MSOA,MSOAn,LTLAn,RGNn,ONS_00_16,ONS_16_64,ONS_65_69,ONS_70_74,ONS_75_79,ONS_80_99,ONS_16_99,P_00_16,P_16_64,P_65_69,P_70_74,P_75_79,P_80_99,P_16_99
E02002796,Allestree North,Derby,East Midlands,1164,3312,366,461,317,427,4883,1124,3681,399,445,364,468,5357
E02002797,Allestree South,Derby,East Midlands,1121,3860,442,559,444,912,6217,1087,4234,437,540,478,893,6582
E02002798,Oakwood,Derby,East Midlands,1570,6365,517,488,240,387,7997,1634,7080,570,531,323,384,8888
E02002799,Breadsall Hilltop,Derby,East Midlands,1390,3738,208,211,163,247,4567,1434,4367,223,227,166,252,5235
E02002800,Darley Abbey,Derby,East Midlands,1286,4189,370,394,278,559,5790,1208,4457,367,392,305,545,6066
E02002801,Chaddesden North,Derby,East Midlands,1508,4419,351,394,304,497,5965,1428,4916,337,410,321,485,6469
E02002802,Chaddesden West,Derby,East Midlands,2028,4920,296,246,209,283,5954,2032,5808,313,271,203,265,6860
E02002803,Little Chester,Derby,East Midlands,857,6740,252,217,171,235,7615,818,8066,310,231,166,200,8973
E02002804,Mackworth,Derby,East Midlands,2088,5173,349,354,240,519,6635,2081,5779,384,386,251,435,7235
E02002805,Spondon North,Derby,East Midlands,823,2949,362,510,371,465,4657,845,3272,352,453,397,515,4989
E02002806,New Zealand,Derby,East Midlands,941,4854,168,133,109,140,5404,913,5475,173,169,92,131,6040
E02002807,Chaddesden Park,Derby,East Midlands,1777,5186,418,557,311,426,6898,1832,5882,457,520,353,458,7670
E02002808,Cathedral Quarter & California,Derby,East Midlands,1926,10221,227,242,153,287,11130,1958,11645,306,248,166,247,12612
E02002809,Spondon South,Derby,East Midlands,1305,3979,318,357,306,416,5376,1381,4573,333,372,333,486,6097
E02002810,Mickleover North,Derby,East Midlands,1547,4771,563,563,357,631,6885,1662,5412,554,567,407,633,7573
E02002811,New Normanton,Derby,East Midlands,2837,7650,309,161,138,238,8496,3340,9758,392,224,137,250,10761
E02002812,Littleover East,Derby,East Midlands,1405,4693,360,330,283,504,6170,1486,5283,417,366,286,488,6840
E02002813,Rose Hill & Castleward,Derby,East Midlands,3258,7597,335,212,143,306,8593,3591,9928,372,243,164,349,11056
E02002814,Mickleover South,Derby,East Midlands,1101,3911,514,525,332,617,5899,1117,4331,589,563,389,667,6539
E02002815,Normanton North & Peartree,Derby,East Midlands,2532,5458,206,164,151,278,6257,2784,7160,255,176,129,242,7962
E02002816,Littleover West & Heatherton,Derby,East Midlands,2184,5866,450,354,265,384,7319,2142,6615,483,425,277,322,8122
E02002817,Normanton West,Derby,East Midlands,1229,3552,395,331,269,456,5003,1145,3956,402,362,261,435,5416
E02002818,Normanton South,Derby,East Midlands,2417,5138,285,247,183,424,6277,2337,6062,306,251,186,347,7152
E02002819,Wilmorton & Alvaston Village,Derby,East Midlands,1339,5265,369,378,202,373,6587,1293,5173,356,360,249,353,6491
E02002820,Alvaston & Crewton,Derby,East Midlands,2286,6113,365,354,243,331,7406,2202,6880,408,366,240,298,8192
E02002821,Allenton & Osmaston,Derby,East Midlands,3524,7435,328,300,212,353,8628,3449,8733,363,312,212,345,9965
E02002822,Sunny Hill,Derby,East Midlands,1337,3964,316,309,232,462,5283,1374,4551,326,320,238,450,5885
E02002823,Boulton,Derby,East Midlands,1411,4266,349,437,421,455,5928,1481,4767,387,437,387,461,6439
E02002824,Sinfin,Derby,East Midlands,2462,5949,489,368,247,276,7329,2583,7139,535,448,295,313,8730
E02002825,Chellaston West & Shelton Lock,Derby,East Midlands,1852,4981,427,469,334,517,6728,1758,5428,430,498,350,560,7266
E02002826,Chellaston East,Derby,East Midlands,1453,4447,267,288,185,281,5468,1488,4894,296,311,198,291,5990
E02002827,Beaumont Park,Leicester,East Midlands,1486,4058,271,218,121,154,4822,1617,4753,323,232,155,150,5613
E02002828,Rushey Mead North,Leicester,East Midlands,1486,4771,506,382,246,336,6241,1526,5637,552,439,293,387,7308
E02002829,Stocking Farm & Mowmacre,Leicester,East Midlands,3038,6896,355,338,198,461,8248,3125,8197,419,380,198,372,9566
E02002830,Bradgate Heights & Beaumont Leys,Leicester,East Midlands,2660,6303,448,279,168,221,7419,2929,7742,452,369,186,205,8954
E02002831,Rushey Mead South,Leicester,East Midlands,1431,4127,400,297,220,334,5378,1508,5212,403,343,210,356,6524
E02002832,Belgrave North West,Leicester,East Midlands,1780,5829,524,325,283,418,7379,2031,7925,559,469,278,452,9683
E02002833,Belgrave North East,Leicester,East Midlands,1709,5488,433,270,198,242,6631,1849,7095,506,330,188,267,8386
E02002834,Abbey Park,Leicester,East Midlands,2116,7469,460,453,283,475,9140,2266,8685,499,465,324,446,10419
E02002835,Hamilton & Humberstone,Leicester,East Midlands,3636,9249,539,371,226,372,10757,3897,10494,589,398,263,364,12108
E02002836,Belgrave South,Leicester,East Midlands,1807,6206,554,366,255,359,7740,2018,8427,605,457,272,413,10174
E02002837,Northfields & Merrydale,Leicester,East Midlands,2243,5494,289,193,123,135,6234,2601,7494,334,206,147,178,8359
E02002838,New Parks & Stokeswood,Leicester,East Midlands,2337,4643,279,313,186,291,5712,2544,5894,298,307,206,238,6943
E02002839,Colchester Road,Leicester,East Midlands,1841,4698,368,322,247,387,6022,2026,5647,411,353,260,366,7037
E02002842,Newfoundpool,Leicester,East Midlands,2017,6084,180,114,84,106,6568,2094,6969,205,156,80,97,7507
E02002843,Spinney Hill Road,Leicester,East Midlands,3649,9130,553,349,206,298,10536,3782,11935,667,413,242,323,13580
E02002844,St Matthews & Highfields North,Leicester,East Midlands,3360,7108,372,285,216,285,8266,3391,8984,458,337,212,307,10298
E02002845,North Evington & Rowlatts Hill,Leicester,East Midlands,2724,6750,430,339,223,396,8138,2882,8296,481,378,238,374,9767
E02002846,Dane Hills & Western Park,Leicester,East Midlands,1329,4493,388,362,225,356,5824,1385,5155,387,371,252,360,6525
E02002847,Crown Hills,Leicester,East Midlands,2474,6367,435,232,210,291,7535,2688,8613,493,299,209,322,9936
E02002848,Highfields South,Leicester,East Midlands,2861,7345,399,257,192,222,8415,3110,9674,431,336,188,259,10888
E02002849,West End & Westcotes,Leicester,East Midlands,1866,11873,293,223,200,283,12872,1882,12736,338,235,170,294,13773
E02002851,Evington,Leicester,East Midlands,1578,4932,498,379,322,609,6740,1740,5721,553,437,327,578,7616
E02002852,Braunstone Park West,Leicester,East Midlands,2149,4195,217,180,105,161,4858,2243,5320,227,226,120,148,6041
E02002853,Stoneygate North,Leicester,East Midlands,3066,8657,513,330,254,400,10154,3410,10859,637,398,265,416,12575
E02002854,Braunstone Park East,Leicester,East Midlands,1995,5209,293,246,177,347,6272,2146,6286,321,233,185,309,7334
E02002855,Rowley Fields & Faircharm,Leicester,East Midlands,1375,5985,242,190,128,159,6704,1481,6522,250,214,142,195,7323
E02002856,Clarendon Park & Stoneygate South,Leicester,East Midlands,1533,8696,403,378,275,506,10258,1500,9700,461,388,287,486,11322
E02002857,Aylestone North & Saffron Fields,Leicester,East Midlands,1327,4631,223,157,97,178,5286,1542,5259,240,179,123,155,5956
E02002858,Knighton,Leicester,East Midlands,1365,4127,388,382,281,488,5666,1313,4738,430,392,278,473,6311
E02002860,Aylestone South,Leicester,East Midlands,1573,4706,395,423,270,525,6319,1608,5460,418,452,292,494,7116
E02002861,Saffron Lane,Leicester,East Midlands,2121,4546,306,213,147,214,5426,2229,5864,298,227,146,216,6751
E02002862,Eyres Monsell,Leicester,East Midlands,1989,4781,315,366,209,370,6041,2186,5824,343,340,203,357,7067
E02006815,Thurnby Lodge,Leicester,East Midlands,2784,6056,462,395,273,623,7809,3095,7316,514,415,276,536,9057
E02006817,West Knighton,Leicester,East Midlands,1628,6092,308,244,222,334,7200,1700,7538,341,265,201,343,8688
E02006819,Kirby Frith,Leicester,East Midlands,2321,4810,281,278,158,255,5782,2532,5936,308,275,162,227,6908
E02006850,Leicester City South,Leicester,East Midlands,779,12423,121,90,63,127,12824,875,14394,136,102,71,90,14793
E02006851,Leicester City Centre,Leicester,East Midlands,620,10823,46,39,23,24,10955,616,10313,103,64,23,29,10532
E02002863,"Market Overton, Cottesmore & Empingham",Rutland,East Midlands,1018,5114,485,495,333,385,6812,1338,5152,429,518,376,398,6873
E02002864,"Oakham West, Langham & Whissendine",Rutland,East Midlands,1588,4557,510,471,369,516,6423,1503,4888,490,514,438,587,6917
E02002865,Oakham East,Rutland,East Midlands,1305,4332,533,566,490,649,6570,1214,4542,525,598,470,729,6864
E02002866,"Ketton, Ryhall & Luffenham",Rutland,East Midlands,1358,4197,515,624,357,583,6276,1134,4300,503,639,390,586,6418
E02002867,"Uppingham, Lyddington & Braunston",Rutland,East Midlands,1492,4803,555,604,428,695,7085,1421,5319,563,604,469,657,7612
E02002868,Rise Park & Top Valley West,Nottingham,East Midlands,1103,3236,343,451,274,337,4641,1113,3739,338,415,336,383,5211
E02002869,Bulwell North,Nottingham,East Midlands,1868,4480,328,336,174,340,5658,1966,5281,331,331,202,309,6454
E02002871,Highbury Vale,Nottingham,East Midlands,1477,4757,408,383,280,418,6246,1567,5196,406,383,293,451,6729
E02002872,Bulwell West,Nottingham,East Midlands,2012,5466,416,433,190,273,6778,2177,6157,414,418,293,248,7530
E02002873,Bestwood,Nottingham,East Midlands,2469,6046,310,217,176,295,7044,2605,6997,306,249,162,303,8017
E02002874,North Sherwood,Nottingham,East Midlands,1746,5330,362,279,187,334,6492,1719,6740,327,308,225,328,7928
E02002875,Basford Park Lane,Nottingham,East Midlands,2072,5474,279,293,205,280,6531,2106,6128,342,261,208,285,7224
E02002876,Old Basford,Nottingham,East Midlands,1507,5412,390,306,249,312,6669,1511,5963,356,325,253,309,7206
E02002877,Sherwood Vale,Nottingham,East Midlands,1231,5010,429,359,253,448,6499,1259,5568,411,375,256,352,6962
E02002878,Broxtowe & Cinderhill,Nottingham,East Midlands,3324,5738,238,174,118,131,6399,3255,6794,233,190,132,132,7481
E02002879,New Basford,Nottingham,East Midlands,2161,6733,277,234,171,165,7580,2266,7550,311,250,186,215,8512
E02002880,Aspley,Nottingham,East Midlands,2691,5580,204,246,173,164,6367,2688,6617,249,231,147,158,7402
E02002881,Bilborough North,Nottingham,East Midlands,1801,4190,272,222,139,239,5062,1801,4869,249,236,175,270,5799
E02002882,Mapperley Park,Nottingham,East Midlands,1346,6111,368,259,154,351,7243,1161,6382,375,312,162,317,7548
E02002883,Thorneywood,Nottingham,East Midlands,1735,5301,303,252,147,213,6216,1679,5790,313,263,168,202,6736
E02002884,Forest Fields,Nottingham,East Midlands,1441,5021,152,107,85,162,5527,1694,5913,182,132,78,156,6461
E02002885,Hyson Green,Nottingham,East Midlands,2355,6355,180,135,105,70,6845,2736,8655,204,143,95,104,9201
E02002886,Bobbers Mill,Nottingham,East Midlands,2441,5946,383,329,245,425,7328,2589,7585,395,353,293,424,9050
E02002887,Beechdale,Nottingham,East Midlands,1303,3798,366,383,287,446,5280,1413,4444,325,384,303,406,5862
E02002888,St Ann's East,Nottingham,East Midlands,1856,4912,274,188,141,206,5721,1948,5921,302,208,139,210,6780
E02002889,"Arboretum, Forest & Trent University",Nottingham,East Midlands,628,12034,140,80,52,86,12392,571,10616,133,94,46,75,10964
E02002890,St Ann's West,Nottingham,East Midlands,1395,11711,227,207,152,220,12517,1386,10660,242,213,151,189,11455
E02002891,Bakersfield,Nottingham,East Midlands,1860,5025,387,334,201,383,6330,1883,5772,396,347,238,377,7130
E02002892,Bilborough South,Nottingham,East Midlands,1404,3697,272,227,167,307,4670,1393,4512,269,285,174,290,5530
E02002893,Radford,Nottingham,East Midlands,2084,13357,251,165,109,135,14017,2272,17042,266,174,110,142,17734
E02002894,Wollaton Park,Nottingham,East Midlands,1525,4155,391,323,223,417,5509,1563,5028,387,357,232,424,6428
E02002895,The Park & Castle,Nottingham,East Midlands,543,7358,182,164,85,106,7895,549,8266,188,191,123,151,8919
E02002896,Sneinton,Nottingham,East Midlands,2594,7182,295,231,141,220,8069,2558,8481,305,253,146,195,9380
E02002897,Wollaton Vale,Nottingham,East Midlands,1759,4412,473,504,350,675,6414,1715,4846,445,466,357,633,6747
E02002898,Lenton & Dunkirk,Nottingham,East Midlands,700,9730,160,89,83,152,10214,872,10996,169,127,90,154,11536
E02002899,"University Park, Lenton Abbey & Jubilee Campus",Nottingham,East Midlands,810,9432,235,184,136,222,10209,901,14714,198,195,153,224,15484
E02002901,Wilford & Silverdale,Nottingham,East Midlands,1126,3812,341,303,216,369,5041,1107,4170,373,291,220,444,5498
E02002902,Clifton North,Nottingham,East Midlands,1594,6314,423,271,187,477,7672,1668,7180,424,302,209,414,8529
E02002903,Clifton West,Nottingham,East Midlands,1299,3595,357,274,203,504,4933,1290,4012,388,299,197,476,5372
E02002904,Clifton South,Nottingham,East Midlands,1342,3753,258,203,138,341,4693,1475,4410,312,231,158,341,5452
E02006834,Top Valley East,Nottingham,East Midlands,1603,4494,364,324,282,476,5940,1587,5107,338,337,244,464,6490
E02006904,City Centre & Trent Bridge,Nottingham,East Midlands,701,11252,143,82,56,38,11571,795,10179,157,112,68,68,10584
E02006905,Meadows,Nottingham,East Midlands,1626,5380,235,187,156,198,6156,1688,6115,277,217,146,206,6961
E02004029,Alfreton,Amber Valley,East Midlands,1167,4427,459,363,235,321,5805,1279,4780,432,389,265,366,6232
E02004030,"Crich, Holloway & Wingfield",Amber Valley,East Midlands,831,3371,495,516,312,395,5089,855,3540,492,528,385,436,5381
E02004031,Somercotes & Pye Bridge,Amber Valley,East Midlands,1674,4903,401,363,238,320,6225,1613,5007,367,384,254,277,6289
E02004032,Swanwick & Leabrooks,Amber Valley,East Midlands,1219,5068,594,723,429,521,7335,1288,5127,566,675,479,518,7365
E02004033,"Ripley East, Riddings & Ironville",Amber Valley,East Midlands,1394,5744,543,488,335,530,7640,1416,5752,549,522,377,477,7677
E02004034,Ripley West,Amber Valley,East Midlands,1029,4133,516,643,499,497,6288,953,3933,529,589,464,454,5969
E02004035,"Ambergate, Heage & Idridgehay",Amber Valley,East Midlands,911,3837,498,526,417,454,5732,829,3818,493,511,420,461,5703
E02004036,Ripley South & Loscoe,Amber Valley,East Midlands,1903,6378,616,654,406,469,8523,1851,6511,528,702,486,528,8755
E02004037,Belper Far Laund,Amber Valley,East Midlands,1415,5055,446,482,342,403,6728,1353,5089,456,500,344,484,6873
E02004038,Belper Town,Amber Valley,East Midlands,1160,4914,464,495,310,528,6711,1069,4833,449,544,360,491,6677
E02004039,Openwoodgate & Holbrook,Amber Valley,East Midlands,1291,5118,464,486,316,442,6826,1248,4916,482,484,350,409,6641
E02004040,Heanor Gate & Aldercar,Amber Valley,East Midlands,1737,6167,526,483,304,416,7896,1709,6300,521,516,352,386,8075
E02004041,Heanor East & Langley Mill,Amber Valley,East Midlands,1256,4742,449,422,270,292,6175,1240,4756,412,417,310,326,6221
E02004043,Kilburn & Horsley,Amber Valley,East Midlands,1261,4380,494,502,345,429,6150,1223,4571,510,500,372,422,6375
E02004044,"Duffield, Quarndon & Kirk Langley",Amber Valley,East Midlands,1735,4870,476,537,429,639,6951,1779,5460,450,573,436,686,7605
E02006827,Heanor South & Shipley Park,Amber Valley,East Midlands,1561,5020,427,441,281,360,6529,1568,5289,412,429,299,390,6819
E02004045,Clowne & Barlborough,Bolsover,East Midlands,1612,5976,629,658,396,523,8182,1569,6283,605,640,466,501,8495
E02004046,Whitwell & Elmton,Bolsover,East Midlands,970,3807,449,446,245,390,5337,1042,3987,392,445,308,381,5513
E02004047,Creswell & Hodthorpe,Bolsover,East Midlands,1291,3838,343,324,235,261,5001,1237,3847,310,310,258,269,4994
E02004048,Bolsover North & Shuttlewood,Bolsover,East Midlands,1389,4324,386,333,233,268,5544,1464,4677,397,367,246,323,6010
E02004049,Bolsover South & Glapwell,Bolsover,East Midlands,1191,4589,548,540,387,513,6577,1154,4795,537,556,424,541,6853
E02004050,Shirebrook North,Bolsover,East Midlands,1562,4972,326,343,304,379,6324,1558,5085,323,299,307,363,6377
E02004051,"Langwith, Shirebrook South & Pleasley",Bolsover,East Midlands,1767,6559,501,508,395,415,8378,1804,6823,505,506,418,407,8659
E02004052,"Tibshelf, Newton & Hardwick Park",Bolsover,East Midlands,1512,5252,481,462,353,441,6989,1539,5608,498,474,388,427,7395
E02004053,South Normanton West,Bolsover,East Midlands,1507,4972,411,402,282,300,6367,1500,5174,406,376,313,320,6589
E02004054,South Normanton Broadmeadows & Pinxton,Bolsover,East Midlands,1484,5796,506,493,351,432,7578,1442,5964,536,491,383,481,7855
E02004055,Old Whittington,Chesterfield,East Midlands,1156,4393,410,452,312,462,6029,1103,4380,418,414,343,435,5990
E02004056,Staveley & Norbriggs,Chesterfield,East Midlands,1733,4928,383,359,220,301,6191,1763,5132,412,362,267,324,6497
E02004057,"New Whittington, Hollingwood & Barrow Hill",Chesterfield,East Midlands,1577,5150,389,329,191,242,6301,1523,5185,390,324,220,231,6350
E02004058,Dunston,Chesterfield,East Midlands,1437,4753,424,430,316,402,6325,1445,5059,414,417,342,425,6657
E02004059,Brimington South & Tapton,Chesterfield,East Midlands,1015,4320,485,471,353,516,6145,1018,4457,460,478,384,509,6288
E02004060,Inkersall Green & Duckmanton,Chesterfield,East Midlands,1422,4467,487,487,363,402,6206,1443,4656,470,513,361,434,6434
E02004061,Newbold,Chesterfield,East Midlands,1190,4850,410,365,334,471,6430,1185,4923,418,392,320,479,6532
E02004062,Loundsley Green & Holme Hall,Chesterfield,East Midlands,1179,4811,572,503,374,401,6661,1128,4812,559,573,350,428,6722
E02004063,Ashgate & Brockwell,Chesterfield,East Midlands,1233,4665,482,543,418,614,6722,1172,4693,517,543,448,609,6810
E02004064,Central Chesterfield & Stonegravels,Chesterfield,East Midlands,1753,6680,378,300,197,355,7910,1742,6827,404,357,216,355,8159
E02004065,Brookside & Walton,Chesterfield,East Midlands,1153,4409,717,694,466,690,6976,1181,4664,677,701,542,692,7276
E02004066,Spital & Hasland,Chesterfield,East Midlands,1774,7304,637,698,489,704,9832,1864,7354,639,701,505,686,9885
E02004067,Boythorpe & Birdholme,Chesterfield,East Midlands,1235,4060,355,348,245,307,5315,1198,4174,362,347,259,322,5464
E02004068,"Hathersage, Bradwell & Tideswell",Derbyshire Dales,East Midlands,1021,4272,577,509,435,548,6341,1023,4360,526,561,413,560,6420
E02004069,"Bakewell North, Baslow & Calver",Derbyshire Dales,East Midlands,863,3436,511,578,417,521,5463,827,3657,504,599,463,575,5798
E02004070,"Bakewell South, Youlgreave and Taddington",Derbyshire Dales,East Midlands,833,3300,525,549,381,605,5360,804,3415,520,532,406,598,5471
E02004071,Darley Dale & Stanton,Derbyshire Dales,East Midlands,774,2885,359,399,251,361,4255,706,3051,346,412,296,390,4495
E02004072,Matlock North,Derbyshire Dales,East Midlands,1471,5205,719,745,476,689,7834,1443,5584,687,768,590,770,8399
E02004073,"Matlock South, Cromford & Winster",Derbyshire Dales,East Midlands,1355,5324,739,703,440,632,7838,1356,5440,683,700,511,603,7937
E02004074,Wirksworth,Derbyshire Dales,East Midlands,943,3578,458,464,294,381,5175,894,3697,463,471,321,392,5344
E02004075,"Ashbourne North, Dovedale & Carsington",Derbyshire Dales,East Midlands,980,4287,544,554,400,450,6235,942,4395,552,598,461,459,6465
E02004076,Ashbourne South,Derbyshire Dales,East Midlands,1398,4491,402,400,313,439,6045,1341,4706,388,423,327,506,6350
E02004077,"Doveridge, Brailsford & Bradley",Derbyshire Dales,East Midlands,1197,5032,492,557,371,492,6944,1175,5285,530,547,415,504,7281
E02004078,Cotmanhay,Erewash,East Midlands,1502,4296,394,384,242,353,5669,1478,4502,356,421,266,338,5883
E02004080,Ilkeston Town,Erewash,East Midlands,1793,6250,404,450,324,541,7969,1773,6538,490,462,332,515,8337
E02004081,"Breadsall, Little Eaton & Stanley Common",Erewash,East Midlands,998,3412,456,390,294,410,4962,925,3401,428,435,307,393,4964
E02004082,West Hallam,Erewash,East Midlands,922,3553,440,449,315,534,5291,824,3674,447,479,336,492,5428
E02004083,Hallam Fields & Greenwood Ave,Erewash,East Midlands,1543,5195,391,405,303,329,6623,1449,5360,359,374,326,314,6733
E02004084,Kirk Hallam,Erewash,East Midlands,1194,3641,292,330,280,445,4988,1151,3771,321,322,280,387,5081
E02004085,Sandiacre & Stanton,Erewash,East Midlands,1694,5356,469,529,384,666,7404,1593,5470,479,517,407,630,7503
E02004086,Borrowash & Ockbrook,Erewash,East Midlands,1275,4267,417,506,354,529,6073,1195,4627,445,448,407,514,6441
E02004087,Long Eaton North,Erewash,East Midlands,1496,5028,389,367,237,382,6403,1522,5250,385,384,257,380,6656
E02004088,Long Eaton West,Erewash,East Midlands,1269,4764,485,528,313,434,6524,1192,4853,494,515,370,442,6674
E02004089,Long Eaton Town,Erewash,East Midlands,1329,4964,245,229,198,278,5914,1250,5054,271,259,188,262,6034
E02004090,Breaston & Draycott,Erewash,East Midlands,968,3707,352,415,302,483,5259,909,3737,398,424,316,427,5302
E02004091,Long Eaton South,Erewash,East Midlands,1552,5923,510,510,405,491,7839,1502,6195,502,552,406,471,8126
E02004092,Sawley,Erewash,East Midlands,1859,6084,492,555,432,505,8068,1739,6078,505,527,464,522,8096
E02006828,Shipley,Erewash,East Midlands,1256,4562,363,377,184,249,5735,1228,4796,367,403,235,244,6045
E02004093,Hadfield East & Tintwistle,High Peak,East Midlands,1136,4100,362,307,199,254,5222,1126,4321,390,342,210,241,5504
E02004094,Hadfield West & Gamesley,High Peak,East Midlands,1529,4585,359,357,274,262,5837,1502,4737,339,350,243,289,5958
E02004095,Glossop,High Peak,East Midlands,1710,6602,588,547,349,393,8479,1683,6907,536,581,365,457,8846
E02004096,"Dinting, Simmondley & Charlesworth",High Peak,East Midlands,1639,5677,681,667,438,555,8018,1633,6204,679,661,510,529,8583
E02004097,New Mills West & Furness Vale,High Peak,East Midlands,1162,4979,503,565,310,341,6698,1083,5015,483,516,368,337,6719
E02004098,New Mills East & Hayfield,High Peak,East Midlands,1253,4371,475,473,331,363,6013,1246,4857,484,499,327,361,6528
E02004100,Whaley Bridge & Chinley,High Peak,East Midlands,1268,4797,545,509,340,474,6665,1379,5254,591,546,402,477,7270
E02004102,Buxton North,High Peak,East Midlands,1076,5438,534,460,334,616,7382,932,5320,515,514,382,660,7391
E02004103,Buxton South & East,High Peak,East Midlands,1574,4386,332,313,239,314,5584,1545,4625,355,310,245,323,5858
E02004104,Buxton Burbage & Harpur Hill,High Peak,East Midlands,1286,4476,450,448,343,374,6091,1269,4617,457,452,337,403,6266
E02006872,Chapel-en-le-Frith & Hope Valley,High Peak,East Midlands,2167,7691,881,912,599,794,10877,2027,7922,858,897,671,814,11162
E02004105,Killamarsh,North East Derbyshire,East Midlands,1530,6063,605,578,303,421,7970,1570,6183,618,620,363,408,8192
E02004106,Eckington West & Coal Aston,North East Derbyshire,East Midlands,913,3704,538,600,463,529,5834,862,3883,518,624,484,606,6115
E02004108,Dronfield Town & Unstone,North East Derbyshire,East Midlands,1258,4434,400,494,395,573,6296,1224,4660,377,427,403,578,6445
E02004109,Dronfield Woodhouse & Holmesfield,North East Derbyshire,East Midlands,1056,3450,515,643,447,602,5657,1066,3714,485,620,522,622,5963
E02004110,Dronfield South & Gosforth Lane,North East Derbyshire,East Midlands,1288,4103,513,581,434,462,6093,1307,4409,531,517,483,533,6473
E02004111,Arkwright Town & Temple Normanton,North East Derbyshire,East Midlands,859,3420,375,420,279,362,4856,851,3386,377,400,311,382,4856
E02004112,Wingerworth & Holymoorside,North East Derbyshire,East Midlands,826,3440,535,655,444,569,5643,779,3502,500,616,497,608,5723
E02004113,Grassmoor & Holmewood,North East Derbyshire,East Midlands,1991,6170,530,472,328,459,7959,1984,6297,538,488,381,451,8155
E02004114,Ashover & New Tupton,North East Derbyshire,East Midlands,1074,4370,578,668,502,559,6677,1157,4671,594,629,537,638,7069
E02004115,North Wingfield & Pilsley,North East Derbyshire,East Midlands,1372,5801,583,574,436,472,7866,1264,5490,573,539,435,472,7509
E02004116,Clay Cross,North East Derbyshire,East Midlands,1464,4964,482,489,341,433,6709,1539,5309,463,485,397,461,7115
E02004117,"Stonebroom, Shirland & Wessington",North East Derbyshire,East Midlands,1411,4553,530,526,391,451,6451,1440,4855,526,537,408,469,6795
E02006804,Eckington East & Renishaw,North East Derbyshire,East Midlands,1563,5202,429,426,307,482,6846,1503,5394,424,422,328,472,7040
E02004118,Hatton & Burnaston,South Derbyshire,East Midlands,1211,4746,389,357,240,361,6093,1353,5024,407,393,268,361,6453
E02004119,Hilton & Etwall,South Derbyshire,East Midlands,2575,7639,483,478,369,451,9420,2471,7618,487,487,388,472,9452
E02004120,"Willington North, Findern & Stenson Fields",South Derbyshire,East Midlands,1953,6285,607,464,286,374,8016,2136,7003,624,539,335,360,8861
E02004121,Aston-on-Trent & Barrow-upon-Trent,South Derbyshire,East Midlands,1526,5160,435,491,315,456,6857,1747,5754,455,471,392,504,7576
E02004122,Willington South & Repton,South Derbyshire,East Midlands,1195,4246,466,499,277,378,5866,1185,4362,441,448,336,354,5941
E02004123,"Melbourne, Ticknall & Hartshorne",South Derbyshire,East Midlands,1132,4160,455,408,285,452,5760,1099,4189,490,427,313,470,5889
E02004124,Swadlincote North,South Derbyshire,East Midlands,1505,4769,426,453,307,383,6338,1493,4951,417,439,325,401,6533
E02004125,Swadlincote West,South Derbyshire,East Midlands,1750,5691,561,527,306,405,7490,1587,5644,532,523,371,399,7469
E02004126,Swadlincote Central,South Derbyshire,East Midlands,1236,4628,488,424,295,400,6235,1316,4814,508,488,310,387,6507
E02004128,"Castle Gresley, Overseal & Coton",South Derbyshire,East Midlands,1851,7054,699,760,546,555,9614,1945,7089,679,764,567,619,9718
E02006919,Swadlincote South,South Derbyshire,East Midlands,2358,7363,417,382,250,306,8718,2230,6967,422,396,243,256,8284
E02006920,Swadlincote East,South Derbyshire,East Midlands,1859,5680,337,325,182,179,6703,1733,5526,356,330,203,218,6633
E02005334,Leicester Forest East,Blaby,East Midlands,1160,3778,297,257,213,387,4932,1159,3861,294,235,217,305,4912
E02005335,Kirby Muxloe & Thurlaston,Blaby,East Midlands,1338,4176,424,458,333,587,5978,1281,4410,414,453,373,688,6338
E02005336,Thorpe Astley,Blaby,East Midlands,1591,4994,257,243,142,235,5871,1620,4952,293,224,168,249,5886
E02005337,Braunstone Town,Blaby,East Midlands,1860,6219,452,467,386,578,8102,1915,6598,503,487,389,587,8564
E02005338,Enderby & Glen Parva,Blaby,East Midlands,2181,6689,525,578,333,577,8702,2161,7119,550,577,378,578,9202
E02005339,Narborough,Blaby,East Midlands,1625,5376,489,508,289,389,7051,1560,5511,491,526,351,397,7276
E02005340,Blaby Village,Blaby,East Midlands,1534,5373,478,520,452,550,7373,1486,5497,503,517,483,586,7586
E02005341,Whetstone,Blaby,East Midlands,1568,5008,322,364,229,334,6257,1463,5011,325,380,232,322,6270
E02005342,"Cosby, Croft & Elmesthorpe",Blaby,East Midlands,1429,4196,467,466,352,353,5834,1403,4504,442,492,374,411,6223
E02005343,Countesthorpe & Kilby,Blaby,East Midlands,1482,4396,559,511,346,421,6233,1511,4891,499,553,394,452,6789
E02005344,"Stoney Stanton, Sapcote & Sharnford",Blaby,East Midlands,1730,5058,519,620,386,459,7042,1721,5405,523,596,450,509,7483
E02006820,Glenfield,Blaby,East Midlands,1869,6247,655,685,420,777,8784,1848,6536,625,771,494,770,9196
E02005345,Loughborough Dishley & Hathern,Charnwood,East Midlands,1138,4200,406,387,257,258,5508,1107,4174,455,402,269,266,5566
E02005346,Loughborough Lemyngton & Hastings,Charnwood,East Midlands,2410,9316,455,317,228,412,10728,2297,10021,504,380,239,394,11538
E02005347,Loughborough Storer & Queen's Park,Charnwood,East Midlands,1028,9207,312,250,177,301,10247,973,8990,320,276,186,322,10094
E02005348,Loughborough Garendon,Charnwood,East Midlands,686,3458,453,430,317,324,4982,740,3536,401,473,344,366,5120
E02005349,Shepshed West,Charnwood,East Midlands,1372,4495,439,427,312,406,6079,1398,4766,471,467,370,410,6484
E02005350,Shepshed East,Charnwood,East Midlands,1079,4043,438,437,265,346,5529,1071,4203,456,429,284,389,5761
E02005351,Loughborough - University,Charnwood,East Midlands,1142,10649,268,257,204,278,11656,1117,12612,263,251,219,268,13613
E02005352,"Wymeswold, Rearsby & Cossington",Charnwood,East Midlands,1161,3873,409,373,264,372,5291,1117,3997,425,397,287,359,5465
E02005353,Loughborough - Shelthorpe & Woodthorpe,Charnwood,East Midlands,2095,7229,424,426,261,343,8683,2153,7676,418,425,312,389,9220
E02005354,Loughborough - Outwoods,Charnwood,East Midlands,1812,6306,535,517,402,742,8502,1788,6502,582,530,443,738,8795
E02005355,Barrow upon Soar,Charnwood,East Midlands,1384,4395,447,457,310,392,6001,1324,4548,441,482,354,392,6217
E02005356,Quorn & Mountsorrel Castle,Charnwood,East Midlands,1329,4383,421,467,329,449,6049,1241,4652,407,504,351,475,6389
E02005357,Sileby,Charnwood,East Midlands,1717,5489,431,344,227,322,6813,1706,5430,411,365,254,321,6781
E02005358,Mountsorrel & Rothley,Charnwood,East Midlands,2300,7298,536,569,390,571,9364,2398,7650,577,550,451,599,9827
E02005359,East Goscote & Queniborough,Charnwood,East Midlands,1348,4169,423,484,322,370,5768,1432,4586,443,500,357,432,6318
E02005360,"Thurcaston, Woodhouse & Bradgate",Charnwood,East Midlands,1050,3909,466,449,333,485,5642,1002,3881,453,497,340,471,5642
E02005361,Syston West,Charnwood,East Midlands,1115,4345,385,333,231,330,5624,1027,4306,397,348,254,350,5655
E02005362,Syston East,Charnwood,East Midlands,1491,4526,388,444,222,365,5945,1470,4662,401,445,312,393,6213
E02005363,Birstall Wanlip & Riverside,Charnwood,East Midlands,1687,5173,424,516,353,653,7119,1676,5476,427,488,361,652,7404
E02005364,Birstall Central,Charnwood,East Midlands,999,3372,281,248,190,258,4349,911,3501,289,238,210,298,4536
E02005365,Thurmaston,Charnwood,East Midlands,1843,6333,560,503,472,555,8423,1768,6303,629,562,453,568,8515
E02005366,Anstey,Charnwood,East Midlands,1357,4410,397,472,296,431,6006,1423,4521,371,466,365,421,6144
E02005368,"Tilton, Billesdon & Great Easton",Harborough,East Midlands,1043,3754,407,476,296,374,5307,996,3861,448,456,334,397,5496
E02005369,Kibworth & Great Glen,Harborough,East Midlands,2473,6969,704,714,517,745,9649,2364,7309,698,746,564,747,10064
E02005370,Broughton Astley,Harborough,East Midlands,1840,5778,532,482,269,319,7380,1787,6152,551,541,311,374,7929
E02005371,"Fleckney, Kilworth & Foxton",Harborough,East Midlands,1785,6178,644,707,429,509,8467,1723,6484,662,697,495,566,8904
E02005372,"Dunton Bassett, Claybrooke & Swinford",Harborough,East Midlands,1594,5908,677,638,417,543,8183,1569,6209,632,663,486,559,8549
E02005373,"Market Harborough West, Great Bowden & Lubenham",Harborough,East Midlands,2054,6804,666,723,545,593,9331,2097,7351,690,773,583,629,10026
E02005374,Market Harborough Central,Harborough,East Midlands,1174,4070,376,356,275,632,5709,1038,4232,373,351,295,522,5773
E02005375,Market Harborough South & Little Bowden,Harborough,East Midlands,1901,5842,447,545,360,578,7772,1762,5839,456,554,430,665,7944
E02005376,Lutterworth,Harborough,East Midlands,1959,6212,542,644,432,600,8430,1898,6596,558,637,538,631,8960
E02006816,"Houghton, Thurby & Scraptoft",Harborough,East Midlands,1387,4503,531,440,341,554,6369,1491,4966,516,470,376,604,6932
E02005377,Markfield & Thornton,Hinckley and Bosworth,East Midlands,1602,5082,562,567,443,539,7193,1652,5444,528,631,462,568,7633
E02005378,Groby East,Hinckley and Bosworth,East Midlands,954,3222,338,282,255,297,4394,972,3294,360,308,242,329,4533
E02005379,Groby West & Ratby,Hinckley and Bosworth,East Midlands,1151,3735,399,423,260,359,5176,1051,3756,380,434,294,382,5246
E02005380,"Market Bosworth, Barlestone & Sheepy Magna",Hinckley and Bosworth,East Midlands,1470,5165,656,701,451,510,7483,1386,5252,681,692,485,564,7674
E02005381,Desford & Newbold Verdon,Hinckley and Bosworth,East Midlands,1549,4869,651,624,452,560,7156,1678,5307,630,648,518,564,7667
E02005382,Earl Shilton,Hinckley and Bosworth,East Midlands,1985,6696,618,637,385,557,8893,1829,6661,579,639,450,580,8909
E02005383,Barwell,Hinckley and Bosworth,East Midlands,1597,5732,494,584,361,470,7641,1611,5972,538,580,396,446,7932
E02005384,"Stoke Golding, Higham & Fenny Drayton",Hinckley and Bosworth,East Midlands,1323,4464,451,451,294,417,6077,1180,4650,440,434,375,461,6360
E02005385,Hinckley East,Hinckley and Bosworth,East Midlands,1093,3789,448,476,296,383,5392,1053,3935,432,495,321,429,5612
E02005386,Hinckley Central,Hinckley and Bosworth,East Midlands,1509,5920,405,371,322,503,7521,1542,6341,402,423,327,470,7963
E02005387,Hinckley West,Hinckley and Bosworth,East Midlands,1997,6459,517,539,277,303,8095,1946,6546,508,520,373,317,8264
E02005388,Hinckley Clarendon Park,Hinckley and Bosworth,East Midlands,1184,3790,326,327,195,319,4957,1168,4142,273,341,214,299,5269
E02005389,Burbage St Catherines,Hinckley and Bosworth,East Midlands,968,3275,382,408,293,549,4907,962,3498,374,395,331,564,5162
E02005390,Burbage Sketchley & Stretton,Hinckley and Bosworth,East Midlands,1754,5812,682,700,404,517,8115,1777,6189,650,732,491,595,8657
E02005391,"Bottesford, Harby & Croxton Kerrial",Melton,East Midlands,1660,5629,712,714,460,555,8070,1574,5917,715,722,509,616,8479
E02005392,Melton Mowbray North,Melton,East Midlands,1660,5413,526,537,411,554,7441,1583,5710,532,592,450,595,7879
E02005393,"Asfordby, Frisby & Old Dalby",Melton,East Midlands,1178,4317,538,425,326,386,5992,1225,4520,497,516,332,432,6297
E02005394,Melton Mowbray West,Melton,East Midlands,2045,5812,557,558,311,483,7721,2007,5903,535,547,382,485,7852
E02005395,Melton Mowbray South,Melton,East Midlands,1481,5360,541,519,403,499,7322,1420,5675,563,548,418,542,7746
E02005396,"Waltham, Wymondham & Great Dalby",Melton,East Midlands,969,3880,487,536,337,430,5670,956,4142,495,556,374,466,6033
E02005397,Castle Donington,North West Leicestershire,East Midlands,1602,5682,572,565,387,390,7596,1544,6021,542,568,426,444,8001
E02005398,Kegworth & Belton,North West Leicestershire,East Midlands,975,4234,397,400,274,348,5653,921,4270,394,415,291,363,5733
E02005399,Ashby de la Zouch North,North West Leicestershire,East Midlands,1716,4949,437,433,268,357,6444,1566,5024,413,483,301,326,6547
E02005400,Thringstone & Swannington,North West Leicestershire,East Midlands,989,3296,457,490,264,347,4854,967,3379,427,469,335,364,4974
E02005401,"Packington, Ravenstone & Coleorton",North West Leicestershire,East Midlands,1138,3828,411,427,266,349,5281,1083,3977,423,421,308,315,5444
E02005402,Ashby de la Zouch South,North West Leicestershire,East Midlands,1247,3795,408,495,293,452,5443,1217,4007,400,493,340,468,5708
E02005403,Whitwick,North West Leicestershire,East Midlands,1032,4141,422,436,376,446,5821,963,4125,402,418,374,431,5750
E02005404,Donisthope & Blackfordby,North West Leicestershire,East Midlands,1591,5264,487,463,282,363,6859,1570,5465,468,487,319,390,7129
E02005405,Agar Nook,North West Leicestershire,East Midlands,1308,4144,405,487,276,399,5711,1385,4439,422,498,323,416,6098
E02005406,Coalville,North West Leicestershire,East Midlands,1629,5423,341,277,214,298,6553,1594,5496,349,280,226,322,6673
E02005407,Hugglescote & Bardon Hill,North West Leicestershire,East Midlands,1967,6724,418,486,300,342,8270,1991,7006,442,471,336,368,8623
E02005408,Measham & Appleby Magna,North West Leicestershire,East Midlands,1471,4993,485,448,323,311,6560,1416,5077,490,444,357,346,6714
E02005409,Ibstock & Ellistown,North West Leicestershire,East Midlands,2330,7366,655,632,422,496,9571,2301,7523,609,662,475,536,9805
E02005412,Oadby South & West,Oadby and Wigston,East Midlands,1652,4927,471,469,394,809,7070,1762,5364,502,488,395,801,7550
E02005414,Wigston Town,Oadby and Wigston,East Midlands,1576,4740,435,393,288,730,6586,1633,5269,429,413,300,618,7029
E02005415,South Wigston,Oadby and Wigston,East Midlands,1563,4980,372,345,321,474,6492,1626,5314,385,362,321,499,6881
E02005416,Wigston Harcourt & Little Hill,Oadby and Wigston,East Midlands,1366,4776,565,709,469,531,7050,1343,5300,601,720,525,603,7749
E02006818,Wigston North,Oadby and Wigston,East Midlands,1495,4786,417,425,353,729,6710,1532,5221,427,429,381,671,7129
E02006911,Oadby North & East,Oadby and Wigston,East Midlands,2854,9938,697,676,478,812,12601,2882,11363,721,712,509,834,14139
E02005417,Leake & Butterwick,Boston,East Midlands,1084,4289,596,579,408,512,6384,1120,5709,610,577,447,538,7881
E02005418,Fenside & Lister Way,Boston,East Midlands,2599,7486,470,392,248,427,9023,2785,9129,466,436,262,409,10702
E02005419,Boston Central & North,Boston,East Midlands,1683,6338,315,245,192,324,7414,2141,8659,370,298,226,330,9883
E02005420,Skirbeck,Boston,East Midlands,1848,5271,440,460,346,485,7002,1895,6105,425,457,338,489,7814
E02005422,"Swineshead, Bicker & Holland Fen",Boston,East Midlands,1131,3474,443,495,315,400,5127,1139,4071,455,502,368,428,5824
E02005423,"Kirton, Frampton & Algarkirk",Boston,East Midlands,2019,5636,703,633,498,633,8103,2088,6647,674,647,479,670,9117
E02006864,Fishtoft & Wyberton East,Boston,East Midlands,1691,4822,537,602,427,534,6922,1538,5277,558,573,418,623,7449
E02006865,Wyberton West & Fen,Boston,East Midlands,1460,4654,508,555,394,572,6683,1521,5355,511,538,426,575,7405
E02005424,"Holton-le-Clay, Binbrook & Tetney",East Lindsey,East Midlands,1465,5706,830,983,569,643,8731,1466,6034,769,918,676,717,9114
E02005425,"Marshchapel, Somercotes & Grimoldby",East Lindsey,East Midlands,937,3588,560,544,383,440,5515,951,3747,518,590,442,458,5755
E02005426,Louth North & East,East Lindsey,East Midlands,2106,5788,629,640,466,690,8213,2063,6175,624,644,526,733,8702
E02005427,Louth Central & South,East Lindsey,East Midlands,1156,4173,470,474,326,495,5938,1053,4229,484,505,390,514,6122
E02005428,Mablethorpe,East Lindsey,East Midlands,1058,4263,835,919,547,623,7187,1193,4817,843,861,661,689,7871
E02005429,Sutton-on-Sea,East Lindsey,East Midlands,585,2780,803,941,639,695,5858,510,2732,786,915,701,758,5892
E02005430,"Wragby, Roughton & Ludford",East Lindsey,East Midlands,977,3935,601,642,440,556,6174,913,3901,608,632,489,587,6217
E02005431,"Alford, Withern & Willoughby",East Lindsey,East Midlands,1279,4688,747,797,546,653,7431,1286,4992,774,819,594,713,7892
E02005432,Little Cawthorpe & South Wolds,East Lindsey,East Midlands,970,4265,763,716,488,492,6724,955,4412,710,736,534,563,6955
E02005433,Ingoldmells & Chapel St Leonards,East Lindsey,East Midlands,700,3598,768,842,510,605,6323,808,4003,719,886,593,611,6812
E02005434,Horncastle,East Lindsey,East Midlands,1150,4186,440,546,451,606,6229,1217,4371,460,539,485,592,6447
E02005435,Skegness North,East Lindsey,East Midlands,1129,3973,616,674,448,495,6206,1250,4657,600,756,517,532,7062
E02005436,Spilsby & Burgh le Marsh,East Lindsey,East Midlands,1400,4340,689,675,498,610,6812,1296,4504,688,693,542,673,7100
E02005437,Skegness Town,East Lindsey,East Midlands,993,3646,416,352,212,329,4955,1099,4494,419,372,250,367,5902
E02005438,Skegness South,East Lindsey,East Midlands,1254,3866,517,495,402,541,5821,1266,4105,469,551,421,538,6084
E02005439,Coningsby & Woodhall Spa,East Lindsey,East Midlands,2264,6951,753,827,624,923,10078,1966,7137,761,887,726,986,10497
E02005440,Wainfleet All Saints,East Lindsey,East Midlands,870,2975,478,455,294,362,4564,862,3267,443,469,304,421,4904
E02005441,"Mareham, Sibsey & New Leake",East Lindsey,East Midlands,1309,4865,696,717,470,618,7366,1213,5004,673,721,534,619,7551
E02005442,Ermine,Lincoln,East Midlands,1352,3768,256,242,197,300,4763,1470,4338,276,247,183,239,5283
E02005443,Glebe Park,Lincoln,East Midlands,1447,4379,359,380,280,430,5828,1358,4700,368,389,288,408,6153
E02005444,Cathedral & West Common,Lincoln,East Midlands,1785,8245,591,538,413,674,10461,1842,9271,610,590,439,738,11648
E02005445,"Monks Road, St Giles & Greetwell",Lincoln,East Midlands,2523,8403,429,327,200,271,9630,2733,9896,415,375,218,252,11156
E02005446,Wharf & University,Lincoln,East Midlands,503,9722,231,194,119,189,10455,526,9124,223,209,123,157,9836
E02005447,Pelham Bridge & South Common,Lincoln,East Midlands,1077,5761,188,150,119,278,6496,1284,6973,222,156,119,275,7745
E02005448,Birchwood West,Lincoln,East Midlands,1689,4408,298,280,207,209,5402,1670,4892,308,303,208,263,5974
E02005449,Boultham & New Boultham,Lincoln,East Midlands,1187,6903,320,331,210,322,8086,1214,6809,344,323,237,335,8048
E02005450,Hartsholme & Birchwood East,Lincoln,East Midlands,1217,4655,564,561,328,657,6765,1272,5184,557,591,432,564,7328
E02005451,Bracebridge North & Boultham Moor,Lincoln,East Midlands,1652,4994,337,281,176,291,6079,1798,5896,317,286,201,365,7065
E02005452,Bracebridge South & Swallow Beck,Lincoln,East Midlands,2009,6348,688,679,446,732,8893,1995,7147,669,679,457,654,9606
E02005453,Washingborough & Branston,North Kesteven,East Midlands,1666,6442,709,829,630,753,9363,1606,6310,686,810,628,839,9273
E02005455,"Skellingthorpe, Witham & Bassingham",North Kesteven,East Midlands,2654,8599,761,888,591,694,11533,2590,8983,798,829,643,700,11953
E02005456,Bracebridge Heath & Waddington,North Kesteven,East Midlands,2001,6340,558,531,488,680,8597,2035,7585,511,559,459,654,9768
E02005457,"Metheringham, Nocton & Potterhanworth",North Kesteven,East Midlands,1482,4882,550,627,437,604,7100,1491,5159,526,615,482,595,7377
E02005458,"Navenby, Harmston & Brant Broughton",North Kesteven,East Midlands,1045,3838,457,589,394,514,5792,1031,3909,428,572,419,559,5887
E02005459,Ruskington North & Billinghay,North Kesteven,East Midlands,1567,4790,577,585,422,485,6859,1434,4959,552,621,447,537,7116
E02005460,Ruskington West & Cranwell,North Kesteven,East Midlands,1189,4199,342,295,253,233,5322,1125,4436,329,293,242,274,5574
E02005461,"Ruskington South, Leasingham & Osbournby",North Kesteven,East Midlands,782,3496,504,560,417,524,5501,855,3722,480,567,458,585,5812
E02005462,Sleaford East,North Kesteven,East Midlands,1878,5888,500,542,403,550,7883,1872,6032,500,553,401,574,8060
E02005463,Sleaford West,North Kesteven,East Midlands,1957,6132,463,486,315,420,7816,2003,6291,435,509,364,444,8043
E02005464,Heckington,North Kesteven,East Midlands,1301,4723,678,735,511,610,7257,1154,4811,667,719,547,682,7426
E02006866,North Hykeham South,North Kesteven,East Midlands,1626,5202,395,436,356,476,6865,1693,5350,356,470,360,524,7060
E02006867,North Hykeham North,North Kesteven,East Midlands,1240,4416,495,570,468,690,6639,1305,4763,515,536,448,661,6923
E02005465,"Donington, Quadring & Gosberton",South Holland,East Midlands,1367,4824,676,645,450,601,7196,1426,5161,662,685,458,635,7601
E02005466,"Long Sutton West, Gedney & Holbeach Hurn",South Holland,East Midlands,1082,3669,484,593,384,473,5603,1085,3894,506,581,363,498,5842
E02005467,Holbeach,South Holland,East Midlands,1318,4249,458,491,367,680,6245,1373,4613,462,479,397,701,6652
E02005468,"Moulton, Weston & Whaplode",South Holland,East Midlands,1256,4310,538,617,391,511,6367,1228,4512,501,608,397,538,6556
E02005469,Pinchbeck & Deeping St Nicholas,South Holland,East Midlands,1480,4715,539,522,318,471,6565,1448,5023,479,538,370,445,6855
E02005470,Spalding North,South Holland,East Midlands,2407,8301,526,600,423,782,10632,2503,9328,544,564,444,748,11628
E02005471,Spalding East,South Holland,East Midlands,1872,5894,554,513,371,588,7920,1808,6485,527,535,397,546,8490
E02005472,Long Sutton East & Sutton Bridge,South Holland,East Midlands,1702,5318,673,769,589,818,8167,1696,5788,659,772,623,821,8663
E02005473,Spalding South West,South Holland,East Midlands,1940,6209,499,563,418,635,8324,1853,6584,490,548,454,627,8703
E02005474,Fleet Hargate & Holbeach St Johns,South Holland,East Midlands,979,3874,503,571,397,469,5814,967,4094,545,577,404,493,6113
E02005475,Crowland & Cowbit,South Holland,East Midlands,1323,3909,418,491,285,357,5460,1267,4314,383,444,309,360,5810
E02005476,"Ancaster, Caythorpe & Claypole",South Kesteven,East Midlands,1200,4179,503,502,410,426,6020,1205,4641,520,498,424,482,6565
E02005477,"Long Bennington, Allington & Barrowby",South Kesteven,East Midlands,1426,4776,832,815,590,673,7686,1383,5056,695,869,617,723,7960
E02005478,Grantham North East,South Kesteven,East Midlands,1890,5660,593,665,454,664,8036,1944,6220,646,634,520,697,8717
E02005479,Grantham North West,South Kesteven,East Midlands,1675,5541,564,545,395,532,7577,1705,6232,580,608,437,564,8421
E02005480,Grantham South West,South Kesteven,East Midlands,2023,4527,340,332,202,212,5613,1933,5019,299,307,220,208,6053
E02005481,Grantham South East,South Kesteven,East Midlands,2547,8142,506,508,384,568,10108,2448,8734,502,500,375,575,10686
E02005482,"Corby Glen, Ropsley & Grantham Outskirts",South Kesteven,East Midlands,1631,5738,763,664,426,455,8046,1506,5877,746,740,473,496,8332
E02005483,Morton & Billingborough,South Kesteven,East Midlands,1287,4635,545,555,410,500,6645,1215,4790,522,555,452,541,6860
E02005484,"Harlaxton, Colsterworth & South Witham",South Kesteven,East Midlands,1250,4194,470,552,340,405,5961,1201,4432,489,499,399,403,6222
E02005485,Bourne West,South Kesteven,East Midlands,1453,4319,457,504,296,480,6056,1634,4897,457,498,387,509,6748
E02005486,Bourne East,South Kesteven,East Midlands,1935,5629,518,531,428,750,7856,1870,5835,500,527,416,681,7959
E02005487,"Langtoft, Thurlby & Uffington",South Kesteven,East Midlands,1615,5592,682,762,477,623,8136,1474,5810,720,762,552,631,8475
E02005488,Market Deeping,South Kesteven,East Midlands,1268,3927,463,494,316,448,5648,1222,4064,511,481,352,454,5862
E02005489,Deeping St James & Frognall,South Kesteven,East Midlands,1305,4244,524,486,290,338,5882,1231,4379,500,495,327,363,6064
E02005490,Stamford North,South Kesteven,East Midlands,1775,5581,535,540,400,581,7637,1787,6110,476,575,436,576,8173
E02005491,"Stamford Central, West and South",South Kesteven,East Midlands,1863,6609,653,783,526,803,9374,1936,7197,620,709,578,833,9937
E02005492,"Caistor, Kelsey & Keelby",West Lindsey,East Midlands,1535,5614,756,738,504,601,8213,1574,5908,798,756,542,603,8607
E02005493,"Morton, Blyton & Scotter",West Lindsey,East Midlands,1709,5940,649,706,473,667,8435,1658,6169,625,733,516,611,8654
E02005494,Market Rasen & Brookenby,West Lindsey,East Midlands,1662,5774,707,777,539,699,8496,1486,5717,712,763,568,762,8522
E02005495,Gainsborough West,West Lindsey,East Midlands,2100,6714,554,506,357,444,8575,2118,7002,549,495,415,460,8921
E02005496,Hemswell & Spital,West Lindsey,East Midlands,1002,3977,469,477,313,281,5517,979,3917,460,496,345,318,5536
E02005497,Gainsborough East,West Lindsey,East Midlands,1939,4554,391,384,228,360,5917,1853,4701,356,375,267,338,6037
E02005498,Torksey & Stow,West Lindsey,East Midlands,942,4001,649,736,491,585,6462,983,4119,628,709,553,611,6620
E02005499,Dunholme & Welton,West Lindsey,East Midlands,1557,4947,558,529,381,473,6888,1546,5201,561,540,415,511,7228
E02005500,Saxilby & Scampton,West Lindsey,East Midlands,1209,4369,458,499,373,406,6105,1124,4344,484,503,437,448,6216
E02005501,"Nettleham, Sudbrooke & Scothern",West Lindsey,East Midlands,1251,4310,556,622,455,616,6559,1290,4529,554,651,494,674,6902
E02005502,Cherry Willingham & Bardney,West Lindsey,East Midlands,1577,5267,755,770,547,678,8017,1590,5454,679,761,575,716,8185
E02005612,"Rowlett, Gretton & Cottingham",Corby,East Midlands,1398,4547,422,393,238,320,5920,1406,4996,479,367,289,351,6482
E02005613,Corby North,Corby,East Midlands,2046,5926,445,355,286,365,7377,1937,6720,447,404,292,370,8233
E02005614,Corby Village & Weldon,Corby,East Midlands,2602,7098,467,397,240,350,8552,3100,8783,556,449,311,366,10465
E02005615,Corby Lodge Park,Corby,East Midlands,1809,5497,473,479,358,494,7301,1856,6265,492,483,365,499,8104
E02005616,Corby Town,Corby,East Midlands,1162,3695,248,213,173,208,4537,1243,4484,257,222,157,213,5333
E02005617,Corby Kingswood,Corby,East Midlands,2628,6837,438,385,269,325,8254,2608,8515,515,421,290,359,10100
E02006862,Great Oakley and Danesholme,Corby,East Midlands,1328,4061,384,324,209,200,5178,1341,4571,428,349,227,246,5821
E02006863,Snatchill,Corby,East Midlands,3294,8041,295,247,107,142,8832,3208,8697,336,247,142,155,9577
E02005619,"Clipston, Naseby & Yelvertoft",Daventry,East Midlands,1015,3700,417,395,263,363,5138,1053,4090,407,425,296,403,5621
E02005620,Broxworth & Spratton,Daventry,East Midlands,1777,5445,534,518,305,378,7180,1666,5630,529,502,369,392,7422
E02005621,Braunston & Crick,Daventry,East Midlands,1279,5434,602,619,414,474,7543,1258,5940,597,627,424,538,8126
E02005622,Long Buckby East & Ravensthorpe,Daventry,East Midlands,1707,5721,603,614,397,435,7770,1714,6184,603,616,449,491,8343
E02005623,Walgrave & Moulton,Daventry,East Midlands,1911,5720,597,630,401,576,7924,2144,6744,624,636,437,649,9090
E02005624,Daventry North,Daventry,East Midlands,2330,7172,449,443,314,298,8676,2295,8109,461,485,333,328,9716
E02005625,Daventry Central,Daventry,East Midlands,1751,5675,521,564,388,614,7762,1715,6241,499,550,436,609,8335
E02005626,Daventry South & Southbrook,Daventry,East Midlands,1554,4363,336,291,147,140,5277,1571,5020,315,321,203,183,6042
E02005627,Long Buckby West & Weedon,Daventry,East Midlands,1318,4311,529,531,338,457,6166,1347,4833,526,549,373,417,6698
E02005628,"Woodforth Halse, Byfield & Staverton",Daventry,East Midlands,1330,4753,518,525,351,395,6542,1367,5317,523,541,377,408,7166
E02005629,"King's Cliffe, Woodnewton & Easton",East Northamptonshire,East Midlands,1092,3693,462,509,296,373,5333,1101,3932,448,490,335,387,5592
E02005630,"Oundle, Warmington & Titchmarsh",East Northamptonshire,East Midlands,2075,6014,684,693,468,700,8559,1955,6269,642,706,552,725,8894
E02005631,Thrapston & Brigstock,East Northamptonshire,East Midlands,1904,6537,642,647,369,507,8702,1934,6995,642,634,427,510,9208
E02005632,"Ringstead, Woodford & Stanwick",East Northamptonshire,East Midlands,1158,3761,514,478,299,422,5474,1113,3958,466,482,336,422,5664
E02005633,Raunds,East Northamptonshire,East Midlands,1586,5505,593,602,363,516,7579,1702,5710,567,644,416,477,7814
E02005634,Irthlingborough,East Northamptonshire,East Midlands,1885,5811,469,502,261,410,7453,1815,5957,449,485,322,388,7601
E02005635,Higham Ferrers,East Northamptonshire,East Midlands,1885,5818,531,559,335,481,7724,1867,5971,490,561,403,449,7874
E02005636,Rushden West & North,East Northamptonshire,East Midlands,2571,7283,688,678,428,586,9663,2517,7805,635,691,483,582,10196
E02005637,Rushden East,East Northamptonshire,East Midlands,1894,6077,444,404,275,502,7702,1848,6196,413,408,289,517,7823
E02005638,Rushden South,East Northamptonshire,East Midlands,1851,6098,677,681,467,514,8437,1733,6379,610,681,477,526,8673
E02005639,"Geddington, Rushton & Stoke Albany",Kettering,East Midlands,757,2899,421,454,260,344,4378,807,3398,406,439,304,380,4927
E02005640,Desborough,Kettering,East Midlands,2344,6874,677,712,399,514,9176,2371,7391,655,731,490,553,9820
E02005641,Rothwell,Kettering,East Midlands,1614,4862,560,506,329,342,6599,1645,5304,533,564,353,349,7103
E02005642,Kettering Brambleside,Kettering,East Midlands,1538,5057,423,472,307,418,6677,1504,5600,454,487,361,449,7351
E02005643,Kettering Avondale Grange,Kettering,East Midlands,2156,5250,339,300,190,243,6322,2170,6088,369,318,222,246,7243
E02005644,Kettering Central East,Kettering,East Midlands,1941,6347,295,219,159,177,7197,2079,7306,313,236,145,170,8170
E02005645,Kettering Town & West,Kettering,East Midlands,2383,7586,527,534,418,838,9903,2352,8565,507,556,463,801,10892
E02005646,Kettering East,Kettering,East Midlands,1202,3595,437,537,334,368,5271,1163,3799,399,515,395,410,5518
E02005647,Kettering South,Kettering,East Midlands,1521,4724,340,421,248,447,6180,1491,4906,406,376,303,418,6409
E02005648,Barton Seagrave,Kettering,East Midlands,1787,4903,440,513,392,423,6671,1923,6004,466,515,443,474,7902
E02005649,"Burton Latimer, Broughton & Mawsley",Kettering,East Midlands,3718,9708,797,824,497,615,12441,3635,10691,802,806,576,680,13555
E02005650,Boughton,Northampton,East Midlands,1104,4124,396,412,236,277,5445,1217,5125,366,400,270,272,6433
E02005651,Moulton,Northampton,East Midlands,926,3302,470,466,329,464,5031,981,4012,450,472,385,455,5774
E02005652,Sunnyside,Northampton,East Midlands,1108,3253,393,488,344,455,4933,1230,4174,378,500,354,521,5927
E02005653,Thorplands & Round Spinney,Northampton,East Midlands,2384,5215,343,301,149,135,6143,2439,6717,369,316,185,172,7759
E02005654,Overstone Lodge & Rectory Farm,Northampton,East Midlands,2278,5064,367,254,166,151,6002,2237,6375,392,329,188,203,7487
E02005655,Boothville & Spinney Hill,Northampton,East Midlands,1146,3283,414,431,299,476,4903,1130,4035,402,463,310,497,5707
E02005656,Blackthorn & Lings,Northampton,East Midlands,1590,3681,278,226,122,123,4430,1798,4940,316,250,161,136,5803
E02005657,Kingsthorpe,Northampton,East Midlands,1040,3593,360,392,253,352,4950,1047,4161,385,404,314,420,5684
E02005658,St David's,Northampton,East Midlands,1608,4163,221,181,134,172,4871,1707,5308,235,198,136,172,6049
E02005659,Westone,Northampton,East Midlands,1212,3123,313,307,250,430,4423,1269,3902,303,333,259,391,5188
E02005660,Billing & Riverside,Northampton,East Midlands,1502,3579,357,385,195,172,4688,1650,5113,433,435,230,204,6415
E02005661,Eastfield,Northampton,East Midlands,1827,4186,261,217,105,198,4967,1778,5264,281,227,129,211,6112
E02005662,Phippsville,Northampton,East Midlands,1206,4165,273,300,234,370,5342,1331,5148,270,295,264,387,6364
E02005663,New Duston West,Northampton,East Midlands,951,3169,364,324,218,257,4332,969,3523,346,371,222,250,4712
E02005664,Kingsley Park & Racecourse,Northampton,East Midlands,1045,3943,233,226,166,311,4879,1089,5120,230,226,192,330,6098
E02005665,Little Billing,Northampton,East Midlands,1602,4850,455,372,206,258,6141,1700,6098,484,436,266,261,7545
E02005666,King's Heath & Spencer,Northampton,East Midlands,2394,5185,266,224,142,226,6043,2560,6639,279,248,144,210,7520
E02005667,Lodge Farm,Northampton,East Midlands,1521,3754,346,387,285,399,5171,1435,4296,322,357,334,417,5726
E02005668,New Duston East,Northampton,East Midlands,1195,3317,351,389,328,567,4952,1190,3917,334,395,332,567,5545
E02005669,Abington Vale,Northampton,East Midlands,1018,3233,392,409,265,430,4729,1069,3879,391,382,307,423,5382
E02005670,Town Centre & Semilong,Northampton,East Midlands,2049,7216,204,158,98,159,7835,2176,9023,261,189,100,162,9735
E02005671,Abington,Northampton,East Midlands,1417,5352,225,177,137,279,6170,1533,6697,300,210,144,224,7575
E02005672,St Michael's Road,Northampton,East Midlands,1600,6483,145,101,85,93,6907,1738,8004,227,148,93,120,8592
E02005673,Stornton & Sixfields,Northampton,East Midlands,1448,4634,277,282,208,372,5773,1501,5610,305,322,212,329,6778
E02005674,Cliftonville & Rushmere,Northampton,East Midlands,1318,6661,308,234,176,373,7752,1424,7227,285,272,181,463,8428
E02005675,Briar Hill & Hunsbury Hill,Northampton,East Midlands,1683,3604,245,202,106,159,4316,1639,4410,260,215,115,160,5160
E02005676,Delapre,Northampton,East Midlands,1402,3743,237,262,150,201,4593,1342,4273,225,254,155,209,5116
E02005677,"Cotton End, Brackmills & Hardingstone",Northampton,East Midlands,1837,6063,362,322,187,291,7225,1892,7072,364,351,241,293,8321
E02005678,Upton & West Hunsbury,Northampton,East Midlands,3710,8054,496,479,277,434,9740,3780,9534,496,521,325,475,11351
E02005679,East Hunsbury,Northampton,East Midlands,1780,5494,399,299,199,296,6687,1872,6498,427,379,221,284,7809
E02005680,Wootton & Collingtree,Northampton,East Midlands,2144,5212,268,275,168,269,6192,2055,6219,260,294,216,312,7301
E02005681,"Harpole, Kislingbury & Bugbrooke",South Northamptonshire,East Midlands,1566,4819,548,623,483,476,6949,1467,5389,591,628,512,535,7655
E02005682,"Cogenhoe, Hackleton & Denton",South Northamptonshire,East Midlands,1279,4056,443,494,325,380,5698,1309,4462,438,507,374,390,6171
E02005683,"Blisworth, Roade & Yardley Gobion",South Northamptonshire,East Midlands,3226,9028,686,756,469,610,11549,3113,9998,684,753,545,644,12624
E02005684,Towcester West & Blakesley,South Northamptonshire,East Midlands,1597,5323,567,597,386,453,7326,1527,5610,598,608,411,461,7688
E02005685,Towcester East & Paulerspury,South Northamptonshire,East Midlands,1697,5525,506,523,269,438,7261,1762,6390,519,548,333,418,8208
E02005686,Middleton Cheney & Chipping Warden,South Northamptonshire,East Midlands,1353,4692,479,585,362,493,6611,1322,4984,470,570,413,518,6955
E02005687,Silverstone & Syresham & Helmdon,South Northamptonshire,East Midlands,1203,3998,394,436,214,338,5380,1116,4348,414,428,274,316,5780
E02005688,"Deanshanger, Potterspury & Old Stratford",South Northamptonshire,East Midlands,1967,5860,551,552,331,394,7688,1834,6287,520,581,387,448,8223
E02005689,Brackley North,South Northamptonshire,East Midlands,2018,6155,410,398,268,409,7640,2156,7184,434,441,297,410,8766
E02005690,Brackley South,South Northamptonshire,East Midlands,968,3612,285,316,186,290,4689,912,3721,273,278,239,305,4816
E02005691,"Kings Sutton, Greatworth & Evenley",South Northamptonshire,East Midlands,1134,4105,373,524,317,372,5691,1018,4094,409,463,326,401,5693
E02005692,"Finedon, Isham & Harrowden",Wellingborough,East Midlands,1093,3835,488,540,329,371,5563,1050,4216,435,519,384,377,5931
E02005693,Rixon,Wellingborough,East Midlands,2180,5183,390,397,254,368,6592,2125,6044,397,395,267,378,7481
E02005694,Redwell,Wellingborough,East Midlands,1304,4410,561,470,326,287,6054,1256,4974,524,511,353,335,6697
E02005695,Victoria & Isebrook,Wellingborough,East Midlands,1885,6113,305,235,228,314,7195,2180,7700,374,270,203,297,8844
E02005696,Queensway,Wellingborough,East Midlands,1672,3638,211,283,209,237,4578,1664,4517,239,239,230,280,5505
E02005697,Central Wellingborough,Wellingborough,East Midlands,1281,4410,378,341,231,476,5836,1261,5081,354,314,250,462,6461
E02005698,Brickhill,Wellingborough,East Midlands,1278,3431,338,345,232,295,4641,1309,4020,294,343,268,357,5282
E02005699,Croyland,Wellingborough,East Midlands,2177,5053,338,311,202,245,6149,2121,6016,335,308,210,270,7139
E02005700,Earls Barton & Great Doddington,Wellingborough,East Midlands,1658,5203,678,691,474,551,7597,1629,6116,756,787,532,596,8787
E02005701,"Irchester, Wollaston & Bozeat",Wellingborough,East Midlands,2069,6300,715,851,462,577,8905,1930,6990,714,835,552,601,9692
E02005819,Stanton Hill & Skegby,Ashfield,East Midlands,1177,3827,433,423,295,342,5320,1176,3963,449,400,348,335,5495
E02005820,The Dales & South Skegby,Ashfield,East Midlands,819,3289,350,424,341,300,4704,848,3403,348,395,370,365,4881
E02005821,Huthwaite,Ashfield,East Midlands,1459,4338,370,341,264,235,5548,1414,4404,345,350,272,265,5636
E02005822,Sutton Forest Side & New Cross,Ashfield,East Midlands,2318,6972,433,322,260,383,8370,2259,7102,436,360,250,392,8540
E02005823,Sutton Central & Leamington,Ashfield,East Midlands,1640,4820,365,353,261,518,6317,1615,4970,364,376,307,518,6535
E02005824,Sutton St Mary's & Ashfields,Ashfield,East Midlands,1776,6351,545,518,424,433,8271,1669,6464,530,559,434,466,8453
E02005825,East Kirkby,Ashfield,East Midlands,1614,4794,424,449,336,429,6432,1560,5016,432,459,347,412,6666
E02005826,Kirkby Central,Ashfield,East Midlands,1435,3910,301,251,189,290,4941,1438,4030,317,262,191,275,5075
E02005827,Kirkby Larwood & Kingsway,Ashfield,East Midlands,1788,5959,526,414,310,449,7658,1729,6022,532,432,322,479,7787
E02005828,Annesley & Kirkby Woodhouse,Ashfield,East Midlands,1379,4774,516,534,397,363,6584,1299,4742,461,510,424,379,6516
E02005829,Selston,Ashfield,East Midlands,1110,4043,415,434,346,382,5620,1108,4193,404,478,332,402,5809
E02005830,Jacksdale & Underwoood,Ashfield,East Midlands,856,3568,423,461,325,341,5118,847,3714,435,442,341,347,5279
E02005831,Hucknall North & East,Ashfield,East Midlands,1991,6618,486,485,351,469,8409,2145,6732,485,490,390,512,8609
E02005832,Hucknall Town,Ashfield,East Midlands,1813,6021,445,385,306,405,7562,1708,6090,388,377,330,441,7626
E02005833,West Hucknall,Ashfield,East Midlands,1294,4642,532,501,371,388,6434,1289,4676,469,521,396,404,6466
E02005834,Hucknall Westville,Ashfield,East Midlands,1720,5017,359,386,305,374,6441,1814,5607,365,387,326,403,7088
E02005835,"Harworth, Bircotes & Blyth",Bassetlaw,East Midlands,2112,6409,556,602,481,625,8673,2157,6923,584,598,490,671,9266
E02005836,"Clarborough, Beckingham & Misterton",Bassetlaw,East Midlands,1522,5179,701,711,504,610,7705,1419,5400,635,723,553,647,7958
E02005837,"Ranskill, Everton & Gringley",Bassetlaw,East Midlands,1105,4946,596,539,367,393,6841,1066,5375,553,580,403,398,7309
E02005838,Carlton & Langold,Bassetlaw,East Midlands,1434,4710,625,573,440,475,6823,1551,5127,598,586,431,483,7225
E02005839,Retford North,Bassetlaw,East Midlands,992,3638,437,439,321,541,5376,970,3856,436,454,338,505,5589
E02005840,Worksop North,Bassetlaw,East Midlands,1896,6006,428,410,240,315,7399,1988,6533,429,424,285,308,7979
E02005842,Retford East,Bassetlaw,East Midlands,1602,5068,506,560,375,612,7121,1512,5502,483,551,420,633,7589
E02005843,"Worksop West, Shireoaks & Rhodesia",Bassetlaw,East Midlands,1355,4368,290,284,209,306,5457,1395,4788,330,320,212,257,5907
E02005844,Retford South,Bassetlaw,East Midlands,1721,5214,460,472,304,399,6849,1743,5633,461,484,343,433,7354
E02005846,Worksop Cheapside,Bassetlaw,East Midlands,1638,4700,286,231,153,265,5635,1635,5543,314,258,198,252,6565
E02005847,Worksop Town & South,Bassetlaw,East Midlands,1215,4425,391,460,284,397,5957,1155,4912,401,399,318,415,6445
E02005848,"Manton, Clumber & Elkesley",Bassetlaw,East Midlands,1077,3765,405,466,323,384,5343,1069,4107,427,454,367,419,5774
E02005849,"Tuxford, Markham & Rampton",Bassetlaw,East Midlands,1543,5499,663,752,474,463,7851,1532,5693,636,749,515,541,8134
E02006903,Worksop Kilton,Bassetlaw,East Midlands,1859,6426,749,806,557,820,9358,1920,7002,707,813,571,779,9872
E02005850,Eastwood Hall & Brinsley,Broxtowe,East Midlands,1136,4152,497,521,334,419,5923,1056,4054,454,558,375,434,5875
E02005851,Eastwood Town,Broxtowe,East Midlands,1223,3799,360,359,205,335,5058,1290,3982,366,361,261,337,5307
E02005852,Eastwood East,Broxtowe,East Midlands,1271,4867,526,686,490,559,7128,1290,4989,484,661,525,596,7255
E02005853,Kimberley North & Watnall,Broxtowe,East Midlands,1562,5605,623,607,380,459,7674,1554,5732,618,639,414,473,7876
E02005856,Bramcote,Broxtowe,East Midlands,1231,4042,528,568,354,611,6103,1179,4356,483,618,407,617,6481
E02005857,Stapleford North,Broxtowe,East Midlands,1382,3848,299,345,265,332,5089,1236,3889,290,313,268,311,5071
E02005858,Beeston North,Broxtowe,East Midlands,1401,5643,333,322,238,318,6854,1428,6943,367,377,236,334,8257
E02005859,Stapleford South,Broxtowe,East Midlands,1735,5803,494,478,350,435,7560,1731,6173,470,490,373,496,8002
E02005860,Beeston Town,Broxtowe,East Midlands,1190,6589,381,375,281,509,8135,1247,8489,372,381,321,477,10040
E02005861,Beeston Rylands,Broxtowe,East Midlands,948,3746,261,247,206,228,4688,866,4058,266,266,178,248,5016
E02005862,Chilwell West,Broxtowe,East Midlands,1567,4960,386,450,387,473,6656,1478,5308,365,456,364,492,6985
E02005863,Attenborough & Chilwell East,Broxtowe,East Midlands,1309,4420,428,477,341,621,6287,1259,4705,446,501,394,680,6726
E02005864,Toton,Broxtowe,East Midlands,1514,5198,425,387,306,437,6753,1454,5294,481,425,308,481,6989
E02006906,"Kimberley South, Trowell & Awsworth",Broxtowe,East Midlands,2050,7745,787,835,487,752,10606,1993,7689,761,866,587,729,10632
E02005865,Ravenshead & Newstead,Gedling,East Midlands,1335,4568,591,664,500,635,6958,1375,4975,551,662,522,645,7355
E02005866,Calverton & Woodborough,Gedling,East Midlands,1630,5494,644,658,449,541,7786,1609,5511,611,695,468,622,7907
E02005868,Redhill,Gedling,East Midlands,1368,4262,406,466,285,372,5791,1381,4598,408,435,313,426,6180
E02005869,Arnold Town,Gedling,East Midlands,1358,3710,278,246,176,321,4731,1286,3877,279,286,168,320,4930
E02005870,Daybrook,Gedling,East Midlands,1320,4432,272,265,199,380,5548,1305,4503,272,306,190,355,5626
E02005871,Plains Estate,Gedling,East Midlands,1151,4222,492,535,330,417,5996,1099,4250,482,540,387,457,6116
E02005872,Burton Joyce & Lambley,Gedling,East Midlands,1065,3399,440,474,347,495,5155,1087,3640,452,451,376,528,5447
E02005873,Woodthorpe & Arno Vale,Gedling,East Midlands,1695,5885,677,677,438,678,8355,1697,6191,661,721,517,769,8859
E02005874,Mapperley & Porchester,Gedling,East Midlands,1474,5488,475,483,310,485,7241,1456,5702,500,543,345,530,7620
E02005875,Gedling North,Gedling,East Midlands,1550,4974,401,404,288,417,6484,1589,5158,394,399,281,406,6638
E02005876,Gedling South,Gedling,East Midlands,1581,5428,496,510,348,599,7381,1600,5771,492,521,400,549,7733
E02005877,Carlton Hill,Gedling,East Midlands,1308,4548,381,312,203,355,5799,1400,4832,388,368,249,360,6197
E02005878,Carlton,Gedling,East Midlands,1790,6393,601,508,337,526,8365,1670,6565,579,545,372,576,8637
E02005879,Netherfield & Colwick,Gedling,East Midlands,1456,5245,273,270,188,198,6174,1463,5291,307,285,199,227,6309
E02006835,Bestwood Village,Gedling,East Midlands,1044,3877,379,311,188,252,5007,1100,3947,398,330,209,278,5162
E02005880,Church Warsop & Meden Vale,Mansfield,East Midlands,1352,3738,321,357,254,366,5036,1336,4003,355,324,282,337,5301
E02005881,Market Warsop,Mansfield,East Midlands,1209,3761,383,299,233,380,5056,1243,4083,365,350,256,294,5348
E02005882,"Manor, Hornby & Peafields",Mansfield,East Midlands,1226,4375,542,579,419,417,6332,1294,4713,543,583,434,469,6742
E02005883,Woodhouse,Mansfield,East Midlands,1813,5262,429,378,279,356,6704,1765,5623,380,380,301,346,7030
E02005884,Yeoman Hill & Maun Valley,Mansfield,East Midlands,962,3698,383,340,248,295,4964,992,3940,397,385,273,297,5292
E02005885,Abbott Road & Pleasley Hill,Mansfield,East Midlands,1492,4879,561,510,346,509,6805,1622,5539,557,516,365,472,7449
E02005886,Forest Town & Newlands,Mansfield,East Midlands,2209,6861,624,597,413,541,9036,2220,7370,635,607,484,571,9667
E02005887,Mansfield Town Centre & Broomhill,Mansfield,East Midlands,1953,7125,409,334,271,492,8631,1997,8094,400,340,272,436,9542
E02005888,Newgate & Carr Bank,Mansfield,East Midlands,1765,5600,361,307,205,275,6748,1699,6031,392,327,232,289,7271
E02005889,Grange Farm & Ladybrook,Mansfield,East Midlands,2016,6444,592,572,352,531,8491,2073,7015,612,584,435,580,9226
E02005890,Eakring & Ling Forest,Mansfield,East Midlands,1102,4079,430,487,286,321,5603,1007,4099,440,448,345,341,5673
E02005891,Oak Tree & Ransom Wood,Mansfield,East Midlands,1318,4180,285,267,195,253,5180,1385,4510,303,243,212,268,5536
E02005892,"King's Walk, Berry Hill & Oakham",Mansfield,East Midlands,2250,7391,718,706,499,746,10060,2334,8008,725,746,521,766,10766
E02005893,Ollerton & Boughton,Newark and Sherwood,East Midlands,2199,6802,610,589,393,523,8917,2206,7480,650,615,435,533,9713
E02005894,Edwinstowe & Clipstone,Newark and Sherwood,East Midlands,2224,6469,620,586,400,569,8644,2283,7213,588,601,453,608,9463
E02005895,"Muskham, Sutton on Trent & Walesby",Newark and Sherwood,East Midlands,1153,4543,639,686,439,520,6827,1150,4757,639,698,501,539,7134
E02005896,"Winthorpe, Coddington & Collingham",Newark and Sherwood,East Midlands,1116,4091,586,736,448,576,6437,1050,4317,548,712,528,582,6687
E02005897,Bilsthorpe & Farnsfield,Newark and Sherwood,East Midlands,1704,5399,617,687,416,581,7700,1579,5734,589,670,461,588,8042
E02005898,Rainworth & Blidworth,Newark and Sherwood,East Midlands,2114,7162,569,512,400,509,9152,2111,7625,627,557,404,553,9766
E02005899,Newark North,Newark and Sherwood,East Midlands,2398,8229,581,479,352,426,10067,2351,8944,613,529,385,477,10948
E02005900,Southwell,Newark and Sherwood,East Midlands,1082,4086,464,632,473,650,6305,1020,4276,458,626,524,697,6581
E02005901,Newark South East,Newark and Sherwood,East Midlands,1991,6109,464,458,358,433,7822,1911,6571,521,461,369,474,8396
E02005902,Newark South West,Newark and Sherwood,East Midlands,1604,4929,524,495,316,474,6738,1706,5338,492,511,330,492,7163
E02005903,Balderton,Newark and Sherwood,East Midlands,1751,5890,648,673,535,599,8345,1732,6320,613,706,594,676,8909
E02005904,"Fernwood, Farndon & Fiskerton",Newark and Sherwood,East Midlands,1751,5456,542,585,403,594,7580,1694,5658,582,600,424,546,7810
E02005905,"Lowdham, Bleasby & Gunthorpe",Newark and Sherwood,East Midlands,916,4167,432,500,312,473,5884,841,4020,442,520,354,493,5829
E02005906,East Bridgford & Aslockton,Rushcliffe,East Midlands,1122,4468,513,478,338,520,6317,1050,4438,513,521,367,502,6341
E02005907,Bingham,Rushcliffe,East Midlands,2104,5955,559,579,438,562,8093,1999,5998,516,584,483,604,8185
E02005908,Radcliffe on Trent & Shelford,Rushcliffe,East Midlands,1619,5204,606,670,495,824,7799,1524,5206,557,666,527,840,7796
E02005909,Lady Bay,Rushcliffe,East Midlands,1837,5538,370,300,173,314,6695,1767,5825,388,351,209,302,7075
E02005910,West Bridgford,Rushcliffe,East Midlands,1615,6948,317,253,141,377,8036,1530,6973,337,293,172,354,8129
E02005911,Gamston & Holme Pierrepoint,Rushcliffe,East Midlands,1769,5501,449,405,235,371,6961,1657,5677,452,438,272,366,7205
E02005912,Compton Acres & Lutterell,Rushcliffe,East Midlands,1812,5740,510,452,339,634,7675,1767,6141,527,509,355,656,8188
E02005913,Edwalton,Rushcliffe,East Midlands,1627,4605,441,406,292,539,6283,1755,5236,431,425,328,565,6985
E02005914,Cotgrave,Rushcliffe,East Midlands,1609,5074,377,387,288,378,6504,1649,5213,403,389,315,386,6706
E02005915,"Cropwell Bishop, Kinoulton & Upper Broughton",Rushcliffe,East Midlands,940,3278,444,456,297,315,4790,862,3366,421,475,335,350,4947
E02005916,Ruddington,Rushcliffe,East Midlands,1531,4745,405,408,308,459,6325,1496,4785,430,415,330,460,6420
E02005917,"Keyworth North, Tollerton & Willoughby",Rushcliffe,East Midlands,886,3068,363,549,352,577,4909,880,3302,374,511,395,620,5202
E02005918,Keyworth South,Rushcliffe,East Midlands,810,2860,347,382,343,426,4358,799,2864,352,361,328,449,4354
E02005919,"Ratcliffe, Sutton Bonington & Gotham",Rushcliffe,East Midlands,1274,4272,337,420,245,341,5615,1236,5284,330,411,326,336,6687
E02005920,East Leake,Rushcliffe,East Midlands,1459,4706,521,639,423,521,6810,1486,5125,525,617,471,543,7281
E02003237,"Glinton, Northborough & Maxey",Peterborough,East of England,940,3302,415,429,272,410,4828,919,3730,428,432,339,450,5379
E02003238,Werrington,Peterborough,East of England,1172,3594,287,222,110,182,4395,1088,4205,325,234,144,192,5100
E02003239,Newborough & Peakirk,Peterborough,East of England,1265,4301,497,509,330,472,6109,1387,5155,549,552,366,539,7161
E02003240,"Barnack, Wittering & Wansford",Peterborough,East of England,1668,4055,326,306,196,237,5120,1388,4478,357,346,216,262,5659
E02003241,Eye & Thorney,Peterborough,East of England,1405,3878,356,375,290,271,5170,1405,4657,365,420,331,385,6158
E02003242,Walton,Peterborough,East of England,1444,4446,506,507,417,633,6509,1514,5334,501,525,438,649,7447
E02003243,Paston,Peterborough,East of England,2905,6480,422,289,202,333,7726,3364,8538,456,342,205,299,9840
E02003244,Dogsthorpe,Peterborough,East of England,2369,5596,365,374,255,504,7094,2747,7193,388,351,264,433,8629
E02003245,North Bretton & Westwood,Peterborough,East of England,2071,4881,297,243,151,193,5765,2267,6544,328,282,157,181,7492
E02003246,Millfield & Bourges Boulevard,Peterborough,East of England,2418,6765,279,234,134,220,7632,2997,10728,323,293,149,224,11717
E02003247,Bretton Park,Peterborough,East of England,1972,5060,406,392,253,287,6398,2100,6483,428,428,263,301,7903
E02003248,Central Park,Peterborough,East of England,2798,7185,332,282,183,442,8424,3358,10319,430,317,203,423,11692
E02003249,Fengate & Parnwell,Peterborough,East of England,3170,7397,430,396,291,406,8920,3360,9603,515,443,305,408,11274
E02003250,Peterborough Central,Peterborough,East of England,2727,8512,399,237,178,417,9743,3202,12399,458,279,177,414,13727
E02003251,Longthorpe & Netherton,Peterborough,East of England,1310,3883,531,524,386,611,5935,1511,4968,522,546,453,664,7153
E02003252,West Town & Woodston,Peterborough,East of England,3251,8316,316,281,178,346,9437,3609,10412,381,337,202,361,11693
E02003253,Fletton,Peterborough,East of England,2291,6250,356,333,243,366,7548,2469,7819,377,341,252,379,9168
E02003254,Orton West & Castor,Peterborough,East of England,1546,4962,600,602,339,551,7054,1575,5835,589,632,417,608,8081
E02003255,Stanground,Peterborough,East of England,2737,6928,526,528,358,596,8936,3175,9120,587,524,386,630,11247
E02003257,Orton Malborne & Goldhay,Peterborough,East of England,2320,5465,407,298,193,250,6613,2487,7070,419,364,213,256,8322
E02006877,Hargate & Orton Longueville,Peterborough,East of England,2330,6082,341,337,286,349,7395,2376,7091,404,338,301,395,8529
E02006878,Hampton Vale,Peterborough,East of England,3276,7485,195,133,97,213,8123,3716,9226,256,207,116,195,10000
E02003258,Bramingham,Luton,East of England,1564,4912,486,519,336,440,6693,1559,5728,527,474,396,521,7646
E02003259,Sundon Park,Luton,East of England,1444,3676,286,251,208,306,4727,1579,4675,326,253,222,305,5781
E02003260,Marsh Farm,Luton,East of England,2292,5037,315,295,188,187,6022,2547,6479,337,280,165,219,7480
E02003261,Warden Hill,Luton,East of England,1135,3379,287,355,316,515,4852,1227,4217,292,308,351,514,5682
E02003262,Leagrave,Luton,East of England,2427,6049,459,413,287,493,7701,2700,7587,480,419,332,454,9272
E02003263,Limbury,Luton,East of England,2999,7125,399,431,377,701,9033,3241,9026,468,423,394,681,10992
E02003264,Barnfield,Luton,East of England,2138,5668,387,327,241,487,7110,2287,6635,438,366,261,492,8192
E02003265,Stopsley North,Luton,East of England,1417,4725,443,432,332,451,6383,1479,5339,473,485,321,422,7040
E02003266,Lewsey North,Luton,East of England,2402,5551,342,229,233,416,6771,2632,7120,366,276,216,368,8346
E02003267,Montrose Avenue,Luton,East of England,4078,8457,378,246,229,340,9650,4390,10851,434,308,216,336,12145
E02003268,Challney,Luton,East of England,3425,7177,343,277,207,405,8409,3573,8863,357,276,218,390,10104
E02003269,Stopsley South & Round Green,Luton,East of England,2111,6496,441,415,305,536,8193,2301,7365,419,415,333,487,9019
E02003270,Lewsey South,Luton,East of England,1821,4908,318,310,264,533,6333,1978,6194,330,322,271,555,7672
E02003271,Wigmore & Airport,Luton,East of England,1999,6393,428,347,182,272,7622,2170,7431,485,400,228,276,8820
E02003272,Kingsway,Luton,East of England,3071,6285,320,159,155,261,7180,3490,9019,414,264,163,325,10185
E02003273,St Anns Hill,Luton,East of England,2635,6761,436,365,216,384,8162,2889,8452,480,386,225,356,9899
E02003274,Bury Park,Luton,East of England,3447,7034,221,175,138,266,7834,3612,9634,382,185,166,293,10660
E02003275,Central Luton & Park Town,Luton,East of England,3165,11658,335,208,174,296,12671,3386,13400,405,272,158,289,14524
E02003276,Dallow Road,Luton,East of England,2612,5797,220,155,90,215,6477,2674,7468,260,177,112,205,8222
E02003277,Farley Hill & Stockwood Park,Luton,East of England,2954,6876,367,290,169,374,8076,3171,8714,407,332,195,324,9972
E02003278,New Town,Luton,East of England,2998,10013,309,271,168,258,11019,2945,10905,345,270,187,217,11924
E02003279,Eastwood Park,Southend-on-Sea,East of England,1592,5289,630,725,492,783,7919,1518,5587,595,699,574,802,8257
E02003280,Eastwood,Southend-on-Sea,East of England,1957,6095,640,663,442,654,8494,2026,6570,578,645,451,637,8881
E02003281,Belfairs,Southend-on-Sea,East of England,1549,5207,613,817,573,867,8077,1531,5595,595,743,602,839,8374
E02003282,Prittlewell,Southend-on-Sea,East of England,2133,6216,590,605,453,647,8511,2091,6833,570,569,465,661,9098
E02003283,Blenheim Park,Southend-on-Sea,East of England,2268,6636,608,576,397,657,8874,2291,7334,568,611,435,647,9595
E02003284,St Lukes,Southend-on-Sea,East of England,2467,7171,522,455,291,419,8858,2429,7708,504,457,307,421,9397
E02003285,Westborough,Southend-on-Sea,East of England,2582,7513,383,312,188,213,8609,2708,8361,441,325,227,264,9618
E02003286,West Leigh,Southend-on-Sea,East of England,1867,5530,502,561,386,596,7575,1884,5810,536,569,424,592,7931
E02003287,Southchurch,Southend-on-Sea,East of England,1981,5605,602,647,435,813,8102,2052,6338,542,699,477,789,8845
E02003288,Victoria,Southend-on-Sea,East of England,3050,8302,420,398,267,452,9839,3051,9451,525,420,264,407,11067
E02003289,Leigh,Southend-on-Sea,East of England,2034,6661,464,460,319,527,8431,1788,6499,478,433,359,513,8282
E02003290,Chalkwell,Southend-on-Sea,East of England,1726,6631,528,456,309,867,8791,1752,6843,554,539,380,771,9087
E02003291,Shoeburyness,Southend-on-Sea,East of England,2440,7325,641,721,407,460,9554,2304,7850,626,680,459,486,10101
E02003292,Kursaal,Southend-on-Sea,East of England,2690,8232,490,375,240,316,9653,2658,9054,514,405,264,327,10564
E02003293,Southend Central,Southend-on-Sea,East of England,1904,7952,401,456,352,638,9799,2111,8897,505,508,360,628,10898
E02003294,Thorpe Bay,Southend-on-Sea,East of England,1424,5129,595,713,557,856,7850,1400,5473,583,699,584,859,8198
E02003295,West Shoebury,Southend-on-Sea,East of England,2242,6100,571,626,390,596,8283,2142,6722,542,603,439,596,8902
E02003296,Corringham North & London Gateway,Thurrock,East of England,1164,3924,501,544,281,390,5640,1150,4389,445,558,324,408,6124
E02003297,Corringham South,Thurrock,East of England,1414,4109,416,455,326,443,5749,1434,4524,366,469,360,418,6137
E02003298,Stanford East,Thurrock,East of England,1212,4015,395,486,266,442,5604,1267,4493,358,483,321,476,6131
E02003299,"Orsett, Bulphan & Hordon-on-the-Hill",Thurrock,East of England,1038,3601,400,365,252,333,4951,1006,4010,381,384,254,381,5410
E02003300,Stanford West,Thurrock,East of England,1868,5234,406,419,264,312,6635,1837,5673,396,455,302,313,7139
E02003301,North Ockendon,Thurrock,East of England,2748,7333,467,442,287,294,8823,2887,8066,507,452,307,331,9663
E02003302,South Ockendon,Thurrock,East of England,2592,6931,419,317,193,280,8140,2454,6963,396,349,202,269,8179
E02003303,Aveley,Thurrock,East of England,2252,5705,425,326,216,263,6935,2189,6097,388,383,218,299,7385
E02003304,Stifford Clays,Thurrock,East of England,2049,5814,519,548,312,542,7735,2048,6522,484,546,326,557,8435
E02003305,Little Thurrock North,Thurrock,East of England,1449,3857,386,387,263,366,5259,1544,4315,365,400,286,353,5719
E02003307,Chadwell St Mary,Thurrock,East of England,2495,5964,477,448,333,621,7843,2520,6744,472,448,328,606,8598
E02003308,East Tilbury,Thurrock,East of England,1741,4516,340,294,181,162,5493,1860,4985,347,332,192,180,6036
E02003309,Little Thurrock South,Thurrock,East of England,1489,4763,384,396,272,328,6143,1466,5150,412,384,265,386,6597
E02003310,"Purfleet, South Stifford & Lakeside",Thurrock,East of England,4013,10424,318,232,147,148,11269,3949,10272,348,257,140,152,11169
E02003311,Grays Chafford Gorges & Orsett Road,Thurrock,East of England,1914,6405,258,279,177,318,7437,2044,6859,294,282,209,332,7976
E02003312,Grays Town,Thurrock,East of England,2757,6782,192,150,96,102,7322,2640,6744,185,162,111,104,7306
E02003313,Tilbury,Thurrock,East of England,4260,8957,478,408,284,361,10488,4396,10324,497,447,283,374,11925
E02006859,South Chafford,Thurrock,East of England,2115,5742,105,95,60,46,6048,2054,5691,165,103,62,51,6072
E02006926,Chafford & North Stifford,Thurrock,East of England,2094,5538,223,168,119,115,6163,1925,5840,241,191,116,131,6519
E02003616,Riseley & Sharnbrook,Bedford,East of England,964,3131,367,390,301,357,4546,934,3584,376,410,310,374,5054
E02003617,"Harrold, Chellington & Turvey",Bedford,East of England,1513,5035,569,610,428,634,7276,1454,5642,574,635,463,584,7898
E02003618,"Clapham, Oakley & Thurleigh",Bedford,East of England,1744,5081,503,535,330,540,6989,1717,5632,483,563,368,536,7582
E02003619,"Wyboston, Great Barford & Cople",Bedford,East of England,2517,6914,686,680,456,562,9298,2361,7619,666,699,509,593,10086
E02003620,Brickhill,Bedford,East of England,1458,4463,508,571,375,660,6577,1476,5103,495,597,371,650,7216
E02003621,Putnoe,Bedford,East of England,1308,4202,564,653,416,627,6462,1328,4992,510,664,467,639,7272
E02003622,Goldington,Bedford,East of England,2090,5446,376,358,307,473,6960,2055,6481,426,398,294,487,8086
E02003623,Bromham & Biddenham,Bedford,East of England,2348,6279,605,602,340,536,8362,2677,7916,613,603,398,533,10063
E02003624,De Parys,Bedford,East of England,919,3639,244,300,194,466,4843,888,4205,271,255,207,441,5379
E02003625,Harpur,Bedford,East of England,1381,5750,403,346,252,627,7378,1343,6947,423,363,259,586,8578
E02003626,Newnham,Bedford,East of England,1040,3480,235,243,153,215,4326,1051,3942,275,251,182,222,4872
E02003627,Castle & Kingsway,Bedford,East of England,1866,7082,401,303,278,457,8521,1894,8565,458,364,257,453,10097
E02003628,Queens Park,Bedford,East of England,2661,5983,256,163,147,273,6822,2854,7400,301,225,127,280,8333
E02003629,Kingsbrook,Bedford,East of England,2405,6420,371,314,211,470,7786,2530,7719,416,330,261,434,9160
E02003630,Cauldwell,Bedford,East of England,2554,7399,348,247,181,260,8435,2670,9000,385,287,183,276,10131
E02003631,Kempston North,Bedford,East of England,1015,3432,307,267,192,247,4445,987,3834,324,307,193,252,4910
E02003632,Kempston Central & East,Bedford,East of England,1207,3712,301,277,156,270,4716,1217,4325,306,277,181,254,5343
E02003633,Kempston West & South,Bedford,East of England,2329,5990,394,375,271,340,7370,2332,7088,428,419,305,322,8562
E02003634,"Elstow, Shortstown & Wixams",Bedford,East of England,3333,7872,578,601,333,435,9819,3722,9527,624,637,397,516,11701
E02003635,Wootton & Stewartby,Bedford,East of England,1883,4522,308,352,252,392,5826,2467,6150,370,346,275,371,7512
E02003599,Sandy North,Central Bedfordshire,East of England,1286,3777,283,233,151,199,4643,1245,3869,285,260,166,205,4785
E02003600,Sandy South,Central Bedfordshire,East of England,1249,4144,393,406,233,268,5444,1178,4016,404,407,281,317,5425
E02003601,Potton,Central Bedfordshire,East of England,1440,4680,523,468,279,355,6305,1450,5016,500,539,332,373,6760
E02003602,"Blunham, Caldecote & Broom",Central Bedfordshire,East of England,987,3648,414,411,330,395,5198,1010,3879,416,444,350,394,5483
E02003603,Biggleswade West,Central Bedfordshire,East of England,2040,7069,522,489,306,488,8874,2201,7270,531,540,366,461,9168
E02003604,Biggleswade East,Central Bedfordshire,East of England,2418,6776,423,423,301,418,8341,2383,6983,487,405,346,409,8630
E02003605,Cranfield & Aspley Guise,Central Bedfordshire,East of England,1818,6052,404,499,353,362,7670,1968,7289,439,480,377,389,8974
E02003606,Houghton Conquest & Clophill,Central Bedfordshire,East of England,1403,4834,501,550,347,489,6721,1508,5493,504,550,399,482,7428
E02003607,"Marston Moretaine, Lidlington & Woburn",Central Bedfordshire,East of England,2223,6820,468,465,370,430,8553,2318,7172,512,530,372,447,9033
E02003608,Arlesey & Henlow,Central Bedfordshire,East of England,2320,7657,652,572,411,532,9824,2267,7786,689,612,425,532,10044
E02003609,Shefford & Shillington,Central Bedfordshire,East of England,2552,7325,521,458,344,422,9070,2432,8101,539,514,373,512,10039
E02003610,Ampthill & Millbrook,Central Bedfordshire,East of England,1719,5360,384,424,276,497,6941,1755,5835,394,432,327,507,7495
E02003611,"Clifton, Meppershall & Stondon",Central Bedfordshire,East of England,1820,5928,524,476,350,495,7773,1858,5835,525,521,379,535,7795
E02003612,Stotfold,Central Bedfordshire,East of England,2883,7635,554,536,366,439,9530,2822,7725,596,556,433,454,9764
E02003613,Flitwick East,Central Bedfordshire,East of England,1061,3748,267,275,208,329,4827,993,3854,262,284,218,365,4983
E02003614,Flitwick West,Central Bedfordshire,East of England,1424,5208,451,379,192,277,6507,1497,5486,470,395,259,250,6860
E02003615,"Westoning, Harlington & Silsoe",Central Bedfordshire,East of England,2006,6048,556,595,366,481,8046,1987,6490,582,629,435,507,8643
E02003636,Barton-le-Clay & Upper Sundon,Central Bedfordshire,East of England,1367,4619,331,382,300,383,6015,1221,4754,355,381,317,391,6198
E02003637,"Toddington, Heath & Reach",Central Bedfordshire,East of England,1805,6105,627,589,443,563,8327,2104,7102,611,611,468,580,9372
E02003638,Leighton Buzzard North & East,Central Bedfordshire,East of England,1507,4525,503,496,278,409,6211,1445,4769,488,544,353,426,6580
E02003639,Leighton Buzzard Central,Central Bedfordshire,East of England,1900,6110,405,424,297,518,7754,1872,6461,433,441,320,529,8184
E02003640,Linslade East,Central Bedfordshire,East of England,1057,3748,392,404,266,347,5157,1064,4016,361,428,269,374,5448
E02003641,Linslade West,Central Bedfordshire,East of England,1012,3434,331,383,223,218,4589,1003,3486,309,384,254,204,4637
E02003642,Houghton Regis North,Central Bedfordshire,East of England,2478,6273,370,272,151,206,7272,2340,6802,415,313,171,200,7901
E02003643,Leighton Buzzard South East,Central Bedfordshire,East of England,3289,8597,438,403,283,376,10097,3346,8855,484,417,326,385,10467
E02003644,Houghton Regis South,Central Bedfordshire,East of England,2118,6277,445,336,265,406,7729,1997,6444,472,376,258,385,7935
E02003645,Dunstable East,Central Bedfordshire,East of England,1259,4479,314,362,239,451,5845,1349,4656,327,319,266,477,6045
E02003646,Dunstable West,Central Bedfordshire,East of England,2376,6423,468,445,308,393,8037,2424,7093,421,506,349,380,8749
E02003647,Dunstable Central,Central Bedfordshire,East of England,1975,6503,370,443,308,636,8260,1954,7052,408,464,317,561,8802
E02003648,Dunstable Manshead,Central Bedfordshire,East of England,1341,3479,242,196,166,313,4396,1264,3730,232,236,156,292,4646
E02003649,Dunstable South,Central Bedfordshire,East of England,1061,4283,323,482,358,368,5814,1075,4326,327,435,369,405,5862
E02003650,"Eaton Bray, Whipsnade & Holywell",Central Bedfordshire,East of England,1119,3910,529,578,330,488,5835,1040,4086,549,555,416,496,6102
E02003651,Caddington & Slip End,Central Bedfordshire,East of England,1162,3926,448,498,343,353,5568,1255,4297,464,501,396,424,6082
E02003719,Kings Hedges,Cambridge,East of England,1813,5157,354,264,210,463,6448,1918,8142,379,293,246,403,9463
E02003720,Arbury,Cambridge,East of England,1597,5556,390,344,233,421,6944,1735,8794,409,389,265,435,10292
E02003721,East Chesterton,Cambridge,East of England,1656,5799,335,312,208,504,7158,1720,8844,396,342,245,514,10341
E02003722,West Chesterton,Cambridge,East of England,1291,5184,390,380,270,397,6621,1268,7773,457,417,304,441,9392
E02003723,Eddington & Castle,Cambridge,East of England,882,8073,223,229,163,294,8982,1200,16537,327,252,197,301,17614
E02003724,East Barnwell & Abbey,Cambridge,East of England,1938,5917,358,270,165,307,7017,1944,8914,410,324,174,308,10130
E02003725,Central & West Cambridge,Cambridge,East of England,1390,12281,365,357,267,479,13749,1467,21752,415,422,325,472,23386
E02003726,Petersfield,Cambridge,East of England,1092,6502,321,193,157,177,7350,1082,10628,342,278,171,186,11605
E02003727,Romsey,Cambridge,East of England,1412,6231,240,182,152,230,7035,1388,9259,288,209,161,230,10147
E02003728,Coleridge,Cambridge,East of England,1580,6121,362,277,201,377,7338,1548,8936,390,308,235,331,10200
E02003729,Cherry Hinton,Cambridge,East of England,1870,4702,381,394,271,422,6170,2057,7231,414,420,322,381,8768
E02003730,Trumpington,Cambridge,East of England,3554,9211,353,387,312,468,10731,3794,14707,419,402,364,477,16369
E02003731,Addenbrooke's & Queen Edith's,Cambridge,East of England,1638,5987,394,352,247,562,7542,1668,9096,439,405,279,508,10727
E02003732,Littleport,East Cambridgeshire,East of England,2061,6099,471,426,317,514,7827,2017,6626,484,470,355,497,8432
E02003733,Little Downham & Sutton,East Cambridgeshire,East of England,1625,5052,517,562,363,409,6903,1497,5406,502,591,376,439,7314
E02003734,North Ely,East Cambridgeshire,East of England,2650,7335,631,634,417,676,9693,2369,7868,581,628,461,749,10287
E02003735,South Ely,East Cambridgeshire,East of England,1793,5682,443,502,355,528,7510,1581,5953,431,459,374,515,7732
E02003736,"Haddenham, Stretham & Witchford",East Cambridgeshire,East of England,2002,5901,626,702,450,515,8194,1904,6446,652,679,497,534,8808
E02003737,Soham,East Cambridgeshire,East of England,2762,8912,679,590,423,606,11210,2745,11978,667,654,430,656,14385
E02003738,"Isleham, Fordham & Chippenham",East Cambridgeshire,East of England,1203,3757,329,414,249,328,5077,1155,4034,396,401,268,352,5451
E02003739,Burwell,East Cambridgeshire,East of England,1241,3708,352,417,268,431,5176,1109,3996,386,385,295,445,5507
E02003740,Swaffham & Bottisham,East Cambridgeshire,East of England,1196,3525,423,405,265,497,5115,1146,3826,409,400,317,476,5428
E02006825,Dullingham & Cheveley,East Cambridgeshire,East of England,1126,3870,440,448,320,398,5476,1006,4217,403,458,298,430,5806
E02003742,"Leverington, Gorefield & Tydd St Giles",Fenland,East of England,1042,3632,554,562,402,472,5622,1065,4149,592,586,408,494,6229
E02003743,Wisbech North,Fenland,East of England,2241,7193,480,531,336,595,9135,2406,8676,523,543,381,587,10710
E02003744,Wisbech South & Peckover,Fenland,East of England,2337,9062,793,741,525,897,12018,2549,10460,809,760,553,790,13372
E02003745,"Wisbech St Mary, Waldersea & Christchurch",Fenland,East of England,1888,5971,676,763,464,552,8426,1840,6617,745,729,529,576,9196
E02003746,March North,Fenland,East of England,1438,4699,420,422,322,455,6318,1384,5054,408,408,343,442,6655
E02003747,Whittlesey,Fenland,East of England,2237,6785,750,789,510,811,9645,2264,7871,775,801,601,843,10891
E02003748,March East,Fenland,East of England,1392,4428,524,547,373,555,6427,1377,4597,497,557,424,541,6616
E02003749,"Coates, Benwick & Pondersbridge",Fenland,East of England,1031,3640,392,409,244,308,4993,1073,3944,412,406,271,294,5327
E02003750,March West,Fenland,East of England,1270,4044,494,543,419,711,6211,1205,4345,490,523,461,655,6474
E02003751,"Doddington, Wimblington & Manea",Fenland,East of England,1245,4032,492,482,330,446,5782,1285,4608,520,532,378,527,6565
E02003752,Chatteris,Fenland,East of England,2108,6689,655,593,440,667,9044,2045,7121,610,621,483,644,9479
E02003753,Yaxley & Farcet,Huntingdonshire,East of England,2248,6934,616,647,388,481,9066,2235,7778,625,672,401,529,10005
E02003754,"Stilton, Elton & Folksworth",Huntingdonshire,East of England,962,3365,419,384,220,333,4721,923,3763,413,421,274,312,5183
E02003755,Ramsey,Huntingdonshire,East of England,1434,5010,476,487,331,408,6712,1523,5545,517,538,376,499,7475
E02003756,Sawtry & Gidding,Huntingdonshire,East of England,1225,4262,419,439,284,331,5735,1220,4680,420,436,332,378,6246
E02003757,Warboys & Bury,Huntingdonshire,East of England,1120,3871,392,406,279,470,5418,1181,4139,418,399,335,355,5646
E02003758,"Somersham, Riptons & Raveleys",Huntingdonshire,East of England,1850,5812,608,531,362,443,7756,1785,6666,602,560,421,478,8727
E02003759,"Bluntisham, Earith & Needingworth",Huntingdonshire,East of England,983,3563,391,429,269,273,4925,915,3724,450,437,291,330,5232
E02003760,Huntingdon Sapley & Oxmoor,Huntingdonshire,East of England,2263,6070,270,237,177,260,7014,2291,7149,312,253,155,254,8123
E02003761,Huntingdon Hartford,Huntingdonshire,East of England,964,3530,349,415,265,432,4991,951,3885,362,439,327,458,5471
E02003762,"Brampton, the Stukeleys and the Alconburys",Huntingdonshire,East of England,1921,5666,519,540,409,513,7647,2142,6597,528,572,459,559,8715
E02003763,St Ives North,Huntingdonshire,East of England,1737,6160,591,510,334,364,7959,1769,6733,565,577,367,379,8621
E02003764,Huntingdon Central & West,Huntingdonshire,East of England,2014,7309,343,331,176,440,8599,1968,7873,388,337,252,439,9289
E02003765,St Ives South,Huntingdonshire,East of England,1212,4367,372,459,315,597,6110,1216,4811,406,464,377,565,6623
E02003766,Godmanchester,Huntingdonshire,East of England,1465,4522,347,379,260,306,5814,1580,5056,346,385,261,334,6382
E02003767,"Kimbolton, Great Staughton & Molesworth",Huntingdonshire,East of England,1127,3895,382,454,289,350,5370,1041,4289,418,426,327,374,5834
E02003768,"Houghton, Hemingford & Fenstanton",Huntingdonshire,East of England,1695,5384,657,780,528,694,8043,1717,5968,649,758,603,734,8712
E02003769,Buckden & Perry,Huntingdonshire,East of England,1045,4557,500,554,420,440,6471,997,4446,479,528,459,434,6346
E02003770,"Little Paxton, Love's Farm & Great Gransden",Huntingdonshire,East of England,2347,6375,491,531,316,380,8093,2540,6994,523,557,372,398,8844
E02003771,St Neots Priory Park,Huntingdonshire,East of England,1070,4029,319,362,266,446,5422,1015,4435,308,365,264,443,5815
E02003772,St Neots Eaton Ford,Huntingdonshire,East of England,1079,3976,457,518,319,400,5670,1049,4188,464,502,382,421,5957
E02003773,St Neots Eynesbury,Huntingdonshire,East of England,2075,7013,465,516,332,442,8768,1965,7368,474,516,383,459,9200
E02003774,St Neots Eaton Socon,Huntingdonshire,East of England,1011,3505,307,354,262,384,4812,992,3677,326,363,290,396,5052
E02003775,Willingham & Over,South Cambridgeshire,East of England,1354,4180,372,410,257,313,5532,1436,4810,409,454,309,362,6344
E02003776,Cottenham,South Cambridgeshire,East of England,1216,3869,387,383,276,462,5377,1325,4484,402,427,298,454,6065
E02003777,"Longstanton, Swavesey & Oakington",South Cambridgeshire,East of England,1957,5028,393,371,250,306,6348,2155,6150,404,384,301,350,7589
E02003778,Waterbeach and Landbeach,South Cambridgeshire,East of England,1254,3973,284,307,205,325,5094,1252,4225,316,324,231,332,5428
E02003779,Bar Hill & Boxworth,South Cambridgeshire,East of England,865,3123,345,303,188,203,4162,867,3278,345,316,226,231,4396
E02003780,"HIston, Impington & Orchard Park",South Cambridgeshire,East of England,2316,7744,502,502,316,711,9775,2332,8347,525,550,361,699,10482
E02003781,"Milton, Fen Ditton & Quy",South Cambridgeshire,East of England,1127,4203,344,285,175,303,5310,1118,4702,353,289,245,310,5899
E02003783,Girton & Barton,South Cambridgeshire,East of England,1271,4583,399,425,313,599,6319,1315,5262,426,414,333,642,7077
E02003784,Hardwick & Highfields,South Cambridgeshire,East of England,1691,5124,460,560,325,454,6923,1611,5772,486,532,391,512,7693
E02003785,Fulbourn & Teversham,South Cambridgeshire,East of England,1751,5663,416,441,341,561,7422,1708,6110,454,409,353,508,7834
E02003786,Great Shelford & Stapleford,South Cambridgeshire,East of England,1264,3700,368,367,312,577,5324,1205,4178,386,402,333,566,5865
E02003787,"Barrington, Orwell & Gamlingay",South Cambridgeshire,East of England,1323,4123,499,561,326,466,5975,1322,4574,540,559,392,543,6608
E02003788,"Little Shelford , Foxton & Haslingfield",South Cambridgeshire,East of England,1547,4308,372,440,368,429,5917,1689,5088,354,431,402,464,6739
E02003789,Sawston,South Cambridgeshire,East of England,1344,4155,455,453,341,485,5889,1436,4855,426,468,332,486,6567
E02003790,Linton & Balsham,South Cambridgeshire,East of England,1716,5373,647,634,388,661,7703,1631,6058,626,673,442,695,8494
E02003791,"Duxford, Whittlesford & the Abingtons",South Cambridgeshire,East of England,1547,4847,435,474,324,397,6477,1612,5387,506,474,389,461,7217
E02003792,"Meldreth, Melbourn & Great Chishill",South Cambridgeshire,East of England,1885,5542,573,655,446,563,7779,1904,6407,579,647,494,630,8757
E02003793,Bassingbourn & the Mordens,South Cambridgeshire,East of England,1302,4255,368,471,289,314,5697,1377,4591,375,457,323,346,6092
E02006873,Cambourne,South Cambridgeshire,East of England,2927,6060,108,135,82,157,6542,2977,6750,115,125,104,158,7252
E02006874,"Papworth, Caxton & Fen Drayton",South Cambridgeshire,East of England,2380,6012,457,403,262,350,7484,2428,7140,458,428,302,373,8701
E02004424,Billericay North East,Basildon,East of England,1362,4206,423,465,306,343,5743,1418,4568,403,466,331,398,6166
E02004425,Billericay Queen's Park,Basildon,East of England,1433,4549,347,374,225,444,5939,1426,4828,363,393,248,438,6270
E02004426,Billericay Central & Sunnymede,Basildon,East of England,1516,4918,349,431,293,578,6569,1552,5330,371,427,340,576,7044
E02004427,Billericay Tye Common,Basildon,East of England,1467,4411,428,542,422,643,6446,1477,4894,402,540,442,690,6968
E02004428,Wickford North East,Basildon,East of England,1311,4079,325,384,285,561,5634,1293,4354,335,398,304,562,5953
E02004429,Wickford West,Basildon,East of England,1146,4141,461,599,420,615,6236,1206,4633,460,606,431,632,6762
E02004430,Wickford Shotgate,Basildon,East of England,1613,5141,424,434,271,361,6631,1653,5440,438,444,339,367,7028
E02004431,Wickford South,Basildon,East of England,2044,6402,405,422,256,302,7787,2135,6648,390,438,295,299,8070
E02004432,Bursteads,Basildon,East of England,1327,4144,398,434,300,382,5658,1356,4507,440,417,329,382,6075
E02004433,Steeple View & Noak Bridge,Basildon,East of England,1865,5657,394,448,242,412,7153,1740,5767,417,433,288,395,7300
E02004434,Felmore & Bowers Gifford,Basildon,East of England,1819,5553,441,389,253,309,6945,1779,5855,460,426,274,294,7309
E02004435,Whitmore Way & Fremnells,Basildon,East of England,2243,5839,361,311,215,370,7096,2388,6516,373,324,217,337,7767
E02004436,Chalvedon,Basildon,East of England,2039,5017,409,332,204,246,6208,2133,5577,421,395,224,229,6846
E02004437,Laindon West & Southfields,Basildon,East of England,1939,5781,449,474,295,398,7397,2124,6300,458,510,306,429,8003
E02004438,Basildon Central & Pipps Hill,Basildon,East of England,2226,6021,336,320,208,635,7520,2382,6523,354,345,217,494,7933
E02004439,Laindon Central,Basildon,East of England,2795,6385,284,261,168,230,7328,2657,6720,290,269,165,223,7667
E02004440,Laindon East & Lee Chapel North,Basildon,East of England,1935,5301,311,262,255,411,6540,2176,6504,315,289,235,426,7769
E02004441,Eversley,Basildon,East of England,1583,4695,438,432,276,314,6155,1699,5301,442,469,317,324,6853
E02004442,Barstable,Basildon,East of England,2362,5343,315,282,193,242,6375,2307,5904,357,302,192,275,7030
E02004443,Lee Chapel South & Kingswood,Basildon,East of England,1992,6446,398,374,265,494,7977,2084,7253,420,397,262,463,8795
E02004444,Langdon Hills,Basildon,East of England,1726,5902,485,446,304,361,7498,1740,6213,485,469,300,388,7855
E02004445,Vange & Pitsea,Basildon,East of England,1801,5484,357,393,253,333,6820,1803,5692,364,390,284,305,7035
E02004446,Steeple Bumpstead & Great Yeldham,Braintree,East of England,1169,4139,454,463,284,358,5698,1075,4308,471,505,320,372,5976
E02004447,"Bures Hamlet, Maplestead & Belchamp",Braintree,East of England,823,3477,465,500,302,348,5092,797,3527,460,497,371,368,5223
E02004448,"Hedingham, Gosfield & Greenstead Green",Braintree,East of England,1336,4223,449,465,340,378,5855,1349,4613,460,458,359,470,6360
E02004449,Halstead Central & West,Braintree,East of England,1747,5138,446,458,327,454,6823,1694,5428,447,449,363,405,7092
E02004450,"Panfield, Finchingfield & Bardfield",Braintree,East of England,982,3776,436,482,303,375,5372,971,4004,431,495,326,400,5656
E02004451,Halstead East & Colnes,Braintree,East of England,1610,5028,561,564,459,632,7244,1575,5556,599,626,476,621,7878
E02004452,Bocking Churchstreet & Blackwater,Braintree,East of England,1667,5403,553,638,369,651,7614,1671,5581,515,633,427,633,7789
E02004453,Bocking,Braintree,East of England,1630,4354,340,337,281,348,5660,1550,4653,330,325,275,345,5928
E02004454,Central Braintree,Braintree,East of England,1683,6112,435,460,266,511,7784,1660,6136,442,465,325,466,7834
E02004455,Braintree West & Rayne,Braintree,East of England,1514,4825,413,517,286,317,6358,1444,4995,412,491,338,326,6562
E02004456,Braintree South,Braintree,East of England,2176,6303,435,424,261,385,7808,1971,6336,494,427,300,368,7925
E02004457,Silver End & Stisted,Braintree,East of England,2139,6383,482,517,324,502,8208,2178,6791,484,518,344,484,8621
E02004458,Great Notley & Black Notley,Braintree,East of England,2043,5856,495,498,324,464,7637,2005,6325,437,500,355,511,8128
E02004459,Coggeshall & Kelvedon,Braintree,East of England,1937,6194,664,686,475,670,8689,1788,6290,648,747,482,682,8849
E02004460,North Witham,Braintree,East of England,1866,5587,501,538,342,343,7311,1869,5935,506,573,421,406,7841
E02004461,West Witham,Braintree,East of England,1389,3697,250,254,153,152,4506,1333,3843,246,290,150,142,4671
E02004462,Witham Town,Braintree,East of England,2122,7054,527,548,376,606,9111,2122,7102,561,554,396,620,9233
E02004463,"Witham South, Hatfield Peverel & White Notley",Braintree,East of England,1455,4668,519,485,330,544,6546,1480,5091,528,500,389,521,7029
E02004464,Kelvedon Hatch & Doddinghurst,Brentwood,East of England,1744,5812,642,696,486,735,8371,1731,6412,644,698,567,748,9069
E02004465,Ingatestone & Mountnessing,Brentwood,East of England,1021,3640,351,400,295,553,5239,1016,4041,333,395,305,532,5606
E02004466,Hutton,Brentwood,East of England,1657,5064,351,356,264,530,6565,1680,5436,428,376,291,507,7038
E02004467,Brentwood North,Brentwood,East of England,1894,5003,409,416,256,367,6451,1794,5353,391,423,275,388,6830
E02004468,Shenfield & Hutton Mount,Brentwood,East of England,1946,6113,493,605,456,898,8565,1991,6652,548,566,515,874,9155
E02004469,Brook Street & Pilgrim's Hatch,Brentwood,East of England,1377,4114,385,441,252,436,5628,1424,4623,396,410,284,397,6110
E02004470,Brentwood Central,Brentwood,East of England,2161,8007,386,451,299,597,9740,2145,8355,420,433,318,623,10149
E02004471,Brentwood South & Warley,Brentwood,East of England,1638,5337,397,369,268,514,6885,1700,5826,429,400,273,480,7408
E02004472,"Herongate, Ingrave & West Horndon",Brentwood,East of England,993,3815,344,373,197,417,5146,1019,4082,345,377,200,424,5428
E02004473,Benfleet North,Castle Point,East of England,1480,4594,408,551,390,498,6441,1481,4873,404,492,399,532,6700
E02004474,New Thundersley,Castle Point,East of England,1296,4345,502,586,399,619,6451,1317,4818,458,550,445,602,6873
E02004475,Benfleet Appleton,Castle Point,East of England,1177,4012,411,464,328,394,5609,1176,4246,415,463,384,440,5948
E02004476,Thundersley Glen,Castle Point,East of England,1357,4775,463,597,411,510,6756,1305,4993,410,582,451,562,6998
E02004477,Hadleigh North,Castle Point,East of England,852,3239,463,501,396,598,5197,848,3340,420,498,381,569,5208
E02004478,Hadleigh South,Castle Point,East of England,1080,3837,373,428,301,522,5461,1092,4174,352,421,315,587,5849
E02004479,South Benfleet,Castle Point,East of England,1405,4954,457,559,393,602,6965,1338,5117,449,568,422,583,7139
E02004480,Canvey Island Winter Gardens,Castle Point,East of England,1499,4337,462,443,223,220,5685,1494,4605,403,457,288,228,5981
E02004481,Canvey Island Newlands,Castle Point,East of England,1005,3365,538,749,530,645,5827,927,3522,493,713,591,718,6037
E02004482,Canvey Island North West,Castle Point,East of England,1867,5148,439,451,276,370,6684,1909,5857,449,456,306,396,7464
E02004483,Canvey Island South West,Castle Point,East of England,1234,4797,640,654,473,546,7110,1240,4793,622,711,524,590,7240
E02004484,Canvey Island Leigh Beck,Castle Point,East of England,1212,4585,585,649,427,480,6726,1378,5366,597,684,467,542,7656
E02004485,Great Leighs & the Walthams,Chelmsford,East of England,1888,4968,427,479,253,390,6517,2129,6002,422,502,349,380,7655
E02004486,South Broomfield,Chelmsford,East of England,1683,5112,433,539,373,578,7035,1632,5552,452,523,399,601,7527
E02004487,"Melbourne Park, Chignall & Pleshey",Chelmsford,East of England,1698,4470,431,386,264,375,5926,1694,4890,422,427,304,376,6419
E02004488,Springfield North,Chelmsford,East of England,1852,5565,487,482,269,480,7283,1984,6197,542,518,319,454,8030
E02004489,Boreham & Little Baddow,Chelmsford,East of England,2092,5719,406,429,287,336,7177,2033,6296,419,477,316,390,7898
E02004490,Melbourne,Chelmsford,East of England,1904,5182,306,339,220,324,6371,1768,5569,338,323,235,334,6799
E02004491,Springfield South & Coronation Park,Chelmsford,East of England,1532,4857,346,395,232,417,6247,1487,5006,376,372,265,391,6410
E02004492,Chelmer Village,Chelmsford,East of England,1900,6396,323,318,192,286,7515,1845,6695,403,372,230,280,7980
E02004493,Waterhouse Lane & Admirals Park,Chelmsford,East of England,2046,7080,359,331,255,455,8480,2068,7690,410,375,263,443,9181
E02004494,Central Chelmsford,Chelmsford,East of England,1801,9479,340,327,243,555,10944,1936,10651,339,361,267,555,12173
E02004495,Writtle & Highwood,Chelmsford,East of England,1354,4901,500,570,435,752,7158,1342,5106,470,550,482,755,7363
E02004496,Moulsham West,Chelmsford,East of England,1763,4863,305,369,293,489,6319,1751,5286,306,363,296,560,6811
E02004497,Great Baddow North & East,Chelmsford,East of England,1298,4438,422,545,437,670,6512,1268,4744,413,533,475,738,6903
E02004498,Great Baddow South & West,Chelmsford,East of England,1976,6164,463,550,341,515,8033,1973,6585,436,542,375,522,8460
E02004499,Moulsham East,Chelmsford,East of England,1272,4155,358,397,283,343,5536,1292,4429,335,401,292,354,5811
E02004500,Danbury & Bicknacre,Chelmsford,East of England,1647,5217,569,664,437,615,7502,1627,5681,580,646,531,674,8112
E02004501,Galleywood,Chelmsford,East of England,1324,4016,443,496,345,464,5764,1270,4168,446,503,367,481,5965
E02004502,"Margaretting, Stock & Ramsden",Chelmsford,East of England,1156,4159,427,496,362,491,5935,1060,4627,531,472,411,566,6607
E02004503,South Woodham Ferrers North,Chelmsford,East of England,1594,4698,502,549,272,367,6388,1561,5145,499,572,337,369,6922
E02004504,South Woodham Ferrers South,Chelmsford,East of England,1425,5148,515,445,175,288,6571,1426,5456,575,493,253,284,7061
E02004505,Rettendon & Runwell,Chelmsford,East of England,925,3367,405,485,310,478,5045,1048,3616,367,533,368,499,5383
E02004506,"Horkesley Heath, Langham & Dedham",Colchester,East of England,1239,4216,457,523,294,420,5910,1273,4439,464,494,338,458,6193
E02004507,Highwoods,Colchester,East of England,2283,6572,335,316,175,252,7650,2104,7012,352,363,228,274,8229
E02004508,West Bergholt & Wormingford,Colchester,East of England,1131,3777,420,465,330,388,5380,1144,4046,395,477,357,419,5694
E02004509,Mile End & Braiswick,Colchester,East of England,3438,10104,390,370,255,328,11447,3757,10993,410,448,272,371,12494
E02004512,Central Colchester,Colchester,East of England,2030,7785,424,447,330,594,9580,1978,8279,427,474,361,650,10191
E02004513,Greenstead,Colchester,East of England,2152,10200,355,343,271,269,11438,1960,10805,338,368,252,287,12050
E02004514,Lexden,Colchester,East of England,1121,3283,264,341,237,422,4547,1113,3789,294,353,260,447,5143
E02004515,Marks Tey & Wakes Colne,Colchester,East of England,1724,5158,517,524,337,409,6945,1982,5976,510,541,373,416,7816
E02004516,New Town & Hythe,Colchester,East of England,2895,10223,311,306,162,197,11199,2888,9566,346,335,213,230,10690
E02004517,Stanway,Colchester,East of England,1693,5410,486,561,376,610,7443,1797,5813,480,590,439,655,7977
E02004518,Abbey Field,Colchester,East of England,1788,5057,313,258,192,261,6081,1780,7405,273,344,231,282,8535
E02004519,Prettygate & Westlands,Colchester,East of England,1239,4071,490,499,353,662,6075,1238,4604,476,503,398,657,6638
E02004520,Shrub End,Colchester,East of England,2575,6062,253,257,169,213,6954,2592,5765,291,272,185,208,6721
E02004521,Old Heath & Rowhedge,Colchester,East of England,1746,5938,458,406,252,389,7443,1775,6237,467,465,295,400,7864
E02004522,Wivenhoe & University,Colchester,East of England,1275,8875,473,573,407,407,10735,1287,10798,481,567,427,451,12724
E02004523,Monkwick,Colchester,East of England,2321,6607,425,415,207,360,8014,2416,6821,424,427,255,359,8286
E02004524,"Layer-de-la-Haye, Abberton & Mersea East",Colchester,East of England,1444,4912,582,614,380,458,6946,1359,5058,582,632,430,469,7171
E02004525,Tiptree,Colchester,East of England,1185,4265,539,640,452,516,6412,1280,4649,497,677,516,592,6931
E02004526,West Mersea,Colchester,East of England,947,3654,654,743,519,768,6338,913,3820,601,758,579,768,6526
E02006922,Parson's Heath,Colchester,East of England,2373,8320,808,901,630,911,11570,2548,8935,810,872,720,951,12288
E02004527,"North Weald, Matching & Sheering",Epping Forest,East of England,1522,5461,486,519,369,494,7329,1608,5929,512,557,428,526,7952
E02004528,"Roydon, Lower Nazeing & Epping Green",Epping Forest,East of England,1318,5042,511,596,391,569,7109,1635,6391,575,593,450,619,8628
E02004529,"Fyfield, High Ongar & Stapleford Abbotts",Epping Forest,East of England,1094,4179,414,458,301,391,5743,1223,4680,456,477,333,415,6361
E02004530,Chipping Ongar,Epping Forest,East of England,1310,3664,379,432,251,519,5245,1436,4105,398,429,298,516,5746
E02004531,Epping North,Epping Forest,East of England,1474,4037,408,373,278,508,5604,1422,4506,393,420,272,466,6057
E02004532,Epping South,Epping Forest,East of England,1156,3838,344,365,227,445,5219,1137,4083,356,382,270,382,5473
E02004533,Waltham Abbey North,Epping Forest,East of England,1509,4487,355,406,264,482,5994,1494,4996,384,430,313,488,6611
E02004534,Waltham Abbey South,Epping Forest,East of England,1964,5722,355,393,271,339,7080,1902,6000,388,404,322,372,7486
E02004535,Waltham Abbey West & Outer,Epping Forest,East of England,989,3579,344,390,239,383,4935,1009,3921,355,369,280,361,5286
E02004536,Theydon Bois & Abridge,Epping Forest,East of England,1085,3603,410,413,274,478,5178,1062,3856,417,440,287,459,5459
E02004537,Loughton East,Epping Forest,East of England,1924,6059,364,281,246,343,7293,1938,6678,387,319,227,326,7937
E02004538,Loughton North,Epping Forest,East of England,1854,6191,403,462,319,568,7943,1826,6804,468,505,364,575,8716
E02004539,Loughton South,Epping Forest,East of England,1699,5075,310,303,246,375,6309,1587,5477,343,323,253,359,6755
E02004540,Loughton West,Epping Forest,East of England,1204,3777,300,261,196,328,4862,1158,4191,310,288,233,346,5368
E02004541,Buckhurst Hill,Epping Forest,East of England,2366,7243,483,569,442,679,9416,2401,8212,553,585,487,685,10522
E02004542,Chigwell,Epping Forest,East of England,1100,4145,389,359,223,425,5541,1206,4512,422,406,260,427,6027
E02004543,Grange Hill,Epping Forest,East of England,1519,4561,337,274,245,385,5802,1603,5117,346,326,249,392,6430
E02004544,Old Harlow & Newhall,Harlow,East of England,2019,5327,418,408,276,437,6866,2233,6639,469,443,305,421,8277
E02004545,Mark Hall & Templefields,Harlow,East of England,1688,4797,349,279,172,372,5969,1812,5656,404,299,181,343,6883
E02004546,Nettleswell,Harlow,East of England,1792,5005,371,272,187,389,6224,1843,6021,402,290,196,344,7253
E02004547,Little Parndon & Hare Street,Harlow,East of England,2172,5970,305,239,173,427,7114,2458,7292,383,288,197,381,8541
E02004548,Church Langley,Harlow,East of England,2088,5636,295,301,197,189,6618,2005,6172,333,321,214,231,7271
E02004549,Bush Fair & Brays Grove,Harlow,East of England,1819,4849,318,225,214,412,6018,1813,5586,363,276,215,425,6865
E02004550,Passmores & The High,Harlow,East of England,1952,5149,285,287,258,520,6499,2026,6122,359,309,239,492,7521
E02004551,Potter Street,Harlow,East of England,1704,4417,353,300,246,400,5716,1748,5096,398,315,242,388,6439
E02004552,Great Parndon & Katherines,Harlow,East of England,1219,3870,406,391,214,261,5142,1236,4454,411,431,254,283,5833
E02004553,Staple Tye & Latton Bush,Harlow,East of England,1696,4354,281,267,228,344,5474,1843,5347,312,272,222,322,6475
E02004554,Kingsmoor,Harlow,East of England,1642,4501,331,333,215,256,5636,1679,5402,360,331,243,294,6630
E02004555,"Tollesbury, Tolleshunt & Goldhanger",Maldon,East of England,1023,3684,519,534,302,373,5412,1010,3896,462,538,342,403,5641
E02004556,"Great Totham, Wickham Bishops & Woodham",Maldon,East of England,1239,4126,519,654,431,522,6252,1236,4517,504,604,521,556,6702
E02004557,Heybridge,Maldon,East of England,1543,5217,505,529,329,425,7005,1564,5426,527,549,331,472,7305
E02004558,Maldon North,Maldon,East of England,1081,4004,360,494,330,670,5858,1077,4013,368,438,369,656,5844
E02004559,Maldon South,Maldon,East of England,1207,4503,539,560,383,519,6504,1212,4834,481,581,442,541,6879
E02004560,"Southminster, Bradwell & Dengie Peninsula",Maldon,East of England,1635,5423,613,619,401,486,7542,1548,5803,583,653,449,523,8011
E02004561,"Mayland, Althorne & Cold Norton",Maldon,East of England,1642,6417,738,776,501,593,9025,1604,6750,743,775,552,635,9455
E02004562,Burnham-on-Crouch,Maldon,East of England,1231,4499,622,657,418,531,6727,1365,4935,631,639,508,543,7256
E02004563,Hullbridge,Rochford,East of England,860,3561,535,643,436,524,5699,916,3863,486,645,473,580,6047
E02004564,Ashingdon,Rochford,East of England,1303,4955,532,557,379,528,6951,1263,5012,525,570,404,570,7081
E02004565,Hockley & Hawkwell West,Rochford,East of England,2674,9534,931,1056,782,1031,13334,2609,9761,898,975,841,1063,13538
E02004566,Rochford Town & Canewdon,Rochford,East of England,1211,3715,276,280,183,325,4779,1118,3745,275,300,191,327,4838
E02004567,Rayleigh North East,Rochford,East of England,1414,4769,502,578,363,634,6846,1333,5121,442,566,408,671,7208
E02004568,Rayleigh North West,Rochford,East of England,1910,5847,395,414,306,341,7303,1787,5791,391,440,294,357,7273
E02004569,Rochford Outer & Hawkwell East,Rochford,East of England,1415,5032,382,455,288,483,6640,1625,5542,431,454,355,498,7280
E02004570,Rayleigh South West,Rochford,East of England,1553,5163,501,637,394,686,7381,1530,5317,503,589,466,739,7614
E02004571,Rayleigh South East,Rochford,East of England,1367,4661,532,585,403,642,6823,1339,4750,455,584,442,622,6853
E02004572,Great Wakering & Foulness,Rochford,East of England,1382,4769,519,536,321,378,6523,1394,5095,502,541,340,412,6890
E02004573,Harwich Town & Dovercourt,Tendring,East of England,1327,3903,366,323,230,380,5202,1275,4082,372,360,251,397,5462
E02004574,Harwich Parkeston,Tendring,East of England,1684,4403,433,481,366,457,6140,1628,4638,436,477,359,490,6400
E02004575,Manningtree & Mistley,Tendring,East of England,1988,6830,762,781,542,784,9699,1938,7252,792,793,601,829,10267
E02004576,Harwich West & South,Tendring,East of England,1486,5010,659,720,518,717,7624,1440,5239,643,702,582,747,7913
E02004577,Elmstead Market & Ardleigh,Tendring,East of England,974,3412,385,349,250,310,4706,989,3773,357,374,268,323,5095
E02004578,Walton & Frinton Coastal,Tendring,East of England,978,3415,641,860,531,906,6353,1011,3773,629,791,616,894,6703
E02004579,Weeley & Thorpe-le-Soken,Tendring,East of England,1093,3874,621,685,475,518,6173,1170,4515,659,723,517,575,6989
E02004580,Frinton West & Kirby,Tendring,East of England,1568,5749,1058,1380,965,1474,10626,1509,5912,1077,1372,1033,1511,10905
E02004581,"Alresford, Great Bentley & Thorrington",Tendring,East of England,1267,4325,591,681,456,597,6650,1377,4939,603,690,535,616,7383
E02004582,Clacton North,Tendring,East of England,942,3412,612,762,564,711,6061,889,3599,600,702,582,725,6208
E02004583,Brightlingsea & Point Clear,Tendring,East of England,1451,4887,598,800,472,645,7402,1473,5330,588,749,562,669,7898
E02004584,Holland-on-Sea,Tendring,East of England,674,2866,654,948,652,898,6018,645,2979,561,900,699,944,6083
E02004585,Clacton Bocking's Elm,Tendring,East of England,1601,4802,603,679,469,520,7073,1638,5239,582,730,521,573,7645
E02004586,Clacton East,Tendring,East of England,1395,4462,550,677,483,802,6974,1412,4808,564,653,500,831,7356
E02004587,Clacton Rush Green,Tendring,East of England,1801,4488,516,496,368,449,6317,1807,4904,502,485,394,469,6754
E02004588,Clacton Central,Tendring,East of England,1325,4334,370,356,266,528,5854,1432,4938,379,374,303,569,6563
E02004589,Clacton West,Tendring,East of England,1461,4268,463,542,386,613,6272,1333,4415,413,527,421,636,6412
E02004590,Jaywick & St Osyth,Tendring,East of England,1093,4311,770,885,644,699,7309,1139,4830,733,871,692,807,7933
E02004591,"Audley End, Ashdon & the Chesterfords",Uttlesford,East of England,1398,4468,437,411,290,430,6036,1412,4771,450,469,332,412,6434
E02004592,Saffron Walden Town,Uttlesford,East of England,2643,8109,697,682,561,976,11025,2576,8416,730,682,530,939,11297
E02004593,"Newport, Littlebury & Clavering",Uttlesford,East of England,1649,5071,563,590,348,488,7060,1602,5476,577,620,400,526,7599
E02004594,"Thaxted, Great Sampford & Radwinter",Uttlesford,East of England,1598,5341,462,522,351,442,7118,1538,5731,467,507,406,499,7610
E02004595,Stansted Mountfitchet & Elsenham,Uttlesford,East of England,2967,8889,699,736,499,701,11524,3024,9536,755,805,555,701,12352
E02004596,"Takeley, Airport & Mountfitchet South",Uttlesford,East of England,2451,6563,443,460,314,373,8153,2346,6783,461,492,367,418,8521
E02004597,Great Dunmow,Uttlesford,East of England,1648,5373,436,441,289,454,6993,1791,5656,454,459,344,475,7388
E02004598,"Flitch Green, Felsted & High Easter",Uttlesford,East of England,2327,6648,599,583,424,625,8879,2200,6941,601,606,481,639,9268
E02004599,"Hatfield Heath, Hallingburys & Rodings",Uttlesford,East of England,1453,4758,404,469,308,423,6362,1405,5061,451,465,360,470,6807
E02004843,Hoddesdon Ware Road,Broxbourne,East of England,1321,4054,366,447,325,447,5639,1350,4681,368,457,381,482,6369
E02004844,Rye Park,Broxbourne,East of England,1564,4611,295,294,185,369,5754,1562,5261,311,289,207,360,6428
E02004845,Hoddesdon Town,Broxbourne,East of England,1533,4847,350,439,285,531,6452,1552,5532,365,413,311,524,7145
E02004846,Broxbourne Town,Broxbourne,East of England,1144,3583,337,431,271,418,5040,1165,4211,389,396,323,455,5774
E02004847,Wormley & Turnford,Broxbourne,East of England,2536,6600,421,412,308,384,8125,2416,6918,443,443,303,403,8510
E02004848,Flamstead End,Broxbourne,East of England,1666,4705,357,353,257,324,5996,1663,5136,353,381,284,322,6476
E02004849,Goffs Oak,Broxbourne,East of England,1161,4257,364,361,273,345,5600,1215,4653,372,388,270,379,6062
E02004850,Cheshunt Coopers Walk,Broxbourne,East of England,1464,4730,327,353,214,417,6041,1455,5101,329,342,260,413,6445
E02004851,Rosedale,Broxbourne,East of England,1235,3598,274,307,213,302,4694,1181,3894,294,319,230,276,5013
E02004852,Cheshunt Central,Broxbourne,East of England,1603,4745,323,343,266,515,6192,1580,5335,337,350,270,521,6813
E02004853,Churchgate,Broxbourne,East of England,1415,4004,291,323,215,391,5224,1470,4588,315,338,231,367,5839
E02004854,Cheshunt South,Broxbourne,East of England,1494,4842,298,320,258,518,6236,1443,5231,326,330,261,501,6649
E02004855,Waltham Cross Town,Broxbourne,East of England,1788,5414,253,248,199,248,6362,1855,6074,285,251,195,264,7069
E02004856,"Markyate, Flamstead & Gaddesden",Dacorum,East of England,1092,3579,297,286,208,226,4596,1121,3797,358,289,189,258,4891
E02004857,Tring West & Long Marston,Dacorum,East of England,1131,3620,334,314,213,365,4846,1125,4044,318,349,226,396,5333
E02004858,Tring North,Dacorum,East of England,1054,3175,241,282,164,238,4100,1058,3503,248,258,196,215,4420
E02004859,"Tring East, Wigginton & Aldbury",Dacorum,East of England,1003,3028,337,365,207,319,4256,974,3310,313,379,237,324,4563
E02004860,Woodhall Farm,Dacorum,East of England,1306,4069,277,175,98,78,4697,1307,4252,283,237,136,110,5018
E02004861,Northchurch & Potten End,Dacorum,East of England,961,3031,338,395,258,509,4531,955,3321,354,418,288,501,4882
E02004862,Grovehill,Dacorum,East of England,1759,4984,469,356,196,230,6235,1771,5366,509,420,212,218,6725
E02004863,Highfield,Dacorum,East of England,1911,4971,288,250,185,424,6118,1898,5521,334,258,218,400,6731
E02004864,Berkhamsted Town,Dacorum,East of England,1179,3965,372,324,234,473,5368,1164,4253,374,359,254,451,5691
E02004865,Gadebridge & Old Town,Dacorum,East of England,1114,3689,209,252,127,290,4567,1068,3869,247,226,150,271,4763
E02004866,Warners End,Dacorum,East of England,1443,4188,278,274,202,375,5317,1377,4460,337,262,192,350,5601
E02004867,Berkhamsted West,Dacorum,East of England,1565,3861,300,326,209,396,5092,1563,4193,298,353,221,346,5411
E02004868,Maylands & Adeyfield,Dacorum,East of England,1749,4341,268,271,176,438,5494,1920,5042,299,252,194,363,6150
E02004869,Berkhamsted South,Dacorum,East of England,1258,3538,271,243,190,292,4534,1278,3959,280,270,202,318,5029
E02004870,Hemel Hempstead Town,Dacorum,East of England,2406,7378,436,360,273,500,8947,2404,8298,470,378,292,560,9998
E02004871,Chaulden,Dacorum,East of England,1038,3300,249,191,178,240,4158,1023,3559,257,201,162,261,4440
E02004872,Leverstock Green,Dacorum,East of England,1432,4434,361,390,296,501,5982,1468,4877,368,394,320,517,6476
E02004873,Boxmoor & Apsley,Dacorum,East of England,2159,7656,494,469,306,444,9369,2145,7813,500,492,352,458,9615
E02004874,Corner Hall,Dacorum,East of England,1280,3974,296,234,182,258,4944,1167,4279,317,263,174,243,5276
E02004875,Nash Mills & Bennetts End,Dacorum,East of England,2402,6393,392,353,218,408,7764,2415,7250,422,385,255,340,8652
E02004876,Bovingdon & Chipperfield,Dacorum,East of England,1535,5833,499,569,398,515,7814,1503,6378,506,544,466,535,8429
E02004877,Kings Langley,Dacorum,East of England,981,3154,265,289,225,343,4276,949,3601,270,282,245,435,4833
E02004896,Potters Bar Parkfield,Hertsmere,East of England,1292,4758,418,518,439,894,7027,1204,5428,468,480,421,843,7640
E02004897,Potters Bar Furzefield,Hertsmere,East of England,1327,3997,328,417,235,391,5368,1319,4581,366,395,261,373,5976
E02004898,Potters Bar Oakmere,Hertsmere,East of England,1476,4624,416,374,267,480,6161,1445,5399,451,377,296,437,6960
E02004899,Shenley & South Mimms,Hertsmere,East of England,1230,3230,276,245,175,299,4225,1211,3857,288,321,196,311,4973
E02004900,Radlett,Hertsmere,East of England,1651,4715,417,444,317,564,6457,1626,5877,449,436,361,586,7709
E02004901,Borehamwood Cowley Hill,Hertsmere,East of England,2142,5690,364,346,240,363,7003,2274,7053,382,347,238,345,8365
E02004902,Borehamwood Brookmeadow,Hertsmere,East of England,2245,5064,361,267,199,297,6188,2058,6273,356,351,214,295,7489
E02004903,Bushey North,Hertsmere,East of England,1645,4959,272,297,198,309,6035,1645,5465,298,299,190,316,6568
E02004904,Borehamwood Kenilworth,Hertsmere,East of England,1467,4164,240,241,139,175,4959,1396,4720,293,261,165,209,5648
E02004905,Elstree & Aldenham,Hertsmere,East of England,1394,3964,323,352,208,339,5186,1313,4749,361,364,248,400,6122
E02004906,Borehamwood Hillside,Hertsmere,East of England,2547,6576,375,389,233,345,7918,2532,7941,449,411,274,371,9446
E02004907,Bushey Central,Hertsmere,East of England,2131,6005,475,547,353,560,7940,2124,7295,506,577,435,578,9391
E02004908,Bushey Heath,Hertsmere,East of England,1900,5463,533,628,551,830,8005,1984,6638,554,613,590,978,9373
E02004909,Royston North & Central,North Hertfordshire,East of England,1175,3670,250,247,162,278,4607,1126,3856,251,266,172,267,4812
E02004910,"Royston South, West & East",North Hertfordshire,East of England,2164,6629,613,685,453,716,9096,2186,7339,607,774,516,691,9927
E02004911,Letchworth Grange,North Hertfordshire,East of England,1382,3989,349,265,246,496,5345,1376,4303,368,290,224,447,5632
E02004912,Baldock,North Hertfordshire,East of England,1991,6737,448,463,341,644,8633,1874,7233,532,484,374,639,9262
E02004913,"Great Ashby, Ashwell & Barley",North Hertfordshire,East of England,3241,9553,741,685,494,677,12150,3050,9945,775,712,534,707,12673
E02004914,Letchworth East,North Hertfordshire,East of England,1783,5117,357,327,243,404,6448,1694,5445,357,372,253,385,6812
E02004915,Letchworth Wilbury,North Hertfordshire,East of England,1128,3593,280,231,209,273,4586,1106,3771,247,248,211,286,4763
E02004916,Letchworth South West,North Hertfordshire,East of England,1376,4200,414,499,385,565,6063,1409,4816,403,502,381,611,6713
E02004917,Letchworth South East,North Hertfordshire,East of England,1223,3636,347,442,280,464,5169,1157,3997,347,433,307,467,5551
E02004918,Hitchin Bearton,North Hertfordshire,East of England,1585,5909,311,232,182,303,6937,1554,6050,328,253,186,308,7125
E02004919,Hitchin Walsworth,North Hertfordshire,East of England,1646,4906,357,327,241,346,6177,1619,5196,369,346,258,318,6487
E02004920,Hitchin Town & West,North Hertfordshire,East of England,2242,6982,569,560,431,885,9427,2174,7261,565,598,448,895,9767
E02004921,Hitchin Highbury,North Hertfordshire,East of England,1618,4820,338,374,303,451,6286,1614,5107,353,366,308,491,6625
E02004922,"Ickleford, Great Offley & Whitwell",North Hertfordshire,East of England,1852,5773,600,606,436,591,8006,1843,6362,587,634,492,542,8617
E02004923,"Knebworth, Codicote & Kimpton",North Hertfordshire,East of England,1902,6087,612,645,403,585,8332,1924,6638,642,621,471,764,9136
E02004956,Abbots Langley,Three Rivers,East of England,1642,5520,481,483,350,533,7367,1631,6024,480,465,375,510,7854
E02004957,Leavesden & Garston Manor,Three Rivers,East of England,2478,6694,448,382,281,299,8104,2524,7416,474,455,301,307,8953
E02004958,Croxley North & Sarratt,Three Rivers,East of England,1613,4700,361,477,268,504,6310,1526,5080,415,432,310,480,6717
E02004959,Rickmansworth North & Loudwater,Three Rivers,East of England,1004,3667,308,327,225,588,5115,1048,4188,340,358,257,612,5755
E02004960,Chorleywood,Three Rivers,East of England,1216,3342,303,305,249,342,4541,1167,3770,304,315,245,367,5001
E02004961,Croxley Green,Three Rivers,East of England,2103,5912,468,446,318,482,7626,2015,6527,486,493,318,517,8341
E02004962,Rickmansworth West,Three Rivers,East of England,1908,5506,372,365,301,502,7046,1852,6179,398,419,319,482,7797
E02004963,Oxhey Hall & Hayling,Three Rivers,East of England,1678,4656,341,320,180,226,5723,1693,5220,371,336,211,273,6411
E02004964,"Mill End, Heronsgate & Maple Cross",Three Rivers,East of England,1161,3481,247,233,170,257,4388,1237,3822,260,265,187,255,4789
E02004965,Carpenders Park,Three Rivers,East of England,1230,4094,366,425,312,527,5724,1309,4540,354,415,384,529,6222
E02004966,Moor Park & Batchworth,Three Rivers,East of England,1283,4534,440,447,292,533,6246,1215,6134,503,493,359,562,8051
E02004967,South Oxhey,Three Rivers,East of England,1825,5074,297,199,153,269,5992,1706,5554,310,234,151,266,6515
E02004968,Woodside & Leavesden Green,Watford,East of England,1669,4647,304,287,189,340,5767,1643,5208,296,313,221,313,6351
E02004969,Stanborough,Watford,East of England,1506,4408,313,271,207,386,5585,1503,5239,344,274,243,347,6447
E02004970,Garston,Watford,East of England,1977,4884,323,318,244,434,6203,1995,5831,373,329,247,405,7185
E02004971,Leggatts,Watford,East of England,1917,5043,284,231,178,286,6022,2040,6196,292,245,219,289,7241
E02004972,Tudor,Watford,East of England,1146,3650,306,268,196,278,4698,1226,4217,332,272,214,295,5330
E02004973,North Watford,Watford,East of England,1841,5471,212,180,94,145,6102,1884,6698,249,218,96,146,7407
E02004974,Nascot Wood,Watford,East of England,1789,5426,354,396,241,568,6985,1852,6273,351,398,303,545,7870
E02004975,Cassiobury,Watford,East of England,1725,4977,347,351,243,389,6307,1658,5674,366,371,289,399,7099
E02004976,Central Watford,Watford,East of England,2100,7471,237,196,163,258,8325,2133,9531,272,241,170,252,10466
E02004977,West Watford,Watford,East of England,2147,5828,212,186,144,206,6576,2188,8041,269,207,145,191,8853
E02004978,Holywell,Watford,East of England,2302,6160,301,206,163,258,7088,2464,8081,348,250,187,336,9202
E02004979,Oxhey,Watford,East of England,1417,4220,340,320,215,288,5383,1406,5108,383,341,243,272,6347
E02005503,"Bawdeswell, Swanton Morley & North Elmham",Breckland,East of England,1256,4089,530,597,365,583,6164,1232,4320,533,560,426,556,6395
E02005504,"Whissonsett, Litcham & Narborough",Breckland,East of England,1447,4915,721,762,532,733,7663,1418,5169,700,772,614,724,7979
E02005505,Dereham North & Neatherd,Breckland,East of England,1383,4183,462,525,366,681,6217,1339,4463,438,489,417,658,6465
E02005506,"Dereham West, Necton & Gressenhall",Breckland,East of England,1110,3860,555,517,391,510,5833,1082,4077,507,545,410,510,6049
E02005507,Dereham Central & Toftwood,Breckland,East of England,2091,6906,676,789,583,819,9773,2005,6980,665,759,621,817,9842
E02005508,"Hockering, Mattishall & Cranworth",Breckland,East of England,1079,3954,528,635,364,447,5928,1061,4311,563,633,438,481,6426
E02005509,Swaffham,Breckland,East of England,1311,4178,621,673,565,930,6967,1306,4573,644,699,590,919,7425
E02005510,"Shipdham, Bradenham & Saham Toney",Breckland,East of England,1005,3703,552,732,412,619,6018,988,4025,598,673,521,596,6413
E02005511,Watton,Breckland,East of England,1206,4575,528,646,487,806,7042,1315,5227,534,705,565,803,7834
E02005512,"Wayland, Ellingham & Great Hockham",Breckland,East of England,1604,5875,602,614,364,391,7846,1629,6463,594,647,387,445,8536
E02005513,Attleborough,Breckland,East of England,1712,5870,550,610,463,748,8241,1814,6571,567,653,536,709,9036
E02005514,"Mundford, Weeting & Forest",Breckland,East of England,1061,3930,527,612,332,441,5842,982,3811,482,598,385,445,5721
E02005515,Buckenhams & Snetterton,Breckland,East of England,1135,3744,424,415,283,423,5289,1069,3950,448,409,301,437,5545
E02005516,"East Harling, Garboldisham & Kenninghall",Breckland,East of England,1196,3824,534,560,352,442,5712,1139,4133,523,589,361,489,6095
E02005517,Thetford North,Breckland,East of England,1638,4087,255,203,149,201,4895,1535,4819,251,229,148,197,5644
E02005518,Thetford Central & East,Breckland,East of England,2056,7316,515,512,397,595,9335,2000,7808,523,531,370,588,9820
E02005519,Thetford South,Breckland,East of England,2075,5463,391,340,231,413,6838,2052,6485,385,357,256,389,7872
E02005520,Aylsham,Broadland,East of England,1406,4657,636,778,472,708,7251,1451,4949,598,791,575,743,7656
E02005521,"Reepham, Cawston & Lenwade",Broadland,East of England,1372,5112,659,701,421,516,7409,1295,5216,624,710,462,539,7551
E02005522,"Coltishall, Buxton & Frettenham",Broadland,East of England,916,3208,339,412,279,380,4618,867,3349,399,402,294,386,4830
E02005523,"Horsford, Hainford & Hevingham",Broadland,East of England,1614,5172,507,480,343,354,6856,1538,5364,514,523,345,375,7121
E02005524,Spixworth & St Faiths,Broadland,East of England,865,3123,424,393,315,367,4622,802,3191,372,421,309,396,4689
E02005525,Taverham,Broadland,East of England,1750,6241,541,611,429,592,8414,1619,6202,555,575,488,656,8476
E02005526,Drayton & Thorpe Marriott,Broadland,East of England,905,3103,319,327,219,475,4443,968,3322,319,355,256,469,4721
E02005527,"Wroxham, Rackheath & the Plumsteads",Broadland,East of England,1608,5071,534,623,407,679,7314,1594,5373,520,616,472,710,7691
E02005528,Old Catton,Broadland,East of England,1362,5037,512,602,429,655,7235,1377,5168,478,586,446,624,7302
E02005529,Hellesdon North West,Broadland,East of England,843,3130,384,442,391,714,5061,816,3341,398,460,351,657,5207
E02005530,Hellesdon South East,Broadland,East of England,829,3242,288,383,287,454,4654,858,3420,303,337,319,448,4827
E02005531,Sprowston Central,Broadland,East of England,869,3255,327,380,240,376,4578,864,3378,320,339,248,418,4703
E02005532,Sprowston East,Broadland,East of England,1271,4621,535,653,433,769,7011,1503,5244,516,657,471,780,7668
E02005533,"Blofield, Lingwood & Upton",Broadland,East of England,1520,4911,656,686,526,618,7397,1480,5221,640,703,566,655,7785
E02005534,Thorpe St Andrew North,Broadland,East of England,1131,4189,467,507,358,629,6150,1070,4520,497,485,411,630,6543
E02005535,Thorpe St Andrew South & Dussindale,Broadland,East of England,1310,4579,382,351,216,405,5933,1257,4628,389,394,233,452,6096
E02005536,Brundall & Cantley,Broadland,East of England,976,3500,449,469,359,463,5240,979,3733,457,497,378,509,5574
E02005537,Acle & Reedham,Broadland,East of England,961,3354,424,482,312,517,5089,892,3489,382,477,353,507,5208
E02005538,Hemsby & Ormesby,Great Yarmouth,East of England,1135,4816,880,925,583,729,7933,1236,5607,880,903,672,744,8806
E02005539,"Fleggburgh, Rollesby & Martham",Great Yarmouth,East of England,1135,4207,638,608,444,502,6399,1162,4650,634,688,525,524,7021
E02005540,Caister on Sea,Great Yarmouth,East of England,1230,4703,694,871,631,866,7765,1166,5049,693,841,679,819,8081
E02005541,Yarmouth North,Great Yarmouth,East of England,1051,3385,356,402,289,441,4873,1105,3937,355,380,327,439,5438
E02005542,Yarmouth Central & Northgate,Great Yarmouth,East of England,1495,4860,357,322,253,267,6059,1607,6113,362,349,221,279,7324
E02005543,Yarmouth Parade,Great Yarmouth,East of England,2257,6231,368,322,241,288,7450,2383,8175,415,342,252,291,9475
E02005544,Southtown & Cobholm,Great Yarmouth,East of England,1757,4689,309,282,198,262,5740,1707,5232,316,296,211,220,6275
E02005545,Bradwell North,Great Yarmouth,East of England,983,3458,458,559,428,465,5368,1009,3836,449,549,409,519,5762
E02005546,Gorleston North,Great Yarmouth,East of England,1588,4614,458,462,332,438,6304,1553,5127,445,468,336,443,6819
E02005547,Gorleston South & Beach,Great Yarmouth,East of England,1587,5111,523,587,394,610,7225,1460,5516,535,532,426,641,7650
E02005548,Gorleston West,Great Yarmouth,East of England,1580,4195,421,408,312,582,5918,1530,4753,403,416,313,528,6413
E02005549,Belton,Great Yarmouth,East of England,773,2905,442,501,288,361,4497,802,3345,454,514,352,361,5026
E02005550,Bradwell South & Hopton,Great Yarmouth,East of England,1207,4119,471,531,376,530,6027,1266,4601,472,551,407,581,6612
E02005551,Hunstanton,King's Lynn and West Norfolk,East of England,532,2318,565,659,415,757,4714,516,2434,492,654,454,744,4778
E02005552,"Brancaster, Burnham Market & Docking",King's Lynn and West Norfolk,East of England,960,3377,650,690,488,625,5830,858,3515,579,643,498,638,5873
E02005553,Heacham & Snettisham,King's Lynn and West Norfolk,East of England,1041,3980,809,1121,713,968,7591,1031,4292,775,1071,823,982,7943
E02005554,"Dersingham, Sandringham & Massingham",King's Lynn and West Norfolk,East of England,940,3354,597,747,540,727,5965,884,3562,579,716,583,740,6180
E02005555,Wootton,King's Lynn and West Norfolk,East of England,1132,3655,556,513,402,589,5715,1062,3939,511,543,435,571,5999
E02005556,Gaywood North Bank,King's Lynn and West Norfolk,East of England,1386,4379,427,467,284,465,6022,1363,4889,421,460,361,527,6658
E02005557,North Lynn,King's Lynn and West Norfolk,East of England,1615,4190,248,223,171,208,5040,1673,5316,241,228,166,196,6147
E02005558,Terrington & Clenchwarton,King's Lynn and West Norfolk,East of England,1219,3925,489,565,376,513,5868,1160,4337,522,523,419,526,6327
E02005559,Gaywood Chase & Old Gaywood,King's Lynn and West Norfolk,East of England,1424,4483,372,322,251,414,5842,1386,5259,379,356,249,444,6687
E02005560,Fairstead & Springwood,King's Lynn and West Norfolk,East of England,2147,5817,350,326,262,302,7057,2134,6532,387,315,256,300,7790
E02005561,"Town, South Lynn & West Lynn",King's Lynn and West Norfolk,East of England,2208,7242,473,469,348,473,9005,2158,8426,486,470,367,518,10267
E02005562,"Grimston, Gayton & East Winch",King's Lynn and West Norfolk,East of England,1137,3952,543,627,411,480,6013,1139,4415,521,627,447,505,6515
E02005563,"Marshland, Walpole & Walton",King's Lynn and West Norfolk,East of England,1299,4332,522,544,383,471,6252,1387,5055,538,573,403,517,7086
E02005564,"West Winch, Marham & Shouldham",King's Lynn and West Norfolk,East of England,1901,5738,604,612,485,590,8029,1529,5970,600,627,505,667,8369
E02005565,"Watlington, Wiggenhall & Terrington St John",King's Lynn and West Norfolk,East of England,1216,4073,457,502,341,407,5780,1220,4534,457,473,365,444,6273
E02005566,"Upwell, Delph & Emneth",King's Lynn and West Norfolk,East of England,1715,5620,684,693,483,652,8132,1773,6507,720,694,544,661,9126
E02005567,Downham Market,King's Lynn and West Norfolk,East of England,1921,5724,657,806,698,1199,9084,1830,6162,682,796,694,1234,9568
E02005568,"Stoke Ferry, Hilgay & Wimbotsham",King's Lynn and West Norfolk,East of England,1263,4038,576,581,427,538,6160,1111,4405,528,591,415,571,6510
E02005569,"Southery, Feltwell & Hockwold",King's Lynn and West Norfolk,East of England,1579,4882,523,525,326,393,6649,1265,4715,551,525,376,468,6635
E02005570,Sheringham,North Norfolk,East of England,943,3453,660,727,587,995,6422,878,3534,578,758,609,942,6421
E02005571,Wells & Blakeney,North Norfolk,East of England,746,2974,584,599,407,680,5244,747,3174,544,558,450,668,5394
E02005572,Cromer,North Norfolk,East of England,949,4005,675,741,492,876,6789,948,4102,646,788,587,822,6945
E02005573,Holt & Weybourne,North Norfolk,East of England,746,2699,550,593,503,783,5128,790,2969,492,626,513,800,5400
E02005574,"Overstrand, Roughton & the Runtons",North Norfolk,East of England,843,3810,658,707,476,623,6274,843,3790,671,692,503,634,6290
E02005575,"Beeston Regis, Saxthorpe & Aldborough",North Norfolk,East of England,1057,3818,657,672,404,561,6112,947,3955,632,698,469,565,6319
E02005576,"Mundesley, Trunch & Bacton",North Norfolk,East of England,870,3380,592,707,493,688,5860,858,3572,612,713,499,648,6044
E02005577,"Melton Constable, Briston & Little Snoring",North Norfolk,East of England,913,3417,496,534,307,417,5171,849,3408,470,544,351,450,5223
E02005578,Walsingham & Raynham,North Norfolk,East of England,961,3399,413,434,284,352,4882,953,3631,398,435,324,362,5150
E02005579,North Walsham,North Norfolk,East of England,2044,6994,886,1024,669,1284,10857,1950,7305,820,999,769,1248,11141
E02005580,Fakenham,North Norfolk,East of England,1238,4301,557,592,485,764,6699,1197,4506,545,624,509,748,6932
E02005581,"Felmingham, Worstead & Happisburgh",North Norfolk,East of England,1133,5067,653,637,421,451,7229,1059,4945,647,633,417,427,7069
E02005582,Stalham & Sea Palling,North Norfolk,East of England,1071,3862,544,570,375,569,5920,978,3851,544,564,417,578,5954
E02005583,"Hoveton, Horning & Potter Heigham",North Norfolk,East of England,982,4390,835,934,634,961,7754,1002,4635,806,916,693,964,8014
E02005584,Catton Grove & Airport,Norwich,East of England,2185,7155,447,421,303,444,8770,2312,8171,515,444,308,399,9837
E02005585,Mile Cross,Norwich,East of England,2503,7133,390,369,282,340,8514,2474,8320,416,368,294,353,9751
E02005586,New Catton & Mousehold North,Norwich,East of England,1742,7143,321,286,194,203,8147,1674,8091,404,334,205,260,9294
E02005587,Heartsease & Pilling Park,Norwich,East of England,2126,5967,379,411,389,713,7859,2164,7180,407,430,360,682,9059
E02005588,Bowthorpe & West Earlham,Norwich,East of England,2316,8265,451,399,270,353,9738,2549,9350,503,491,323,464,11131
E02005589,Earlham,Norwich,East of England,2454,7908,405,397,252,425,9387,2629,8986,432,443,292,394,10547
E02005590,City Centre West,Norwich,East of England,1288,7895,487,505,332,579,9798,1376,9772,539,502,393,484,11690
E02005592,Earlham Road & College Road,Norwich,East of England,1340,6885,403,343,182,241,8054,1293,7304,445,406,217,293,8665
E02005593,University & Avenues,Norwich,East of England,1347,9929,306,244,186,402,11067,1331,13636,281,262,191,368,14738
E02005594,Town Close,Norwich,East of England,1522,7573,576,523,361,550,9583,1473,8442,616,588,371,564,10581
E02005595,Eaton,Norwich,East of England,1443,4887,524,635,534,929,7509,1516,5829,591,647,571,878,8516
E02005596,Lakenham & Tuckswood,Norwich,East of England,1957,5643,404,458,312,596,7413,2079,6814,460,487,321,505,8587
E02006907,City Centre East,Norwich,East of England,644,5237,212,230,184,289,6152,668,5923,262,237,219,315,6956
E02006908,Thorpe Hamlet & Mousehold South,Norwich,East of England,902,3939,281,253,122,218,4813,755,4063,293,247,163,186,4952
E02005597,Costessey & Queens Hills,South Norfolk,East of England,3414,10296,737,798,576,839,13246,3309,10561,725,836,615,852,13589
E02005598,"Cringleford, Little Melton & Easton",South Norfolk,East of England,2072,5825,494,545,418,623,7905,2029,6174,519,577,432,673,8375
E02005599,Hethersett,South Norfolk,East of England,1234,3643,417,445,336,494,5335,1347,4102,395,467,374,489,5827
E02005600,"Hingham, Morley & Barnham Broom",South Norfolk,East of England,1363,3716,410,455,303,388,5272,1402,3916,415,460,355,421,5567
E02005601,Wymondham West,South Norfolk,East of England,757,3252,336,497,329,502,4916,702,3257,351,454,398,542,5002
E02005602,"Trowse, Poringland & Stoke Holy Cross",South Norfolk,East of England,2147,6999,772,812,615,940,10138,2128,7603,755,871,681,932,10842
E02005603,Wymondham East & Spooner Row,South Norfolk,East of England,2672,7011,551,535,396,487,8980,2749,7948,532,591,427,596,10094
E02005604,"Loddon, Surlingham & Alpington",South Norfolk,East of England,1418,4862,593,595,458,674,7182,1379,5227,608,632,507,671,7645
E02005605,"Mulbarton, Tasburgh & Saxlingham Nethergate",South Norfolk,East of England,1956,6272,680,710,526,633,8821,1874,6384,743,686,564,676,9053
E02005606,"Thurlton, Haddiscoe & Geldeston",South Norfolk,East of England,928,3411,451,417,283,358,4920,833,3536,444,449,333,346,5108
E02005607,"Long Stratton, Carlton Rode & Tibenham",South Norfolk,East of England,2027,6800,735,842,483,674,9534,1956,6952,712,816,580,674,9734
E02005608,"Hempnall, Ditchingham & Wortwell",South Norfolk,East of England,1162,4336,577,662,410,609,6594,1078,4458,601,653,457,586,6755
E02005609,Harleston & Pulham,South Norfolk,East of England,1334,4016,506,621,414,635,6192,1262,4194,498,620,454,652,6418
E02005610,"Scole, Dickleburgh & Bressingham",South Norfolk,East of England,1227,4619,635,720,399,562,6935,1120,4717,617,717,463,561,7075
E02005611,Diss & Roydon,South Norfolk,East of England,1846,6451,680,697,573,952,9353,1753,6726,659,716,594,978,9673
E02006227,"Lavenham, Bildeston & Brettenham",Babergh,East of England,823,3399,572,546,396,534,5447,815,3524,556,616,414,540,5650
E02006228,Glemsford & Lawshall,Babergh,East of England,1044,3545,439,457,286,350,5077,998,3674,418,484,339,364,5279
E02006229,North Sudbury & Long Melford,Babergh,East of England,859,3225,460,537,370,486,5078,844,3415,465,543,443,547,5413
E02006230,Hadleigh,Babergh,East of England,2126,6064,724,757,549,928,9022,1974,6372,693,810,626,923,9424
E02006231,"Sproughton, Washbrook & Hintlesham",Babergh,East of England,1459,5300,530,530,324,476,7160,1377,5382,542,490,372,448,7234
E02006232,"Acton, Great Waldingfield & Bures",Babergh,East of England,1022,3413,477,441,346,408,5085,960,3482,448,512,372,392,5206
E02006233,Sudbury,Babergh,East of England,1955,6875,667,750,584,959,9835,1779,7176,638,710,634,962,10120
E02006234,Great Cornard,Babergh,East of England,1922,5900,484,603,400,442,7829,1974,6254,456,576,417,500,8203
E02006235,"Leavenheath, Nayland & Boxford",Babergh,East of England,1356,4484,612,668,429,651,6844,1255,4838,563,681,497,638,7217
E02006236,"East Bergholt, Brantham & Capel St Mary",Babergh,East of England,1738,5620,728,899,588,789,8624,1618,6109,730,864,681,802,9186
E02006237,Shotley Peninsula,Babergh,East of England,1329,4354,492,548,383,625,6402,1271,4498,505,548,402,626,6579
E02006245,Whitton,Ipswich,East of England,1656,4450,406,423,326,517,6122,1777,5122,447,408,382,569,6928
E02006246,Castle Hill,Ipswich,East of England,1230,4096,447,449,292,526,5810,1315,4655,443,443,309,512,6362
E02006247,Whitehouse,Ipswich,East of England,2005,5683,362,356,226,283,6910,2119,6113,356,387,244,322,7422
E02006248,Rushmere,Ipswich,East of England,1776,4781,380,413,295,464,6333,1864,5561,405,410,298,443,7117
E02006249,Christchurch Park,Ipswich,East of England,1515,4933,448,455,260,574,6670,1586,6062,466,466,321,570,7885
E02006250,Westgate,Ipswich,East of England,2200,7683,372,257,186,247,8745,2445,9102,364,295,194,223,10178
E02006251,Ipswich Central,Ipswich,East of England,1991,7948,322,256,157,254,8937,2106,9557,366,303,169,259,10654
E02006252,California,Ipswich,East of England,1991,5820,378,349,236,495,7278,2006,6681,394,368,285,460,8188
E02006253,Broke Hall,Ipswich,East of England,1136,3740,505,486,349,679,5759,1233,4472,463,522,371,651,6479
E02006254,Gipping & Chantry Park,Ipswich,East of England,1973,6173,399,298,236,420,7526,2169,7298,409,317,229,420,8673
E02006255,Holywells,Ipswich,East of England,1490,5632,329,308,159,290,6718,1594,6546,358,337,199,316,7756
E02006256,"Maidenhall, Stoke & Port",Ipswich,East of England,2162,6285,414,340,208,345,7592,2307,7203,408,361,231,351,8554
E02006257,Belstead Hills,Ipswich,East of England,1245,3675,361,382,264,533,5215,1330,4161,396,363,294,513,5727
E02006258,Priory Heath,Ipswich,East of England,2025,5738,437,293,252,337,7057,2173,6646,396,387,238,391,8058
E02006259,Stoke Park,Ipswich,East of England,1505,4121,415,438,256,365,5595,1579,4526,447,434,305,342,6054
E02006260,"Gainsborough, Greenwich & Orwell",Ipswich,East of England,2055,5168,490,384,238,411,6691,2084,5815,451,376,271,370,7283
E02006261,"Eye, Palgrave & Occold",Mid Suffolk,East of England,1243,4383,661,722,488,573,6827,1139,4667,620,744,497,635,7163
E02006262,"Rickinghall, Walsham le Willows & Gislingham",Mid Suffolk,East of England,1389,5201,695,762,476,595,7729,1334,5400,678,762,552,603,7995
E02006263,"Fressingfield, Laxfield & Worlingworth",Mid Suffolk,East of England,1181,4266,576,677,475,537,6531,1072,4299,561,656,503,562,6581
E02006264,"Thurston, Badwell Ash & Elmswell North",Mid Suffolk,East of England,1502,5137,549,542,405,537,7170,1457,5293,578,606,426,563,7466
E02006265,"Stowupland, Mendlesham & Bacton",Mid Suffolk,East of England,1165,4174,515,514,420,495,6118,1132,4331,521,533,437,522,6344
E02006266,"Elmswell South, Haughley, Beyton & Felsham",Mid Suffolk,East of England,1531,5440,717,779,524,662,8122,1382,5377,726,756,558,719,8136
E02006267,"Debenham, Stonham & Coddenham",Mid Suffolk,East of England,1440,5014,693,583,362,523,7175,1302,5241,673,675,403,529,7521
E02006268,Stowmarket West,Mid Suffolk,East of England,1189,3612,433,404,306,463,5218,1108,3914,395,440,313,549,5611
E02006269,"Stowmarket Outer, Finborough & Battisford",Mid Suffolk,East of England,1231,4482,488,456,317,534,6277,1215,4660,479,484,336,475,6434
E02006270,Stowmarket East & Needham Market North,Mid Suffolk,East of England,2764,8809,517,520,330,527,10703,2520,8803,539,514,365,517,10738
E02006271,Needham Market South & Great Blakenham,Mid Suffolk,East of England,1569,6094,551,601,407,526,8179,1587,6289,534,582,460,597,8462
E02006272,Claydon & Bramford,Mid Suffolk,East of England,1189,4320,563,598,393,579,6453,1118,4379,542,602,439,594,6556
E02004924,Harpenden North,St Albans,East of England,2075,4607,314,354,244,337,5856,1987,5210,295,336,260,355,6456
E02004925,Harpenden East,St Albans,East of England,2152,4608,307,270,220,411,5816,2057,5332,331,278,224,387,6552
E02004926,Harpenden Town,St Albans,East of England,1926,4623,309,407,283,595,6217,1882,5456,329,409,326,613,7133
E02004927,Wheathampstead,St Albans,East of England,1476,3639,341,396,245,439,5060,1499,4017,348,391,289,442,5487
E02004928,Harpenden Common,St Albans,East of England,1473,3792,407,359,270,451,5279,1464,4542,376,391,296,424,6029
E02004929,Redbourn,St Albans,East of England,1353,3586,323,404,297,440,5050,1364,4117,346,420,342,448,5673
E02004930,Jersey Farm & Sandridge,St Albans,East of England,1428,4280,336,315,219,366,5516,1466,4811,345,317,257,367,6097
E02004931,Marshalswick,St Albans,East of England,1558,3931,341,307,171,440,5190,1591,4648,352,317,207,396,5920
E02004932,Townsend & New Greens,St Albans,East of England,1992,4800,294,261,189,252,5796,1879,5474,323,305,229,280,6611
E02004933,Bernards Heath,St Albans,East of England,1733,4160,331,271,179,327,5268,1667,4723,330,295,211,328,5887
E02004934,Clarence Park,St Albans,East of England,1768,5549,273,207,118,320,6467,1688,6206,283,268,155,298,7210
E02004935,St Albans Central,St Albans,East of England,1716,6517,274,177,140,261,7369,1656,7437,304,224,168,277,8410
E02004936,Longacres,St Albans,East of England,1656,4101,209,225,145,189,4869,1629,4676,249,219,152,201,5497
E02004937,Verulam Park,St Albans,East of England,1490,4001,394,478,363,631,5867,1477,4641,421,453,383,614,6512
E02004938,Colney Heath & Tyttenhanger,St Albans,East of England,1418,4092,238,263,166,241,5000,1346,4407,282,281,175,279,5424
E02004939,The Camp & Cunningham,St Albans,East of England,1538,4273,277,286,209,407,5452,1515,4653,262,287,193,433,5828
E02004940,Cottonmill & Sopwell,St Albans,East of England,1782,4758,287,220,194,338,5797,1879,5535,297,275,189,315,6611
E02004941,London Colney,St Albans,East of England,2018,6259,478,366,244,363,7710,2010,7070,501,454,288,385,8698
E02004942,How Wood & Park Street,St Albans,East of England,1251,3727,357,375,324,411,5194,1225,4134,358,367,288,425,5572
E02004943,Bricket Wood & Chiswell Green,St Albans,East of England,1468,4443,460,531,385,589,6408,1536,5274,482,543,439,624,7362
E02004980,"Woolmer Green, Oaklands & Digswell",Welwyn Hatfield,East of England,1036,3589,396,414,306,619,5324,1011,3944,367,399,319,429,5458
E02004981,Welwyn & Hatfield Garden Village,Welwyn Hatfield,East of England,1549,4944,360,359,275,462,6400,1656,5476,370,399,286,465,6996
E02004982,Knightsfield,Welwyn Hatfield,East of England,1325,3568,273,295,221,377,4734,1259,3911,257,298,235,377,5078
E02004983,Haldens,Welwyn Hatfield,East of England,1315,3763,277,269,193,334,4836,1291,4043,324,258,204,339,5168
E02004984,Panshanger,Welwyn Hatfield,East of England,1149,4130,354,262,199,358,5303,1059,4340,414,299,200,355,5608
E02004985,Welwyn Garden City Central & Handside,Welwyn Hatfield,East of England,1236,4050,341,406,352,693,5842,1187,4397,371,418,344,648,6178
E02004986,Peartree,Welwyn Hatfield,East of England,1996,5467,242,192,115,203,6219,1997,6465,284,216,141,193,7299
E02004987,Hall Grove,Welwyn Hatfield,East of England,1779,4698,285,262,164,335,5744,1795,5196,283,271,173,311,6234
E02004988,Hollybush,Welwyn Hatfield,East of England,1976,5036,295,226,194,293,6044,1851,5397,309,256,201,289,6452
E02004989,Hatfield North & West,Welwyn Hatfield,East of England,2155,11007,322,298,201,320,12148,2032,9936,340,323,237,335,11171
E02004990,Hatfield East,Welwyn Hatfield,East of England,1251,4889,313,271,205,417,6095,1358,5320,325,324,206,401,6576
E02004991,Hatfield Town,Welwyn Hatfield,East of England,1687,6585,206,166,139,287,7383,1620,6548,235,170,134,266,7353
E02004992,Hatfield South,Welwyn Hatfield,East of England,1794,8811,207,193,164,311,9686,1675,10053,210,199,138,289,10889
E02004993,Welham Green,Welwyn Hatfield,East of England,966,3651,294,296,213,312,4766,956,3849,328,291,223,307,4998
E02004994,Brookmans Park,Welwyn Hatfield,East of England,1090,3473,373,381,253,390,4870,1123,4124,341,336,280,419,5500
E02004995,Cuffley & Northaw,Welwyn Hatfield,East of England,860,3093,323,356,279,434,4485,898,3421,365,346,275,497,4904
E02004878,Buntingford & Great Hormead,East Hertfordshire,East of England,1700,4877,466,559,317,443,6662,1866,5552,493,546,385,477,7453
E02004879,"Datchworth, Walkern & Cottered",East Hertfordshire,East of England,1545,4921,486,550,324,445,6726,1422,5208,512,560,370,470,7120
E02004880,Bishop's Stortford West & Braughing,East Hertfordshire,East of England,1900,5927,474,476,298,444,7619,2211,7021,503,508,338,442,8812
E02004881,Bishop's Stortford North,East Hertfordshire,East of England,1218,4177,300,286,199,492,5454,1318,4837,295,340,180,492,6144
E02004882,Bishop's Stortford East,East Hertfordshire,East of England,1951,5689,355,353,261,380,7038,1840,6587,331,383,232,406,7939
E02004883,Puckeridge & Thundridge,East Hertfordshire,East of England,1227,3693,299,368,270,311,4941,1243,4033,323,374,277,302,5309
E02004884,Bishop's Stortford Central,East Hertfordshire,East of England,2085,7297,432,384,252,428,8793,1854,7661,462,391,245,455,9214
E02004885,Bishop's Stortford South,East Hertfordshire,East of England,1781,5488,341,356,237,326,6748,1753,6157,392,384,272,342,7547
E02004886,Much Hadham & Hunsdon,East Hertfordshire,East of England,1265,3885,338,373,226,415,5237,1269,4221,384,385,258,369,5617
E02004887,"Watton-at-Stone, Bramfield & Bayford",East Hertfordshire,East of England,1426,4554,510,495,297,401,6257,1326,4936,479,531,323,406,6675
E02004888,Sawbridgeworth,East Hertfordshire,East of England,1682,5425,511,514,410,529,7389,1629,5627,562,574,410,567,7740
E02004889,Ware East,East Hertfordshire,East of England,2385,7072,441,479,367,788,9147,2285,7561,425,497,396,832,9711
E02004890,Ware West,East Hertfordshire,East of England,1435,5523,455,440,263,444,7125,1400,5674,450,476,290,374,7264
E02004891,Hertford Bengeo,East Hertfordshire,East of England,1711,4739,406,440,306,487,6378,1578,5030,430,449,328,479,6716
E02004892,Hertford West,East Hertfordshire,East of England,1275,3546,259,204,141,268,4418,1285,3879,267,207,189,252,4794
E02004893,Hertford Foxholes,East Hertfordshire,East of England,1366,4005,193,178,134,107,4617,1322,4169,206,182,140,144,4841
E02004894,Hertford South,East Hertfordshire,East of England,1783,6293,405,368,304,521,7891,1778,6541,430,421,318,537,8247
E02004895,Hertford Heath & Stanstead St Margarets,East Hertfordshire,East of England,1822,5925,508,516,384,418,7751,1856,6662,528,513,419,454,8576
E02004944,St Nicholas,Stevenage,East of England,1898,4905,249,268,152,170,5744,1946,5817,272,268,161,195,6713
E02004945,Woodfield & Old Town,Stevenage,East of England,2358,7951,527,493,372,587,9930,2429,8583,560,530,408,590,10671
E02004946,Martins Wood,Stevenage,East of England,1282,4024,287,282,164,301,5058,1306,4556,271,259,203,297,5586
E02004947,Chells North,Stevenage,East of England,1032,4049,315,293,181,277,5115,1120,4471,400,291,204,256,5622
E02004948,Symonds Green,Stevenage,East of England,1134,3823,351,284,160,273,4891,1149,4072,353,326,193,264,5208
E02004949,Pin Green,Stevenage,East of England,1691,5498,332,369,330,577,7106,1700,6134,360,375,325,531,7725
E02004950,Chells South,Stevenage,East of England,1608,4210,260,241,207,290,5208,1565,4713,252,250,201,322,5738
E02004951,Bedwell,Stevenage,East of England,1758,5183,240,230,189,355,6197,1712,6013,266,257,184,344,7064
E02004952,Poplars,Stevenage,East of England,1372,4275,279,230,161,354,5299,1379,4728,320,247,181,326,5802
E02004953,Shephall,Stevenage,East of England,1477,4054,212,217,163,255,4901,1509,4549,246,198,179,257,5429
E02004954,Roebuck,Stevenage,East of England,1474,4401,262,265,177,344,5449,1516,4880,313,287,197,322,5999
E02004955,Broadwater & Bragbury End,Stevenage,East of England,1223,3644,300,244,143,309,4640,1219,4024,325,285,175,286,5095
E02006287,"Yoxford, Wenhaston & Walberswick",East Suffolk,East of England,840,3118,631,623,421,546,5339,769,3322,637,640,454,533,5586
E02006288,Framlingham & Hacheston,East Suffolk,East of England,1577,5287,716,744,485,753,7985,1605,5929,695,777,556,784,8741
E02006289,Saxmundham & Coldfair Green,East Suffolk,East of England,1660,5124,681,766,561,735,7867,1615,5577,705,806,603,775,8466
E02006290,Leiston & Aldeburgh,East Suffolk,East of England,1181,4353,586,692,519,798,6948,1243,4692,607,656,540,827,7322
E02006291,Wickham Market & Melton,East Suffolk,East of England,1251,4166,620,649,397,598,6430,1198,4531,600,662,480,615,6888
E02006292,"Westerfield, Grundisburgh & Bredfield",East Suffolk,East of England,1174,3834,540,517,334,458,5683,1081,4085,528,531,394,459,5997
E02006293,"Rendlesham, Orford & Hollesley",East Suffolk,East of England,1905,7086,742,695,472,551,9546,1869,7020,742,721,473,602,9558
E02006294,Woodbridge,East Suffolk,East of England,1256,4155,571,685,519,1042,6972,1158,4625,513,664,561,1040,7403
E02006295,Kesgrave West & Rushmere,East Suffolk,East of England,1840,5470,522,657,490,817,7956,1646,5651,486,650,514,792,8093
E02006296,Kesgrave East & Martlesham,East Suffolk,East of England,2694,7933,777,812,504,769,10795,2475,8199,770,845,577,737,11128
E02006297,"Bixley, Warren Heath & Nacton",East Suffolk,East of England,1331,4725,548,555,390,677,6895,1249,5022,553,595,442,678,7290
E02006298,Trimley & Kirton,East Suffolk,East of England,1600,5504,666,655,395,470,7690,1475,5728,679,696,437,482,8022
E02006299,Felixstowe East,East Suffolk,East of England,1005,4018,764,896,661,1037,7376,944,4260,738,876,731,1086,7691
E02006300,Felixstowe West,East Suffolk,East of England,1489,4666,434,462,329,401,6292,1483,5248,442,450,359,390,6889
E02006301,Felixstowe Seafront,East Suffolk,East of England,976,3611,474,455,306,629,5475,928,4116,430,524,326,577,5973
E02006302,"Gunton East, Corton & Somerleyton",East Suffolk,East of England,845,3655,570,665,439,568,5897,846,3804,538,628,485,620,6075
E02006303,Gunton West,East Suffolk,East of England,1712,4876,396,447,296,425,6440,1773,5154,380,392,329,392,6647
E02006304,Oulton,East Suffolk,East of England,1252,3990,584,723,533,692,6522,1227,4348,569,728,586,726,6957
E02006305,Lowestoft Central,East Suffolk,East of England,2176,6425,388,416,314,305,7848,2278,7516,399,391,282,324,8912
E02006306,Normanston & Oulton Broad East,East Suffolk,East of England,1383,4144,456,592,387,548,6127,1298,4485,494,541,411,526,6457
E02006307,Oulton Broad West,East Suffolk,East of England,1045,3681,617,767,430,763,6258,925,3985,535,778,526,745,6569
E02006308,Lowestoft Harbour & Kirkley,East Suffolk,East of England,1413,4894,438,380,224,387,6323,1422,5585,451,418,273,377,7104
E02006309,Pakefield North,East Suffolk,East of England,1203,3671,485,517,335,688,5696,1183,3884,457,530,407,637,5915
E02006310,Carlton Colville,East Suffolk,East of England,1722,5059,419,513,349,460,6800,1539,5103,396,469,390,504,6862
E02006311,Beccles,East Suffolk,East of England,1417,4491,593,667,500,803,7054,1315,4662,562,670,555,783,7232
E02006312,Worlingham & Barnby,East Suffolk,East of England,1475,4975,606,700,479,595,7355,1289,5081,625,689,504,625,7524
E02006313,Pakefield South & Kessingland,East Suffolk,East of England,1507,5401,765,943,612,805,8526,1481,5735,703,888,695,816,8837
E02006314,Bungay & the Saints,East Suffolk,East of England,1166,4105,589,527,401,595,6217,1116,4254,580,576,386,636,6432
E02006315,"Southwold, Reydon & Wrentham",East Suffolk,East of England,746,2935,550,560,396,661,5102,748,3221,541,532,440,598,5332
E02006316,Halesworth & Wangford,East Suffolk,East of England,1075,3644,547,651,490,799,6131,1027,3823,555,643,517,777,6315
E02006238,Brandon,West Suffolk,East of England,1800,5538,602,726,473,646,7985,1545,5936,613,653,512,697,8411
E02006239,Lakenheath,West Suffolk,East of England,1657,4875,299,339,231,318,6062,814,2957,290,333,238,335,4153
E02006240,"Beck Row, Eriswell & Barton Mills",West Suffolk,East of England,2969,6045,454,437,247,333,7516,1504,4955,470,455,270,324,6474
E02006241,Mildenhall,West Suffolk,East of England,1872,5234,511,479,375,583,7182,1434,5165,473,500,372,549,7059
E02006242,"Red Lodge, Icklingham & Moulton",West Suffolk,East of England,2536,6019,374,434,210,421,7458,2030,6125,413,446,300,337,7621
E02006243,"North Newmarket, Studlands & Exning",West Suffolk,East of England,1792,5616,444,425,278,411,7174,1667,6745,427,423,321,408,8324
E02006273,Stanton & Barningham,West Suffolk,East of England,1130,3622,546,556,377,495,5596,1045,3783,488,582,434,494,5781
E02006274,"Ixworth, Honington & Barnham",West Suffolk,East of England,1227,4243,345,375,261,369,5593,1067,4305,345,381,295,402,5728
E02006275,Howard Estate & Northgate,West Suffolk,East of England,1532,4337,293,367,256,357,5610,1431,4913,297,326,261,347,6144
E02006276,"Fornham, Great Barton & Rougham",West Suffolk,East of England,1107,3543,531,573,439,681,5767,1248,4329,510,562,457,661,6519
E02006277,Moreton Hall,West Suffolk,East of England,1736,5240,305,317,184,212,6258,1557,5158,326,322,211,272,6289
E02006278,Bury St Edmunds Central,West Suffolk,East of England,1156,5681,440,483,369,664,7637,984,5508,447,462,386,565,7368
E02006279,Bury St Edmunds West,West Suffolk,East of England,1455,4977,556,666,465,706,7370,1354,5274,535,644,496,715,7664
E02006280,"Barrow, Chedburgh & Sicklesmere",West Suffolk,East of England,1761,5380,634,741,513,760,8028,1723,5849,651,734,602,752,8588
E02006281,Eastgate & Southgate,West Suffolk,East of England,1256,4658,571,672,546,1097,7544,1140,4958,520,656,578,967,7679
E02006282,"Clare, Cavendish & Wickhambrook",West Suffolk,East of England,978,3355,506,578,401,550,5390,914,3559,526,567,466,549,5667
E02006283,"Kedington, Hundon & Withersfield",West Suffolk,East of England,1087,4864,437,516,351,371,6539,1162,5226,454,490,409,409,6988
E02006284,Haverhill North,West Suffolk,East of England,1671,4704,392,443,294,429,6262,1526,5017,380,412,313,409,6531
E02006285,Haverhill West,West Suffolk,East of England,1800,4928,302,280,219,244,5973,1582,5292,276,295,224,289,6376
E02006286,Haverhill East & South,West Suffolk,East of England,2530,7241,536,565,354,549,9245,2341,7669,523,593,412,501,9698
E02006826,South Newmarket & Racecourse,West Suffolk,East of England,1721,6154,481,473,346,629,8083,1659,7062,458,503,329,612,8964
E02000001,City of London,City of London,London,1494,6585,491,439,281,431,8227,661,7568,377,346,231,302,8824
E02000002,Marks Gate,Barking and Dagenham,London,2132,4594,235,204,197,373,5603,2233,5360,247,206,191,333,6337
E02000003,Chadwell Heath East,Barking and Dagenham,London,2622,7244,354,348,227,379,8552,2721,8192,396,334,250,379,9551
E02000004,Eastbrookend,Barking and Dagenham,London,1380,4256,229,237,207,378,5307,1368,4530,284,242,189,332,5577
E02000005,Becontree Heath,Barking and Dagenham,London,2896,6612,247,248,165,264,7536,3176,7798,284,238,170,255,8745
E02000007,Central Park & Frizlands Lane,Barking and Dagenham,London,2775,6202,282,263,183,343,7273,2883,6944,309,278,181,304,8016
E02000008,Becontree East,Barking and Dagenham,London,3383,7949,425,324,228,353,9279,3739,9453,437,319,224,330,10763
E02000009,Becontree West,Barking and Dagenham,London,3400,7556,315,191,147,220,8429,3659,9509,345,235,155,234,10478
E02000010,Dagenham North,Barking and Dagenham,London,2463,5870,264,207,127,273,6741,2663,7040,309,204,152,243,7948
E02000011,Dagenham Eastbrook,Barking and Dagenham,London,1666,4480,240,186,144,278,5328,1773,5062,253,212,183,311,6021
E02000012,Longbridge & Barking Park,Barking and Dagenham,London,2745,7327,372,280,201,366,8546,2786,8259,378,292,185,352,9466
E02000013,Becontree South,Barking and Dagenham,London,2492,5563,306,231,154,202,6456,2540,6800,313,268,151,221,7753
E02000014,Dagenham Central,Barking and Dagenham,London,2636,6242,324,297,165,285,7313,2622,7481,349,332,215,284,8661
E02000015,Old Dagenham Park & Village,Barking and Dagenham,London,2230,5203,245,188,117,207,5960,2449,5957,274,219,135,202,6787
E02000016,Barking Central,Barking and Dagenham,London,3002,6672,124,112,47,64,7019,3517,9249,165,122,74,76,9686
E02000017,Barking East,Barking and Dagenham,London,2181,6303,246,191,124,230,7094,2541,8416,364,216,149,214,9359
E02000018,Mayesbrook Park & Rippleside,Barking and Dagenham,London,2760,6076,263,181,145,224,6889,2774,7206,308,226,147,212,8099
E02000019,Goresbrook & Scrattons Farm,Barking and Dagenham,London,2527,5798,300,228,142,179,6647,2697,6825,313,259,152,204,7753
E02000020,Creekmouth & Barking Riverside,Barking and Dagenham,London,3795,8556,279,243,173,309,9560,3924,10550,353,273,175,283,11634
E02000021,Rylands Estate & Dagenham Dock,Barking and Dagenham,London,2472,5558,270,224,161,259,6472,2662,6410,292,237,151,238,7328
E02000022,Gascoigne Estate & Roding Riverside,Barking and Dagenham,London,2739,5116,112,95,52,69,5444,2534,6256,158,83,74,64,6635
E02000023,Thames View,Barking and Dagenham,London,2628,4970,162,109,41,114,5396,2566,6077,182,137,53,100,6549
E02006799,Becontree North,Barking and Dagenham,London,3057,6998,326,249,192,316,8081,3300,8716,377,273,207,312,9885
E02000024,High Barnet & Hadley,Barnet,London,1974,6877,565,569,383,689,9083,1914,7334,584,581,427,641,9567
E02000025,Hadley Wood,Barnet,London,1633,5312,362,407,233,400,6714,1569,5530,370,376,262,387,6925
E02000026,Oak Hill,Barnet,London,1354,3972,333,331,242,361,5239,1291,4424,343,347,265,377,5756
E02000027,Ducks Island & Underhill,Barnet,London,2024,6002,522,397,276,417,7614,1968,6733,485,428,310,430,8386
E02000028,New Barnet West,Barnet,London,1388,4332,281,262,194,352,5421,1332,4595,289,292,207,363,5746
E02000029,New Barnet Town & East Barnet,Barnet,London,2246,5959,365,325,239,317,7205,2126,6456,396,346,253,312,7763
E02000030,Totteridge & Barnet Gate,Barnet,London,1684,5436,527,530,376,688,7557,1684,6291,556,549,406,633,8435
E02000031,Oakleigh Park,Barnet,London,1483,4752,370,357,307,587,6373,1637,5893,415,397,313,603,7621
E02000032,Osidge,Barnet,London,1576,4749,386,355,314,391,6195,1576,5572,424,437,306,486,7225
E02000033,Brunswick Park Road,Barnet,London,1786,5751,395,339,221,411,7117,1772,6229,408,356,252,370,7615
E02000034,Whetstone East,Barnet,London,1899,5953,376,433,279,416,7457,1936,6682,454,398,316,427,8277
E02000035,Woodside Park,Barnet,London,1740,5817,382,401,232,505,7337,1750,6475,389,410,311,491,8076
E02000036,Edgware East,Barnet,London,2771,7194,444,453,300,483,8874,2854,8356,511,446,355,467,10135
E02000037,Edgware Park,Barnet,London,2703,6021,517,502,334,475,7849,2695,7205,540,560,348,501,9154
E02000038,Friern Barnet,Barnet,London,2317,7529,484,390,271,488,9162,2155,7815,533,417,295,518,9578
E02000039,Mill Hill Park,Barnet,London,1562,4527,289,330,214,333,5693,1499,5287,318,363,225,332,6525
E02000040,Mill Hill East,Barnet,London,1975,5150,384,345,238,360,6477,1997,6425,379,362,300,380,7846
E02000041,Edgware Central,Barnet,London,2340,6181,431,312,266,504,7694,2346,7695,493,381,269,461,9299
E02000042,North Finchley,Barnet,London,2454,8076,435,383,325,574,9793,2282,8686,478,419,341,566,10490
E02000043,West Finchley,Barnet,London,1929,4961,384,341,194,397,6277,1952,5715,380,362,232,375,7064
E02000044,Mill Hill Broadway,Barnet,London,2126,5801,287,275,180,207,6750,2176,7143,343,271,187,224,8168
E02000045,Colney Hatch,Barnet,London,2363,7373,366,337,233,273,8582,2352,8004,395,377,222,301,9299
E02000046,Church End,Barnet,London,1391,5300,262,213,183,274,6232,1392,5928,269,255,186,268,6906
E02000047,Burnt Oak & Watling Park,Barnet,London,2870,8162,425,359,258,348,9552,2978,10050,490,394,229,408,11571
E02000048,Copthall & Downage,Barnet,London,2323,6608,474,468,308,526,8384,2321,7526,485,490,382,570,9453
E02000049,Grahame Park,Barnet,London,2492,6233,266,211,133,141,6984,2626,7965,321,239,166,172,8863
E02000050,Fallow Corner,Barnet,London,2320,7173,436,409,281,391,8690,2131,7891,442,407,284,368,9392
E02000051,Finchley Central,Barnet,London,1878,6195,414,408,338,639,7994,1846,7315,444,464,393,591,9207
E02000052,East Finchley,Barnet,London,1998,7244,406,358,267,340,8615,1984,7376,392,342,284,371,8765
E02000053,Colindale,Barnet,London,3647,11915,381,246,211,285,13038,3907,14941,451,337,196,288,16213
E02000054,North Hendon & Sunny Hill,Barnet,London,1378,5339,297,246,158,230,6270,1576,6439,336,255,207,247,7484
E02000055,Hendon Central,Barnet,London,2290,8172,384,342,248,558,9704,2570,10600,426,392,273,486,12177
E02000056,Hampstead Garden Suburb,Barnet,London,2142,5663,384,491,363,566,7467,1971,6281,430,521,363,571,8166
E02000057,Hendon Park,Barnet,London,2119,5105,237,242,183,279,6046,2284,6617,271,271,188,290,7637
E02000058,Temple Fortune,Barnet,London,2388,6655,465,513,393,537,8563,2496,7795,475,524,422,578,9794
E02000059,West Hendon,Barnet,London,2358,8183,422,291,245,374,9515,2261,9642,489,345,241,423,11140
E02000060,Golders Green North,Barnet,London,3571,7182,397,336,227,640,8782,3747,8922,487,385,275,596,10665
E02000061,Golders Green South,Barnet,London,1656,6152,369,308,193,497,7519,1668,7310,362,374,245,484,8775
E02000062,Brent Cross & Staples Corner,Barnet,London,1485,4835,255,177,104,165,5536,1522,6286,283,216,107,173,7065
E02000063,North Cricklewood,Barnet,London,1620,5385,284,215,188,263,6335,1711,7002,379,277,184,274,8116
E02000064,Childs Hill,Barnet,London,1305,4781,255,203,154,229,5622,1251,5613,235,213,167,222,6450
E02000065,Crossway Park,Bexley,London,2393,5851,246,169,98,194,6558,2219,6005,272,187,125,118,6707
E02000066,South Thamesmead,Bexley,London,2446,6595,337,321,210,273,7736,2328,6938,396,319,202,226,8081
E02000067,Belvedere & Lessness Heath,Bexley,London,2545,6837,288,291,206,287,7909,2476,7156,357,319,205,272,8309
E02000068,Erith East,Bexley,London,2086,5358,229,166,127,237,6117,2125,5532,277,197,142,245,6393
E02000069,Erith West,Bexley,London,1510,4286,275,269,206,365,5401,1513,4482,319,282,233,363,5679
E02000070,Lesnes Abbey,Bexley,London,1503,5050,371,394,290,471,6576,1543,5258,409,411,327,475,6880
E02000071,Northumberland Heath,Bexley,London,1623,4932,334,285,168,304,6023,1703,5236,380,327,208,307,6458
E02000072,Slade Green & Crayford Marshes,Bexley,London,3579,8372,311,285,192,300,9460,3465,8732,366,295,178,294,9865
E02000073,Bostall,Bexley,London,2078,6695,535,534,417,600,8781,2030,7052,539,586,425,637,9239
E02000074,Lesney Farm & Colyers East,Bexley,London,1979,5513,331,308,228,324,6704,2038,5953,351,325,232,327,7188
E02000075,Bursted Wood,Bexley,London,1409,4869,476,533,353,581,6812,1401,5082,486,513,370,564,7015
E02000077,St Michael's,Bexley,London,1569,5304,341,329,237,434,6645,1569,5551,346,376,247,451,6971
E02000078,Barnehurst North,Bexley,London,1482,4924,399,389,265,463,6440,1527,5146,423,398,301,441,6709
E02000079,Bexleyheath Broadway,Bexley,London,1661,5392,357,353,293,712,7107,1688,5573,392,392,318,679,7354
E02000080,Welling,Bexley,London,2004,6599,424,403,347,561,8334,2060,6916,508,454,324,531,8733
E02000081,Barnehurst South,Bexley,London,1589,4852,380,413,304,548,6497,1648,5271,401,432,308,551,6963
E02000082,Falconwood,Bexley,London,1842,5849,391,421,264,461,7386,1880,6245,439,431,288,449,7852
E02000083,Crayford,Bexley,London,2527,7495,386,396,353,411,9041,2477,7751,390,434,324,396,9295
E02000084,Danson Park,Bexley,London,2162,6796,590,547,375,611,8919,2184,7145,598,582,426,578,9329
E02000085,Blackfen,Bexley,London,1591,5093,334,376,250,400,6453,1609,5358,376,372,288,391,6785
E02000086,Lamorbey,Bexley,London,1339,4542,386,398,264,352,5942,1360,4699,395,402,301,344,6141
E02000087,Bexley Village,Bexley,London,1380,4921,389,400,352,591,6653,1414,5238,400,422,362,627,7049
E02000088,Albany Park,Bexley,London,1508,4779,389,379,315,428,6290,1472,5000,379,378,354,434,6545
E02000089,Longlands & Halfway,Bexley,London,1548,4669,393,347,282,565,6256,1557,4994,403,393,319,552,6661
E02000090,Sidcup West,Bexley,London,1568,6008,386,436,339,746,7915,1525,5956,400,454,389,677,7876
E02000091,Sidcup East,Bexley,London,1657,6038,459,552,383,888,8320,1706,6055,500,584,434,865,8438
E02000092,Foots Cray Meadows,Bexley,London,1496,4197,293,267,190,340,5287,1444,4348,312,318,205,341,5524
E02006785,Wickham Street & East Wickham,Bexley,London,1245,4184,323,289,226,384,5406,1242,4447,318,302,245,359,5671
E02000093,Queensbury South,Brent,London,2496,6916,475,429,285,458,8563,2695,10067,599,437,349,520,11972
E02000094,Kingsbury East & Colindale,Brent,London,2043,5976,392,328,232,306,7234,2308,8867,422,313,240,376,10218
E02000095,Kingsbury West,Brent,London,2099,6091,475,374,293,562,7795,2219,8964,542,413,303,421,10643
E02000096,Kenton Woodcock Park,Brent,London,1467,4278,463,456,310,480,5987,1529,5878,465,471,327,480,7621
E02000097,Kingsbury South,Brent,London,1988,5731,395,316,222,375,7039,2033,7799,448,323,260,393,9223
E02000098,Barnhill The Avenue,Brent,London,1845,5239,373,326,219,345,6502,1907,7215,417,373,259,439,8703
E02000099,Preston Park & East Lane,Brent,London,2069,5695,301,229,178,400,6803,2245,7509,329,246,181,312,8577
E02000100,Northwick Park,Brent,London,1324,5917,439,385,272,388,7401,1362,6819,471,387,328,440,8445
E02000101,Forty Lane,Brent,London,2201,5963,391,347,251,409,7361,2415,8890,423,364,270,402,10349
E02000102,Welsh Harp,Brent,London,1924,4749,293,196,194,221,5653,2133,6768,319,219,176,272,7754
E02000103,Dollis Hill,Brent,London,2196,5815,342,257,238,384,7036,2357,8096,367,296,244,354,9357
E02000104,Wembley North,Brent,London,1471,4548,322,270,217,427,5784,1575,6413,328,277,232,388,7638
E02000105,Sudbury East,Brent,London,2214,6351,382,291,194,314,7532,2333,8836,373,308,202,328,10047
E02000106,Neasden,Brent,London,2453,7028,385,278,222,328,8241,2544,9846,427,346,220,333,11172
E02000107,Cricklewood Anson Road,Brent,London,2049,8256,404,368,217,257,9502,2057,10703,453,366,242,270,12034
E02000108,Sudbury West,Brent,London,1465,4173,301,237,158,222,5091,1575,6009,313,243,157,260,6982
E02000109,Tokyngton,Brent,London,2498,9698,388,294,267,379,11026,2867,15157,433,301,273,420,16584
E02000110,Dudden Hill,Brent,London,1510,5967,389,278,197,237,7068,1533,7552,362,333,219,266,8732
E02000111,Wembley West,Brent,London,2412,7194,464,290,224,362,8534,2819,11428,522,352,215,376,12893
E02000112,Wembley East,Brent,London,2000,7280,419,245,202,384,8530,2497,11632,521,299,226,429,13107
E02000113,St Raphaels,Brent,London,2600,5995,370,259,161,261,7046,2522,8129,366,269,183,256,9203
E02000114,Willesden Green,Brent,London,1657,7286,323,252,181,269,8311,1625,9115,345,269,163,261,10153
E02000115,Brondesbury,Brent,London,1277,6404,320,239,178,298,7439,1423,8406,347,286,191,291,9521
E02000116,Roundwood Park,Brent,London,2101,6547,240,199,130,190,7306,2028,8351,298,211,163,208,9231
E02000117,Church End,Brent,London,3274,8193,429,267,290,415,9594,3240,10895,474,333,253,407,12362
E02000118,Alperton East,Brent,London,2259,7032,371,271,197,315,8186,2447,10236,488,293,207,316,11540
E02000119,Stonebridge,Brent,London,2512,5647,266,240,161,234,6548,2507,7886,320,243,170,295,8914
E02000120,Kilburn West,Brent,London,1619,6637,313,256,211,211,7628,1720,10055,327,320,165,244,11111
E02000121,Alperton West,Brent,London,2372,7102,448,297,229,313,8389,2898,11479,470,323,222,327,12821
E02000122,Brondesbury Park,Brent,London,1462,5078,333,288,201,348,6248,1671,7423,383,322,215,352,8695
E02000123,Harlesden,Brent,London,3506,10779,440,304,239,347,12109,3412,13432,539,339,224,350,14884
E02000124,Queens Park,Brent,London,2020,6906,321,296,201,262,7986,2049,9036,419,306,237,276,10274
E02000125,Kensal Green,Brent,London,2008,6866,400,276,215,391,8148,2103,9062,421,311,224,389,10407
E02000126,Kilburn Park,Brent,London,1906,5049,230,207,153,215,5854,1866,7180,278,228,170,215,8071
E02000127,Mottingham,Bromley,London,2229,5931,361,305,200,370,7167,2197,6529,368,356,221,368,7842
E02000128,Chislehurst North,Bromley,London,1626,4807,321,379,267,363,6137,1659,5120,344,402,270,380,6516
E02000130,Penge East,Bromley,London,1805,5789,365,345,193,260,6952,1770,6187,350,333,232,265,7367
E02000131,Crystal Palace Park,Bromley,London,1902,8039,239,238,124,145,8785,1876,8225,258,251,134,157,9025
E02000132,New Beckenham,Bromley,London,1764,7008,422,364,257,448,8499,1761,7274,397,429,273,419,8792
E02000133,Chislehurst West & Elmstead,Bromley,London,2040,6382,449,518,413,818,8580,2124,7072,535,530,464,752,9353
E02000134,Bromley North & Sundridge,Bromley,London,2407,8133,453,380,318,408,9692,2555,8842,475,461,313,402,10493
E02000135,Anerley North & Penge West,Bromley,London,2188,7457,345,237,157,306,8502,2036,7949,365,258,170,298,9040
E02000136,Chislehurst East & Hoblingwell Wood,Bromley,London,1122,3358,267,323,207,511,4666,1056,3653,275,281,264,545,5018
E02000137,Shortlands Bromley Road,Bromley,London,1566,5314,372,426,309,552,6973,1585,5463,396,440,333,567,7199
E02000138,Beckenham East & Kelsey Park,Bromley,London,1246,5312,399,481,389,724,7305,1372,5775,440,485,431,721,7852
E02000139,Clock House & Cator Park,Bromley,London,1706,5358,270,252,155,251,6286,1689,5805,332,261,165,224,6787
E02000140,St Mary Cray North,Bromley,London,2319,5405,298,308,218,285,6514,2108,5863,313,310,209,293,6988
E02000141,Anerley South,Bromley,London,1505,5061,270,233,150,230,5944,1506,5280,279,253,166,235,6213
E02000142,Widmore,Bromley,London,1888,5388,440,396,272,468,6964,1826,6013,414,444,290,459,7620
E02000144,Bromley South,Bromley,London,1947,6663,351,393,269,401,8077,1983,7286,346,376,272,429,8709
E02000145,St Mary Cray East,Bromley,London,2433,5560,323,333,199,274,6689,2199,5932,343,324,244,289,7132
E02000146,Bickley West,Bromley,London,1954,6217,345,335,272,501,7670,2037,6783,363,351,259,523,8279
E02000147,Langley Park,Bromley,London,1673,4903,426,458,301,491,6579,1620,5445,444,513,343,520,7265
E02000148,Bickley East,Bromley,London,1366,3908,378,379,292,426,5383,1310,4297,378,403,319,446,5843
E02000149,St Mary Cray South,Bromley,London,1775,5130,333,355,226,364,6408,1754,5545,339,358,223,378,6843
E02000150,Eden Park & Bethlem,Bromley,London,1837,5419,381,367,265,434,6866,1758,5904,377,403,280,435,7399
E02000151,Petts Wood,Bromley,London,1619,4344,405,472,347,460,6028,1591,4779,424,445,380,515,6543
E02000152,Bromley Common,Bromley,London,1979,4947,277,297,173,330,6024,1859,5512,307,303,206,334,6662
E02000153,Hayes North,Bromley,London,1679,4650,424,435,254,404,6167,1754,5378,390,483,288,418,6957
E02000154,Orpington West,Bromley,London,1638,5250,418,430,335,446,6879,1620,5943,451,447,366,478,7685
E02000155,Orpington East,Bromley,London,1162,4068,379,440,327,554,5768,1218,4661,420,409,358,568,6416
E02000156,West Wickham,Bromley,London,2354,7067,659,687,467,983,9863,2265,7931,702,732,558,997,10920
E02000157,Crofton,Bromley,London,1661,4633,410,493,336,676,6548,1639,5297,433,481,393,694,7298
E02000158,Goddington,Bromley,London,1810,4460,359,432,299,503,6053,1747,5081,366,431,356,519,6753
E02000159,Keston,Bromley,London,1243,4062,407,437,303,508,5717,1227,4701,404,497,309,528,6439
E02000160,Hayes South & Coney Hall,Bromley,London,1538,4842,384,486,265,513,6490,1540,5275,429,495,300,530,7029
E02000161,Orpington South,Bromley,London,1905,5191,400,477,352,463,6883,1835,5736,421,501,360,513,7531
E02000162,Farnborough,Bromley,London,1334,3909,361,418,355,626,5669,1324,4556,373,416,339,644,6328
E02000163,Chelsfield & Green Street Green,Bromley,London,1480,4495,436,444,344,522,6241,1499,5108,474,475,372,531,6960
E02000165,Biggin Hill West,Bromley,London,1403,4339,398,391,206,240,5574,1393,4722,413,413,269,280,6097
E02006782,Plaistow (Bromley),Bromley,London,1679,4923,378,351,289,431,6372,1688,5709,398,410,277,456,7250
E02006787,Elmers End,Bromley,London,1867,5063,363,332,199,324,6281,1918,5664,370,379,219,328,6960
E02006789,Biggin Hill East & Cudham,Bromley,London,1112,3613,405,556,401,405,5380,1091,4089,418,575,428,533,6043
E02000166,Highgate West,Camden,London,1735,5783,479,504,349,470,7585,1335,6571,439,439,293,370,8112
E02000167,Hampstead Town,Camden,London,2014,5901,392,464,362,551,7670,1512,6324,358,386,303,437,7808
E02000168,Tufnell Park West,Camden,London,1649,6724,386,387,237,304,8038,1268,7284,371,297,241,269,8462
E02000169,Frognal,Camden,London,2340,5883,345,395,282,526,7431,1763,6126,307,335,278,394,7440
E02000170,Fortune Green,Camden,London,1852,6949,348,294,241,309,8141,1555,7831,333,289,219,266,8938
E02000171,Mansfield Road & Park Hill Road,Camden,London,1805,6341,388,382,248,349,7708,1445,6909,327,334,234,260,8064
E02000172,Kentish Town West,Camden,London,2625,8432,358,343,247,397,9777,2151,9934,388,307,200,322,11151
E02000173,Fitzjohns & Royal Free,Camden,London,2066,6919,341,284,231,389,8164,1706,7633,242,261,226,305,8667
E02000174,Kentish Town East,Camden,London,1718,7619,379,300,192,259,8749,1423,8862,339,241,196,220,9858
E02000175,West Hampstead,Camden,London,1625,8935,367,324,191,259,10076,1428,9351,305,278,180,189,10303
E02000176,Belsize Park,Camden,London,1380,5466,271,325,218,280,6560,1168,5860,226,249,177,230,6742
E02000177,Chalk Farm,Camden,London,1964,7101,337,343,251,462,8494,1576,8295,322,294,212,353,9476
E02000178,Kilburn Grange,Camden,London,1801,7832,335,327,149,229,8872,1457,9116,303,282,181,199,10081
E02000179,Adelaide Road,Camden,London,1618,4885,243,324,191,335,5978,1202,5442,248,230,159,243,6322
E02000180,Camden Road South,Camden,London,1644,7559,303,260,166,229,8517,1246,7403,282,231,164,189,8269
E02000181,South Hampstead,Camden,London,1754,6740,278,254,162,298,7732,1436,7753,280,270,165,218,8686
E02000182,Swiss Cottage,Camden,London,1895,6000,244,330,178,427,7179,1670,7397,236,224,197,312,8366
E02000183,Primrose Hill,Camden,London,1581,5846,421,383,305,349,7304,1330,6613,358,343,275,333,7922
E02000184,Camden Street & Elm Village,Camden,London,1670,8324,251,235,113,226,9149,1306,9974,268,214,130,185,10771
E02000185,Kilburn East,Camden,London,2009,6787,396,365,277,357,8182,1813,8277,369,342,238,294,9520
E02000186,Camden Town & Mornington Crescent,Camden,London,1112,6526,230,215,183,234,7388,852,6220,229,166,146,162,6923
E02000187,Somers Town,Camden,London,2395,8113,353,223,209,305,9203,1839,9502,308,214,161,220,10405
E02000188,Euston,Camden,London,1736,6469,272,165,163,255,7324,1297,7454,259,175,125,182,8195
E02000189,Gray's Inn Road,Camden,London,1292,5343,190,128,97,177,5935,817,7429,150,147,82,129,7937
E02000190,Bloomsbury East,Camden,London,1063,6941,310,266,161,233,7911,710,9907,239,216,145,186,10693
E02000191,Fitzrovia East & Bloomsbury West,Camden,London,686,7495,227,189,130,158,8199,406,9939,175,135,118,126,10493
E02000192,Hatton Garden & Theobalds Road,Camden,London,1338,6637,350,248,159,264,7658,1010,7068,297,219,131,189,7904
E02000193,"Holborn, St Giles & Bloomsbury South",Camden,London,766,6883,318,346,198,227,7972,577,8737,283,242,178,183,9623
E02000194,Crystal Palace Triangle,Croydon,London,1881,6565,322,257,191,275,7610,1917,7907,342,309,203,307,9068
E02000195,Upper Norwood,Croydon,London,1974,6370,459,370,265,434,7898,2015,7577,503,422,305,508,9315
E02000196,Norbury East,Croydon,London,1577,5318,348,278,211,323,6478,1656,6764,404,313,235,380,8096
E02000197,Norbury West,Croydon,London,2131,6186,411,313,240,361,7511,2053,7897,416,367,250,394,9324
E02000198,Thornton Heath North West,Croydon,London,2212,5718,272,175,166,214,6545,2150,7402,318,242,154,247,8363
E02000199,Thornton Heath North East,Croydon,London,1906,5575,317,208,131,205,6436,1876,7237,369,288,191,243,8328
E02000200,South Norwood Hill,Croydon,London,1842,6014,271,266,161,332,7044,1775,6988,311,266,189,299,8053
E02000201,South Norwood Central,Croydon,London,2416,6060,270,185,121,222,6858,2101,6823,327,233,138,220,7741
E02000202,Thornton Heath West,Croydon,London,1849,5471,338,265,216,344,6634,1936,7453,399,310,212,360,8734
E02000203,Thornton Heath Central,Croydon,London,1911,5244,301,227,167,256,6195,1851,6776,334,274,183,299,7866
E02000204,West Thornton North,Croydon,London,2238,6249,402,271,227,324,7473,2258,8547,455,330,251,374,9957
E02000206,Selhurst North,Croydon,London,2527,6568,336,210,204,379,7697,2527,8227,397,266,180,279,9349
E02000207,Woodside & Ashburton,Croydon,London,2094,6141,322,213,173,195,7044,1884,7171,345,226,175,217,8134
E02000208,University Hospital & Queen's Road,Croydon,London,2898,7219,274,176,162,215,8046,2910,9246,340,241,150,252,10229
E02000209,West Thornton South & Ampere Way,Croydon,London,2219,5740,312,195,101,214,6562,2209,7620,333,234,171,208,8566
E02000210,Addiscombe North,Croydon,London,1867,5698,301,207,157,224,6587,1904,6682,340,257,157,240,7676
E02000211,Monks Orchard,Croydon,London,1371,4870,487,474,346,520,6697,1399,5358,491,487,381,526,7243
E02000212,Broad Green & Waddon Marsh,Croydon,London,2540,6096,246,165,142,178,6827,2535,8136,293,208,153,192,8982
E02000213,Selhurst South & West Croydon,Croydon,London,2908,7786,268,214,139,160,8567,2953,10388,329,282,199,296,11494
E02000214,Addiscombe East,Croydon,London,1188,3901,346,276,189,317,5029,1192,4524,358,331,210,338,5761
E02000215,Addiscombe West,Croydon,London,2230,8069,367,298,251,373,9358,2462,9642,432,351,237,400,11062
E02000216,Park Hill & Lloyd Park,Croydon,London,1463,4236,334,301,263,499,5633,1604,5406,323,318,263,473,6783
E02000217,Croydon Minster & Waddon North,Croydon,London,2996,8549,288,203,152,203,9395,2763,9522,327,246,158,219,10472
E02000218,Shirley East,Croydon,London,1625,3966,347,244,160,264,4981,1523,4653,339,270,189,269,5720
E02000219,Shirley West,Croydon,London,1100,4307,502,539,405,609,6362,1175,4916,505,556,427,661,7065
E02000220,Central Croydon,Croydon,London,2629,9688,300,271,171,333,10763,2777,11374,375,286,203,345,12583
E02000221,Waddon South,Croydon,London,2655,6872,308,328,223,394,8125,2578,7954,363,345,225,431,9318
E02000222,Croham,Croydon,London,1687,5595,304,290,196,266,6651,1665,6028,352,291,199,287,7157
E02000223,New Addington North,Croydon,London,2781,5003,219,172,172,238,5804,2557,6236,246,179,171,225,7057
E02000224,Purley North,Croydon,London,1829,5296,297,261,155,254,6263,1884,6111,315,292,201,211,7130
E02000225,New Addington Central,Croydon,London,1820,4665,295,290,208,251,5709,1744,5496,335,301,218,266,6616
E02000226,Selsdon,Croydon,London,1258,4548,469,449,312,491,6269,1411,5509,500,480,352,535,7376
E02000227,Forestdale,Croydon,London,2365,7032,582,611,360,507,9092,2403,8058,611,660,422,535,10286
E02000228,Sanderstead,Croydon,London,1476,4391,466,531,335,584,6307,1555,4990,472,524,381,617,6984
E02000229,New Addington South,Croydon,London,1794,4038,262,210,161,264,4935,1719,4718,255,205,149,269,5596
E02000230,Purley Central,Croydon,London,2083,6644,516,483,319,573,8535,2070,7327,551,483,359,585,9305
E02000231,Woodcote,Croydon,London,1327,4565,469,434,294,494,6256,1458,5442,493,448,312,498,7193
E02000232,Selsdon Park & Hamsey Green,Croydon,London,1190,3624,403,385,255,410,5077,1168,4183,349,446,263,440,5681
E02000233,Kenley North,Croydon,London,1413,3951,282,233,151,348,4965,1431,4349,294,248,193,334,5418
E02000234,Coulsdon,Croydon,London,1941,5560,410,410,240,387,7007,2101,6412,402,442,311,377,7944
E02000235,Kenley South,Croydon,London,1349,4321,378,353,234,331,5617,1347,4796,374,361,276,358,6165
E02000236,Woodmansterne,Croydon,London,1853,4884,438,405,241,315,6283,2041,5743,433,423,273,346,7218
E02000237,Old Coulsdon,Croydon,London,1469,4280,464,489,365,522,6120,1509,4843,462,484,398,534,6721
E02006788,South Norwood Park,Croydon,London,1790,4968,273,227,125,200,5793,1720,5837,275,261,145,189,6707
E02000238,Whitton Avenue West,Ealing,London,2151,6086,355,312,208,252,7213,2271,8202,385,315,221,263,9386
E02000239,Horsenden,Ealing,London,1730,5670,380,341,271,375,7037,1818,7373,428,385,275,407,8868
E02000240,Northolt West,Ealing,London,2568,6252,390,286,223,322,7473,2696,8578,430,348,237,296,9889
E02000241,Northolt East,Ealing,London,1520,4312,273,208,164,233,5190,1579,5636,308,241,164,253,6602
E02000242,Bilton Road,Ealing,London,1425,4495,313,216,143,232,5399,1427,5868,370,242,150,257,6887
E02000243,Greenford North,Ealing,London,1782,5371,369,270,216,405,6631,1779,7020,411,319,228,355,8333
E02000244,Perivale,Ealing,London,1558,4884,353,303,150,272,5962,1698,6297,324,327,208,256,7412
E02000245,Northolt South,Ealing,London,2343,5081,273,192,146,274,5966,2511,6951,317,229,153,225,7875
E02000246,Kingshill Avenue,Ealing,London,2319,5198,323,230,177,298,6226,2345,6999,342,301,200,282,8124
E02000247,Greenford West,Ealing,London,2734,6334,425,294,239,496,7788,2806,8707,400,368,238,473,10186
E02000248,Hanger Hill East,Ealing,London,1583,5189,306,240,140,280,6155,1707,6846,314,294,191,311,7956
E02000249,Greenford South,Ealing,London,1648,4639,273,240,233,386,5771,1758,6380,310,270,238,380,7578
E02000250,Pitshanger,Ealing,London,1352,3646,389,311,206,321,4873,1387,4820,405,350,247,383,6205
E02000251,Greenford Ravenor Park,Ealing,London,1596,4670,328,250,205,308,5761,1759,6918,421,312,213,348,8212
E02000252,North Acton,Ealing,London,1934,8743,346,220,161,262,9732,2122,12812,376,244,180,280,13892
E02000253,Cuckoo Park,Ealing,London,2294,5562,384,337,260,420,6963,2433,7657,445,361,280,380,9123
E02000254,Southall North,Ealing,London,1798,5332,406,316,225,308,6587,2066,8379,501,361,243,378,9862
E02000255,Drayton Green & Cleveland,Ealing,London,2031,5610,414,359,276,443,7102,2180,7653,441,424,290,377,9185
E02000256,Ealing Broadway West,Ealing,London,1669,6107,312,255,219,323,7216,1578,8120,357,338,212,371,9398
E02000257,Ealing Broadway East,Ealing,London,2563,10169,535,398,394,563,12059,2791,13590,587,492,389,596,15654
E02000258,Acton Noel Road & Lynton Road,Ealing,London,1480,4718,267,214,123,228,5550,1700,6558,272,225,155,225,7435
E02000259,Brent Valley,Ealing,London,1409,3746,278,216,130,205,4575,1477,5015,293,224,174,221,5927
E02000260,Southall Park,Ealing,London,2167,5788,478,296,262,432,7256,2311,9192,519,370,265,413,10759
E02000261,East Acton,Ealing,London,2470,8396,345,336,225,328,9630,2797,12247,442,361,248,339,13637
E02000262,Acton Central,Ealing,London,1722,6083,285,230,203,274,7075,1968,8813,352,288,198,269,9920
E02000263,Southall West,Ealing,London,2836,7602,504,360,280,469,9215,3405,14006,610,434,301,501,15852
E02000264,Ealing Common & Twyford Ave,Ealing,London,1342,5873,358,305,212,362,7110,1444,8062,397,318,232,392,9401
E02000265,West Ealing,Ealing,London,2325,7008,345,341,237,326,8257,2445,9711,396,363,252,330,11052
E02000266,Norwood Green North & Windmill Park,Ealing,London,2691,7521,425,285,226,377,8834,3061,10815,492,377,246,379,12309
E02000267,Hanwell,Ealing,London,1733,4650,263,198,137,241,5489,1891,6245,331,250,174,205,7205
E02000268,St Mary's,Ealing,London,1470,6105,397,396,193,352,7443,1657,7897,449,418,254,338,9356
E02000269,Northfields,Ealing,London,1648,5147,307,295,150,279,6178,1721,6754,356,309,191,297,7907
E02000270,South Acton,Ealing,London,1858,5154,255,182,148,248,5987,1925,8208,285,202,159,238,9092
E02000271,Bedford Park,Ealing,London,1437,4522,286,287,148,212,5455,1528,6151,313,306,184,235,7189
E02000272,Elthorne Park,Ealing,London,1342,3993,303,278,201,317,5092,1467,5156,353,298,235,345,6387
E02000274,Southall Green,Ealing,London,3587,9154,532,365,241,312,10604,4261,16456,642,470,280,390,18238
E02000275,Norwood Green South,Ealing,London,1727,4648,360,293,208,342,5851,1886,7298,402,342,194,344,8580
E02000276,South Ealing,Ealing,London,1411,4300,255,166,155,185,5061,1495,5717,247,210,175,224,6573
E02006791,Chiswick North West,Ealing,London,1244,4705,289,234,172,143,5543,1420,6675,296,259,198,184,7612
E02000277,Bullsmoor & Freezywater,Enfield,London,1829,4868,265,226,204,278,5841,1839,5382,282,239,177,331,6411
E02000278,Turkey Street,Enfield,London,2633,6052,256,252,233,331,7124,2540,6981,308,264,223,341,8117
E02000279,Enfield Lock,Enfield,London,3594,8461,355,268,160,224,9468,3306,8717,374,279,180,221,9771
E02000280,Chase & Crews Hill,Enfield,London,1875,5161,420,370,290,391,6632,1908,5688,405,407,308,394,7202
E02000281,Carterhatch & Forty Hall,Enfield,London,2336,5749,312,290,214,320,6885,2314,6466,319,324,217,295,7621
E02000282,Enfield Wash,Enfield,London,2874,6203,264,253,195,177,7092,2812,7152,297,251,165,232,8097
E02000283,Brimsdown Avenue,Enfield,London,2165,5705,285,261,166,272,6689,2189,6478,317,269,201,297,7562
E02000284,Chase Side,Enfield,London,1856,5483,348,348,253,358,6790,1841,5906,402,353,250,371,7282
E02000285,Enfield Town North,Enfield,London,1201,4016,322,327,221,336,5222,1286,4669,362,338,247,356,5972
E02000286,Chase Farm & The Ridgeway,Enfield,London,1400,5285,427,437,352,611,7112,1506,5465,474,433,351,620,7343
E02000287,Cockfosters & Hadley Wood,Enfield,London,1349,4256,398,407,293,494,5848,1413,4809,438,404,322,553,6526
E02000288,Southbury East,Enfield,London,2983,7283,323,267,223,325,8421,2994,8411,341,296,245,369,9662
E02000289,World's End,Enfield,London,1266,3836,318,386,295,448,5283,1339,4602,337,387,270,459,6055
E02000290,Brimsdown & Ponders End,Enfield,London,2023,4153,216,136,110,177,4792,1977,4678,234,143,111,174,5340
E02000291,Enfield Town South & Bush Hill Park,Enfield,London,2193,6612,356,315,255,552,8090,2201,7106,411,366,270,507,8660
E02000292,Southbury West,Enfield,London,2253,6380,343,287,225,339,7574,2266,7161,391,357,261,352,8522
E02000293,Grange Park,Enfield,London,1240,3777,372,362,259,441,5211,1231,4281,389,391,298,461,5820
E02000294,Ponders End South,Enfield,London,2299,6003,340,308,223,330,7204,2394,7167,425,311,238,345,8486
E02000295,Oakwood Park & Highlands,Enfield,London,1998,5471,330,310,290,548,6949,1897,6078,388,344,246,530,7586
E02000296,Southgate,Enfield,London,2032,6943,384,344,306,558,8535,2291,7728,392,377,327,570,9394
E02000297,Bury Street West & Village Road,Enfield,London,1712,5938,507,518,339,572,7874,1770,6608,610,531,366,596,8711
E02000298,Winchmore Hill,Enfield,London,1555,5008,412,363,286,436,6505,1658,5764,455,406,314,439,7378
E02000299,Lower Edmonton North,Enfield,London,2633,6506,340,212,191,280,7529,2847,8111,415,267,208,330,9331
E02000300,Haslebury North,Enfield,London,2270,5841,279,209,212,254,6795,2260,6630,342,255,186,265,7678
E02000301,Lower Edmonton South,Enfield,London,2927,6897,322,261,213,287,7980,2957,8401,390,326,192,311,9620
E02000302,Palmers Green East,Enfield,London,1811,5394,388,342,292,325,6741,1852,6281,413,413,309,396,7812
E02000303,Haslebury South,Enfield,London,2282,5959,281,256,161,240,6897,2186,6894,366,270,163,247,7940
E02000304,Southgate Green,Enfield,London,1481,5004,419,417,282,475,6597,1481,5456,454,430,345,503,7188
E02000305,Palmers Green West,Enfield,London,1542,6217,339,306,208,354,7424,1793,7252,442,341,254,380,8669
E02000306,Edmonton Green,Enfield,London,2440,5893,260,226,175,244,6798,2587,7356,310,248,161,266,8341
E02000307,Tatem Park,Enfield,London,2235,6532,411,300,257,345,7845,2379,7565,413,364,252,390,8984
E02000308,New Southgate & Arnos Grove,Enfield,London,1678,5759,311,265,247,261,6843,1807,7202,345,297,234,326,8404
E02000309,Upper Edmonton East & Meridian Water,Enfield,London,3276,8174,333,220,181,226,9134,3304,9419,416,274,191,302,10602
E02000311,Bowes,Enfield,London,2219,7215,450,368,275,336,8644,2231,8038,459,435,240,395,9567
E02000312,Broomfield Park,Enfield,London,1987,8387,406,331,249,414,9787,2232,9383,484,382,254,473,10976
E02006793,Upper Edmonton West,Enfield,London,2690,6672,252,173,155,250,7502,2505,7381,324,217,155,272,8349
E02000313,Thamesmead Birchmere Park,Greenwich,London,1897,4999,218,182,92,82,5573,1754,4957,236,178,115,88,5574
E02000314,West Thamesmead,Greenwich,London,4038,11411,242,176,107,100,12036,3868,13230,349,216,132,165,14092
E02000315,Abbey Wood North,Greenwich,London,2680,6045,263,232,134,295,6969,2689,7162,353,238,172,250,8175
E02000316,"Woolwich Dockyard, Arsenal & Charlton Riverside",Greenwich,London,2742,11540,307,222,147,171,12387,2529,11763,309,261,158,138,12629
E02000317,Woolwich West,Greenwich,London,2153,5308,225,185,137,158,6013,1936,6467,281,187,118,165,7218
E02000318,Plumstead High Street,Greenwich,London,2367,7038,326,302,217,270,8153,2332,8293,420,314,249,259,9535
E02000319,Plumstead Common & Riverside,Greenwich,London,2638,8193,339,198,146,187,9063,2487,8383,331,253,162,162,9291
E02000320,Abbey Wood South,Greenwich,London,1762,4841,260,193,125,149,5568,1643,5094,294,204,145,151,5888
E02000321,Woolwich Glyndon,Greenwich,London,1873,5123,223,188,134,162,5830,1893,5805,255,209,137,176,6582
E02000323,Woolwich South,Greenwich,London,2769,7677,282,221,143,239,8562,2839,9526,348,251,155,241,10521
E02000324,Charlton Village,Greenwich,London,1924,5088,259,230,169,264,6010,1772,5685,316,229,160,229,6619
E02000326,Charlton Slopes,Greenwich,London,1659,5022,244,205,135,192,5798,1727,5768,264,243,159,201,6635
E02000327,Woolwich Common,Greenwich,London,1839,4888,155,112,53,82,5290,1646,4898,190,142,74,103,5407
E02000328,Westcombe Park & Maze Hill,Greenwich,London,1290,4497,283,286,197,317,5580,1300,5012,287,275,200,257,6031
E02000329,Plumstead South,Greenwich,London,1312,4229,252,221,157,250,5109,1313,4330,313,225,189,219,5276
E02000331,Hornfair Park,Greenwich,London,1831,5643,245,227,151,267,6533,1891,6250,286,234,155,225,7150
E02000332,Shooters Hill,Greenwich,London,1582,4974,318,320,175,250,6037,1540,5092,334,278,211,248,6163
E02000333,Blackheath Standard & Village,Greenwich,London,1159,4251,253,267,217,337,5325,1194,4573,221,269,223,353,5639
E02000334,Kidbrooke North,Greenwich,London,1343,4388,272,221,163,232,5276,1391,4935,308,261,173,237,5914
E02000335,Eltham North,Greenwich,London,1410,4242,308,326,200,346,5422,1386,4531,337,316,220,322,5726
E02000337,Eltham West,Greenwich,London,1806,5340,313,325,217,264,6459,1933,6257,360,332,231,268,7448
E02000339,Eltham Park,Greenwich,London,1215,3883,337,328,177,367,5092,1288,4215,364,334,224,362,5499
E02000340,Eltham South,Greenwich,London,1133,4190,317,378,199,450,5534,1256,4565,338,347,278,414,5942
E02000341,Middlepark & Horn Park,Greenwich,London,2034,5198,266,311,159,250,6184,2079,5878,300,282,182,242,6884
E02000342,Avery Hill,Greenwich,London,1263,4168,243,179,127,228,4945,1265,4506,218,236,125,222,5307
E02000343,Mottingham East,Greenwich,London,1530,4286,303,286,206,305,5386,1496,4873,315,330,216,305,6039
E02000344,New Eltham,Greenwich,London,1309,4042,311,342,218,325,5238,1331,4411,334,355,238,312,5650
E02006786,Wickham Lane & Winns Common,Greenwich,London,1790,4851,281,211,167,159,5669,1765,5599,295,227,156,205,6482
E02006927,Kidbrooke South,Greenwich,London,2436,6458,409,386,335,438,8026,2589,8464,442,434,345,466,10151
E02006928,Greenwich & Deptford Creekside,Greenwich,London,2112,9567,168,132,103,57,10027,2175,11804,229,170,94,106,12403
E02006929,Greenwich Peninsula,Greenwich,London,2683,9560,230,192,124,230,10336,3005,12663,282,221,164,192,13522
E02006930,Greenwich East,Greenwich,London,1782,6624,233,186,119,183,7345,1857,7974,253,210,134,145,8716
E02006931,Greenwich Town & Park,Greenwich,London,1783,6875,305,304,206,333,8023,1830,8077,338,311,220,289,9235
E02000345,Stamford Hill North,Hackney,London,3617,5317,232,228,125,160,6062,3804,6720,264,231,121,171,7507
E02000346,Woodberry Down & Manor House,Hackney,London,1857,5589,263,167,119,182,6320,1855,7371,251,202,106,160,8090
E02000347,Stamford Hill West,Hackney,London,3035,5076,221,220,93,213,5823,3227,6260,280,210,119,189,7058
E02000348,Stamford Hill South,Hackney,London,3328,5077,244,137,92,173,5723,3742,6856,238,184,107,165,7550
E02000350,Stoke Newington East & Cazenove,Hackney,London,2305,7095,222,185,121,127,7750,2489,8723,274,209,122,176,9504
E02000351,Brownswood,Hackney,London,1390,7810,204,167,110,172,8463,1440,8498,271,180,136,150,9235
E02000352,Clissold North,Hackney,London,1643,4847,221,180,112,229,5589,1490,5547,271,219,124,188,6349
E02000353,Stoke Newington North,Hackney,London,1393,6010,244,201,110,223,6788,1495,7252,281,211,124,199,8067
E02000354,Hackney Downs,Hackney,London,2036,7741,281,206,207,190,8625,1946,9099,324,222,157,208,10010
E02000355,Lower Clapton,Hackney,London,1621,6751,266,188,156,278,7639,1653,7904,295,233,135,251,8818
E02000356,Clissold South,Hackney,London,1266,5584,190,150,93,128,6145,1252,6881,254,165,115,141,7556
E02000357,Hackney Marshes,Hackney,London,1718,4058,246,208,134,189,4835,1611,5686,312,199,150,196,6543
E02000358,Stoke Newington South,Hackney,London,1870,9093,276,240,187,248,10044,1984,11282,317,290,182,209,12280
E02000359,Homerton North,Hackney,London,1312,4776,166,150,121,155,5368,1352,5892,197,160,118,162,6529
E02000360,Amhurst Road & Pembury Estate,Hackney,London,2650,8476,355,204,169,291,9495,2495,10391,400,285,171,226,11473
E02000361,Hackney Central,Hackney,London,1437,7089,231,121,106,152,7699,1300,8126,235,147,100,163,8771
E02000362,Hackney Wick,Hackney,London,1457,5451,187,140,106,151,6035,1308,6358,199,149,104,149,6959
E02000363,Homerton South,Hackney,London,2976,7918,348,217,150,269,8902,2854,10301,388,272,174,245,11380
E02000364,Dalston East,Hackney,London,1677,7725,354,261,225,220,8785,1570,8660,376,264,189,256,9745
E02000365,Dalston Kingsland & De Beauvoir,Hackney,London,1968,12344,361,326,195,294,13520,2072,14506,384,328,236,299,15753
E02000366,South Hackney,Hackney,London,1884,6464,289,206,154,277,7390,1725,7568,346,247,163,236,8560
E02000367,London Fields & Mare Street,Hackney,London,2021,9106,220,175,103,87,9691,1826,11108,262,198,135,132,11835
E02000368,Haggerston East,Hackney,London,2020,7723,267,228,185,218,8621,1908,9107,337,266,158,221,10089
E02000369,Haggerston West & Kingsland Basin,Hackney,London,2646,11069,308,289,149,221,12036,2465,13272,373,260,184,249,14338
E02000370,Hoxton & Wenlock,Hackney,London,1797,7665,209,159,77,153,8263,1611,8754,233,194,97,139,9417
E02000371,Shoreditch,Hackney,London,1730,14066,208,175,99,191,14739,1586,16327,257,183,122,162,17051
E02006918,Clapton Leaside,Hackney,London,2488,6387,176,145,109,145,6962,2086,6751,222,154,92,128,7347
E02006921,Upper Clapton,Hackney,London,2953,5026,247,164,93,183,5713,2970,6234,266,190,130,152,6972
E02000372,Old Oak & Wormwood,Hammersmith and Fulham,London,1789,7068,295,242,137,258,8000,1858,10731,353,283,161,255,11783
E02000373,White City,Hammersmith and Fulham,London,1726,4289,189,161,98,165,4902,1766,6882,257,176,139,189,7643
E02000374,Wormholt Road,Hammersmith and Fulham,London,1367,4625,232,183,149,211,5400,1325,6904,238,238,125,219,7724
E02000375,Shepherd's Bush North,Hammersmith and Fulham,London,1435,4979,257,173,112,190,5711,1375,7726,276,208,119,208,8537
E02000376,Shepherd's Bush West,Hammersmith and Fulham,London,1081,5159,202,137,128,166,5792,1084,7621,233,178,116,174,8322
E02000377,Askew,Hammersmith and Fulham,London,1484,5808,298,215,161,220,6702,1436,8109,285,234,150,215,8993
E02000378,Shepherd's Bush South,Hammersmith and Fulham,London,1062,4718,217,159,147,161,5402,1015,7220,256,217,147,167,8007
E02000379,Ravenscourt Park North,Hammersmith and Fulham,London,1671,5108,312,276,173,368,6237,1584,6319,293,275,212,294,7393
E02000380,Brackenbury,Hammersmith and Fulham,London,1214,3863,197,174,129,160,4523,1100,5060,203,207,134,193,5797
E02000381,Brook Green,Hammersmith and Fulham,London,1603,5503,259,227,186,148,6323,1575,8327,308,270,182,236,9323
E02000382,Ravenscourt Park South,Hammersmith and Fulham,London,1077,4203,185,185,110,133,4816,981,5893,225,225,159,190,6692
E02000383,West Kensington,Hammersmith and Fulham,London,1039,6620,306,355,212,337,7830,1175,9626,385,372,258,378,11019
E02000384,Hammersmith Broadway,Hammersmith and Fulham,London,1247,5244,242,248,149,323,6206,1238,8024,279,242,172,273,8990
E02000385,Barons Court,Hammersmith and Fulham,London,602,4793,169,128,97,81,5268,608,6733,168,141,98,113,7253
E02000386,North End,Hammersmith and Fulham,London,1412,5817,256,216,151,187,6627,1367,8781,317,264,159,216,9737
E02000387,Lillie Road & Greyhound Road,Hammersmith and Fulham,London,876,4503,150,181,122,148,5104,864,6545,225,161,142,159,7232
E02000388,Fulham Broadway,Hammersmith and Fulham,London,1392,6274,279,273,169,305,7300,1313,8936,307,245,217,278,9983
E02000389,Fulham Reach,Hammersmith and Fulham,London,1525,5884,299,263,233,305,6984,1465,8346,330,303,247,302,9528
E02000390,Fulham Aintree,Hammersmith and Fulham,London,1168,4559,158,176,115,140,5148,1144,6824,209,180,140,156,7509
E02000391,Parsons Green East & Eel Brook Common,Hammersmith and Fulham,London,1552,5585,280,265,156,234,6520,1477,7088,322,236,165,240,8051
E02000392,Parsons Green West,Hammersmith and Fulham,London,1839,6766,256,232,173,217,7644,1776,9611,283,230,179,223,10526
E02000393,Munster,Hammersmith and Fulham,London,1131,4185,178,140,119,175,4797,1229,6091,172,177,134,162,6736
E02000394,Sands End & Chelsea Harbour,Hammersmith and Fulham,London,1804,6553,299,253,173,202,7480,1814,8656,295,241,171,211,9574
E02000395,Fulham Palace & Hurlingham Park,Hammersmith and Fulham,London,1112,4160,258,249,188,284,5139,974,5254,237,285,184,283,6243
E02000396,South Park,Hammersmith and Fulham,London,1667,4633,226,254,144,156,5413,1574,6294,256,227,166,168,7111
E02000397,Bowes Park,Haringey,London,1668,6107,249,191,141,205,6893,1610,7113,274,233,155,221,7996
E02000398,Northumberland Park,Haringey,London,2027,5170,230,154,104,180,5838,1935,6530,265,187,126,183,7291
E02000400,Bounds Green,Haringey,London,1710,5447,295,256,156,234,6388,1702,6765,326,262,196,248,7797
E02000401,Roundway,Haringey,London,1503,4440,231,161,111,158,5101,1441,5797,256,184,141,172,6550
E02000402,Tottenham Bruce Castle Park,Haringey,London,1470,4507,188,165,111,171,5142,1504,5765,286,173,113,175,6512
E02000403,Wood Green North,Haringey,London,1454,6048,244,132,133,206,6763,1470,7152,253,196,133,207,7941
E02000404,Scotch Estate,Haringey,London,1499,5424,244,219,147,205,6239,1418,6776,266,224,152,212,7630
E02000405,Alexandra Park,Haringey,London,1513,4026,307,233,119,200,4885,1479,4834,301,253,179,204,5771
E02000406,Noel Park,Haringey,London,1324,5186,216,169,129,152,5852,1198,6404,238,195,126,175,7138
E02000407,Bruce Grove North,Haringey,London,1629,5271,208,142,154,205,5980,1719,6874,241,175,129,221,7640
E02000408,Tottenham North West,Haringey,London,1870,5807,247,191,134,197,6576,1771,6738,268,232,136,212,7586
E02000409,Lordship Lane & Broadwater Farm,Haringey,London,1300,4099,294,152,129,182,4856,1210,5471,308,192,131,176,6278
E02000410,Muswell Hill North,Haringey,London,1382,4370,274,230,153,205,5232,1369,5359,313,274,170,195,6311
E02000411,Tottenham Lea Valley,Haringey,London,2041,7994,230,222,142,160,8748,2114,9425,284,219,154,170,10252
E02000412,Wood Green South,Haringey,London,1295,5738,228,154,145,211,6476,1246,7324,227,171,130,204,8056
E02000413,Fortis Green & Coldfall,Haringey,London,1793,4763,294,232,197,296,5782,1914,6075,346,271,217,325,7234
E02000414,Bruce Grove South,Haringey,London,1430,4981,213,168,111,185,5658,1488,6910,267,187,118,216,7698
E02000415,Downhills Park,Haringey,London,1237,5234,258,217,109,231,6049,1250,6915,269,225,119,240,7768
E02000416,Hornsey East,Haringey,London,1539,5735,287,237,178,158,6595,1581,7405,301,251,155,192,8304
E02000417,Muswell Hill South,Haringey,London,1188,4253,333,261,194,340,5381,1128,5164,324,299,216,279,6282
E02000418,Hornsey West,Haringey,London,1052,3347,314,259,184,185,4289,1065,4238,334,295,193,223,5283
E02000419,Harringay Ladder North,Haringey,London,1509,6715,220,187,141,202,7465,1567,8762,289,205,148,238,9642
E02000420,Tottenham Green West,Haringey,London,1534,5853,303,257,137,167,6717,1484,7765,346,237,163,192,8703
E02000421,Tottenham Green East,Haringey,London,1624,5907,225,164,114,224,6634,1527,7470,265,171,125,241,8272
E02000422,West Green & St Ann's,Haringey,London,1635,5911,239,201,158,236,6745,1626,7358,278,201,149,218,8204
E02000423,Harringay East,Haringey,London,1094,5767,173,148,97,178,6363,1073,7558,243,158,102,183,8244
E02000424,Hornsey Vale,Haringey,London,1234,4850,248,187,105,138,5528,1261,5966,301,213,132,142,6754
E02000425,South Tottenham,Haringey,London,3095,4235,215,122,69,155,4796,3361,6162,207,171,102,153,6795
E02000426,Highgate Wood,Haringey,London,1112,3828,277,340,222,330,4997,1187,5183,315,302,228,387,6415
E02000427,Harringay Ladder South,Haringey,London,991,5374,166,157,69,146,5912,1038,7193,206,173,92,174,7838
E02000428,Harringay Warehouse District & Vartry,Haringey,London,1585,6002,169,168,125,198,6662,1709,7594,231,158,138,177,8298
E02000429,Crouch End West,Haringey,London,1352,4564,287,302,164,224,5541,1363,5555,329,304,202,255,6645
E02000430,Crouch End East,Haringey,London,1120,5224,266,205,123,134,5952,1161,6404,294,243,156,152,7249
E02000431,Highgate East,Haringey,London,1069,4255,223,216,136,204,5034,907,5230,248,222,149,209,6058
E02000432,Stroud Green,Haringey,London,910,4627,213,172,83,119,5214,865,6016,231,205,131,116,6699
E02006794,White Hart Lane,Haringey,London,2231,5576,215,183,134,237,6345,2303,7269,274,196,132,215,8086
E02000433,Stanmore Park,Harrow,London,1486,4476,413,509,378,968,6744,1625,5850,450,501,467,888,8156
E02000434,Canons Park,Harrow,London,1931,5922,487,403,306,560,7678,2108,7697,540,480,320,620,9657
E02000435,Stanmore Uxbridge Road,Harrow,London,1587,4600,405,391,295,495,6186,1537,5219,386,437,293,499,6834
E02000436,Hatch End North,Harrow,London,901,3114,398,433,259,438,4642,946,3668,401,418,296,435,5218
E02000437,Harrow Weald,Harrow,London,1773,5163,425,393,309,511,6801,1803,6228,450,438,332,525,7973
E02000438,Hatch End South,Harrow,London,1560,4732,433,328,271,559,6323,1680,5670,411,360,281,517,7239
E02000439,Edgware West,Harrow,London,2080,5758,352,285,223,346,6964,2356,7930,421,304,215,348,9218
E02000440,Belmont,Harrow,London,2064,5993,479,390,279,432,7573,2271,7279,577,403,309,447,9015
E02000441,Pinner Green,Harrow,London,1450,4195,387,384,246,426,5638,1577,5129,389,379,299,427,6623
E02000442,Queensbury East,Harrow,London,2041,6019,368,236,168,254,7045,2217,8266,406,295,196,293,9456
E02000443,Wealdstone North,Harrow,London,2532,6536,395,246,234,384,7795,2750,8625,419,315,263,435,10057
E02000444,Queensbury West,Harrow,London,1974,5435,448,328,211,385,6807,2070,6934,464,347,236,352,8333
E02000445,Wealdstone South,Harrow,London,2643,7285,366,319,248,437,8655,2774,8988,427,360,270,477,10522
E02000447,Headstone Lane,Harrow,London,1572,4482,351,368,222,287,5710,1750,5643,377,368,266,302,6956
E02000448,Pinner Central,Harrow,London,1409,4026,397,379,264,467,5533,1424,4511,380,409,302,521,6123
E02000449,Kenton East,Harrow,London,1665,5515,352,268,216,351,6702,1896,7097,428,316,229,347,8417
E02000451,North Harrow,Harrow,London,1237,4035,356,342,217,357,5307,1274,4801,405,350,260,347,6163
E02000452,Greenhill North,Harrow,London,1998,5837,271,204,172,223,6707,2267,8397,315,247,171,244,9374
E02000453,Pinner Road,Harrow,London,1821,5341,359,258,194,283,6435,1907,6811,382,291,190,297,7971
E02000454,Pinner South,Harrow,London,1580,4068,358,360,260,387,5433,1659,4795,397,345,294,399,6230
E02000455,Greenhill South,Harrow,London,2146,6906,278,287,244,360,8075,2444,9254,372,311,263,404,10604
E02000456,West Harrow,Harrow,London,1528,4706,315,243,177,313,5754,1533,5926,340,277,195,315,7053
E02000457,Rayners Lane North,Harrow,London,1283,4120,315,312,236,337,5320,1396,5459,393,301,266,376,6795
E02000459,South Harrow,Harrow,London,2126,6016,337,297,209,282,7141,2250,7226,372,317,200,286,8401
E02000460,Newton Farm,Harrow,London,1699,4420,237,197,108,197,5159,1909,5976,287,225,124,197,6809
E02000461,Harrow-on-the-Hill,Harrow,London,1573,5150,264,207,141,295,6057,1687,5766,266,238,159,277,6706
E02000462,Alexandra Park,Harrow,London,1445,4406,264,230,202,260,5362,1539,5969,325,245,197,300,7036
E02000463,Earlsmead,Harrow,London,1929,5308,348,274,189,248,6367,1992,6811,410,330,211,273,8035
E02006795,Rayners Lane South,Harrow,London,1678,5180,355,280,198,325,6338,1923,6680,416,311,228,332,7967
E02006882,Kenton West,Harrow,London,2699,9018,739,641,455,646,11499,3016,11878,854,716,482,738,14668
E02000464,Dagnam Park & Noak Hill,Havering,London,1790,4719,327,303,222,394,5965,1831,5233,330,326,236,375,6500
E02000465,Petersfield Avenue & Duck Wood,Havering,London,2408,6009,340,279,164,263,7055,2326,6544,344,325,176,233,7622
E02000466,Havering-atte-Bower & Chase Cross,Havering,London,2049,5451,370,414,282,431,6948,2027,6000,417,438,307,421,7583
E02000467,Harold Hill East,Havering,London,3078,7118,363,329,171,301,8282,3170,7862,393,364,184,284,9087
E02000468,Collier Row & Park Farm,Havering,London,1774,5082,389,405,259,481,6616,1767,5513,396,429,271,451,7060
E02000469,Harold Hill West,Havering,London,1792,4462,307,279,202,317,5567,1657,4821,297,309,236,294,5957
E02000470,Harold Park & Harold Wood,Havering,London,1640,5912,445,459,360,557,7733,1763,6368,475,501,376,558,8278
E02000471,Rise Park,Havering,London,1277,4342,508,531,364,576,6321,1329,4778,481,502,397,566,6724
E02000472,Romford North,Havering,London,1928,5614,457,534,321,483,7409,1911,5872,481,497,346,440,7636
E02000473,Ardleigh Green,Havering,London,2069,6428,440,479,327,545,8219,2048,6783,507,479,352,544,8665
E02000474,Romford North West,Havering,London,2035,5743,349,376,252,507,7227,1949,5892,383,386,251,475,7387
E02000475,Gidea Park,Havering,London,1728,6065,519,515,368,695,8162,1721,5929,506,516,410,661,8022
E02000476,Central Romford,Havering,London,2051,6938,328,313,237,427,8243,2055,6788,336,324,230,405,8083
E02000477,Romford East,Havering,London,1772,5924,493,498,366,513,7794,1726,6347,510,558,375,548,8338
E02000478,Emerson Park,Havering,London,845,3358,371,446,298,492,4965,917,3715,401,461,362,485,5424
E02000479,Romford South,Havering,London,2012,6480,328,288,184,328,7608,2036,6670,342,328,216,321,7877
E02000480,Rush Green,Havering,London,3083,8532,426,352,252,516,10078,3176,9141,474,392,276,465,10748
E02000481,Cranham East,Havering,London,1471,4709,410,418,368,744,6649,1587,5326,394,470,375,678,7243
E02000482,Upminster North & Cranham West,Havering,London,1140,3708,398,369,284,615,5374,1194,4117,403,403,278,592,5793
E02000483,Hornchurch,Havering,London,1325,4899,450,399,306,614,6668,1404,5155,437,444,326,575,6937
E02000484,Hylands,Havering,London,1388,5384,403,421,292,428,6928,1464,5813,439,471,299,409,7431
E02000485,Upminster Bridge,Havering,London,1672,5414,364,384,292,516,6970,1604,5519,415,399,321,496,7150
E02000486,Elm Park East,Havering,London,1168,4678,401,411,297,546,6333,1193,4851,428,411,318,487,6495
E02000487,Upminster South & Corbets Tey,Havering,London,1277,4451,520,571,346,594,6482,1380,5073,501,606,412,626,7218
E02000488,Hacton,Havering,London,1229,4406,461,492,306,431,6096,1179,4681,479,524,353,476,6513
E02000489,Elm Park West,Havering,London,1872,5385,366,361,288,439,6839,1830,5888,388,378,304,437,7395
E02000490,South Hornchurch,Havering,London,1646,4765,336,404,289,545,6339,1667,5381,357,430,298,500,6966
E02000491,Hornchurch Marshes,Havering,London,2298,6098,368,367,308,415,7556,2248,6635,378,385,292,401,8091
E02000492,Rainham East & Wennington,Havering,London,1173,3848,338,380,291,463,5320,1204,4326,386,381,315,480,5888
E02000493,Rainham West,Havering,London,1673,4258,251,183,157,294,5143,1593,4649,263,214,164,270,5560
E02000494,Ducks Hill,Hillingdon,London,1393,4418,476,461,340,592,6287,1438,5353,562,511,376,693,7495
E02000495,Northwood,Hillingdon,London,2088,6367,452,513,361,645,8338,2299,7554,505,519,388,696,9662
E02000496,Harefield,Hillingdon,London,1489,4684,380,425,255,463,6207,1504,5483,416,402,291,404,6996
E02000497,Northwood Hills,Hillingdon,London,1864,5704,384,391,312,570,7361,1970,6457,436,420,340,613,8266
E02000498,West Ruislip North,Hillingdon,London,1167,3647,390,375,244,328,4984,1242,4172,387,394,257,386,5596
E02000499,Eastcote,Hillingdon,London,1397,4545,377,413,304,568,6207,1449,5388,447,419,337,611,7202
E02000500,Ruislip,Hillingdon,London,1414,5042,438,435,329,579,6823,1410,5761,461,477,349,609,7657
E02000501,Ruislip Manor,Hillingdon,London,1708,5089,426,416,269,462,6662,1705,5862,417,369,304,453,7405
E02000502,West Ruislip South,Hillingdon,London,2008,5374,330,302,258,504,6768,2009,5968,368,332,244,509,7421
E02000503,Ruislip Gardens,Hillingdon,London,1847,5953,387,302,224,346,7212,1754,5940,407,334,213,355,7249
E02000504,Ickenham,Hillingdon,London,1514,4376,350,405,313,491,5935,1464,4900,379,413,331,498,6521
E02000506,Uxbridge Common & Swakeleys,Hillingdon,London,1340,4763,470,440,303,506,6482,1391,5430,518,444,353,524,7269
E02000507,Hillingdon North East,Hillingdon,London,1966,5152,340,282,191,327,6292,1984,5946,367,301,188,315,7117
E02000508,Uxbridge Central & Brunel,Hillingdon,London,2044,9073,292,259,180,299,10103,2239,10344,354,253,193,323,11467
E02000509,Uxbridge West,Hillingdon,London,1729,9575,295,204,164,219,10457,1841,9796,318,258,166,223,10761
E02000510,Hillingdon South,Hillingdon,London,1856,5934,341,392,248,452,7367,1888,6765,415,391,264,434,8269
E02000511,Charville,Hillingdon,London,2194,6460,320,325,255,441,7801,2267,7509,359,336,275,453,8932
E02000512,Hillingdon Heath,Hillingdon,London,2031,5640,288,278,231,290,6727,2028,6587,317,274,209,265,7652
E02000513,Yeading North,Hillingdon,London,2928,6326,242,242,129,230,7169,2672,7437,271,241,148,232,8329
E02000514,Yeading West,Hillingdon,London,2644,6996,355,267,213,342,8173,2718,8987,435,331,222,363,10338
E02000515,Yiewsley West,Hillingdon,London,2716,8274,379,307,229,304,9493,2928,9558,395,358,230,322,10863
E02000516,Yeading Brookside,Hillingdon,London,2242,5939,301,216,152,189,6797,2191,7339,346,266,158,211,8320
E02000517,Hayes End,Hillingdon,London,2766,6391,358,259,168,220,7396,2826,8155,402,315,216,327,9415
E02000518,Yiewsley East,Hillingdon,London,1938,5763,303,333,175,269,6843,2040,6829,364,336,215,304,8048
E02000519,Hayes Town North,Hillingdon,London,2174,5978,306,260,251,336,7131,2273,7656,370,336,222,370,8954
E02000520,Hayes Town & Lake Farm,Hillingdon,London,3562,9207,409,336,232,368,10552,3720,12296,465,376,242,388,13767
E02000521,West Drayton East,Hillingdon,London,3626,8815,322,276,164,283,9860,3668,11025,404,290,189,301,12209
E02000522,West Drayton West,Hillingdon,London,2426,6203,328,258,198,343,7330,2433,7366,393,308,223,388,8678
E02000523,Hayes South,Hillingdon,London,2814,7981,357,268,229,250,9085,2797,10650,470,305,215,302,11942
E02000524,"Heathrow, Hardmonsworth & Sipson",Hillingdon,London,1660,5727,260,214,177,283,6661,1613,6682,296,228,149,198,7553
E02000525,Harlington & Cranford Cross,Hillingdon,London,2632,6935,308,253,173,240,7909,2612,8722,369,278,162,257,9788
E02006796,South Ruislip,Hillingdon,London,2049,5918,320,342,251,401,7232,2059,7125,371,338,278,406,8518
E02000526,Chiswick North East,Hounslow,London,1567,5693,382,330,200,312,6917,1637,7300,404,366,260,324,8654
E02000528,Brentford East,Hounslow,London,2655,8343,521,371,259,311,9805,2977,10563,527,420,300,320,12130
E02000529,Heston North,Hounslow,London,2195,5661,378,261,213,280,6793,2498,8414,442,317,207,288,9668
E02000530,North Hyde & North Cranford,Hounslow,London,2071,4535,254,190,123,208,5310,2250,6547,296,209,134,190,7376
E02000531,Brentford Central,Hounslow,London,1968,7335,408,312,244,364,8663,2314,9224,462,386,267,373,10712
E02000532,Chiswick South East,Hounslow,London,1745,5787,432,433,234,333,7219,1861,7259,478,432,324,333,8826
E02000533,Chiswick South West,Hounslow,London,1617,5534,391,372,205,277,6779,1835,6882,436,391,255,288,8252
E02000534,Brentford West & Osterley Park,Hounslow,London,1578,5314,291,284,211,272,6372,1745,6515,356,324,244,359,7798
E02000535,Heston West,Hounslow,London,1805,6105,434,308,266,331,7444,2227,8831,540,374,291,377,10413
E02000536,Heston Central & Lampton West,Hounslow,London,1941,6192,381,314,209,326,7422,2333,9176,487,396,252,394,10705
E02000537,Osterley & Lampton East,Hounslow,London,1718,6144,378,314,261,331,7428,2115,9222,450,363,292,418,10745
E02000538,Cranford,Hounslow,London,2139,6579,370,290,207,250,7696,2435,9630,485,329,199,285,10928
E02000539,Syon Green,Hounslow,London,2533,7307,350,282,201,325,8465,2811,9332,396,351,251,308,10638
E02000540,Spring Grove,Hounslow,London,2503,7436,381,326,231,369,8743,2944,10720,411,368,244,356,12099
E02000541,Hounslow Meadows,Hounslow,London,2127,6456,362,264,224,302,7608,2542,10093,405,344,245,395,11482
E02000542,Hounslow West,Hounslow,London,2792,7707,399,345,222,387,9060,3267,11958,467,369,246,386,13426
E02000543,Hounslow High Street,Hounslow,London,3307,9331,364,306,203,294,10498,3822,13899,465,344,228,297,15233
E02000544,Hounslow East,Hounslow,London,1516,5350,379,336,213,351,6629,1679,6950,436,380,234,333,8333
E02000545,Isleworth & Ivybridge,Hounslow,London,2071,5533,359,301,197,285,6675,2198,6920,399,342,196,276,8133
E02000546,Hounslow Heath,Hounslow,London,2249,6375,438,257,157,249,7476,2537,9252,435,325,221,310,10543
E02000547,North Feltham & Hatton,Hounslow,London,2170,6439,391,358,245,352,7785,2369,8253,432,368,272,384,9709
E02000548,Bedfont,Hounslow,London,2443,6307,335,278,185,357,7462,2551,7773,380,343,182,294,8972
E02000549,Feltham East,Hounslow,London,2500,7392,466,381,310,437,8986,2676,9954,512,450,300,482,11698
E02000550,Feltham Central,Hounslow,London,2843,7093,297,261,178,211,8040,2995,9165,344,274,171,234,10188
E02000551,Hanworth North,Hounslow,London,2296,5800,330,254,192,231,6807,2377,7047,359,295,205,224,8130
E02000552,Lower Feltham,Hounslow,London,2109,6104,279,216,135,199,6933,2122,7013,310,257,168,212,7960
E02000553,Hanworth South,Hounslow,London,1671,4445,302,272,163,256,5438,1728,5035,323,308,184,248,6098
E02006792,Chiswick Park,Hounslow,London,1404,6262,316,322,241,396,7537,1590,8211,351,314,271,401,9548
E02000554,Highcroft & Holly Park,Islington,London,2021,7037,339,257,168,213,8014,1862,8452,328,288,167,217,9452
E02000555,Archway East,Islington,London,1792,7052,309,265,213,270,8109,1749,8383,379,302,234,289,9587
E02000556,Tollington,Islington,London,1719,8692,289,265,198,210,9654,1667,10665,332,307,187,229,11720
E02000557,Archway West,Islington,London,1426,6390,301,242,214,287,7434,1304,7762,322,236,233,277,8830
E02000558,Finsbury Park West,Islington,London,2248,7173,276,252,172,258,8131,1977,8744,291,272,169,270,9746
E02000559,Gillespie Road,Islington,London,1894,7859,288,250,147,178,8722,1718,8088,292,218,154,201,8953
E02000560,Holloway Nag's Head,Islington,London,1199,7310,200,180,143,193,8026,1047,7959,211,170,135,175,8650
E02000561,Tufnell Park East,Islington,London,1465,6234,303,285,176,180,7178,1219,7202,317,266,199,187,8171
E02000562,Highbury,Islington,London,1604,6348,290,262,145,272,7317,1447,7402,288,259,171,224,8344
E02000563,Hilldrop,Islington,London,1501,6378,242,192,147,215,7174,1568,7990,316,256,162,215,8939
E02000564,Lower Holloway,Islington,London,1923,11781,259,201,163,190,12594,1798,13128,320,242,163,210,14063
E02000565,Newington Green,Islington,London,1698,6671,206,180,104,204,7365,1456,7803,236,200,127,193,8559
E02000566,Highbury Fields,Islington,London,1533,7084,290,283,172,189,8018,1361,8160,344,281,195,211,9191
E02000567,Canonbury East & Mildmay Park,Islington,London,1891,8701,321,263,177,263,9725,1673,10136,373,295,188,258,11250
E02000568,Caledonian Road,Islington,London,1845,10211,302,261,167,295,11236,1786,11643,334,281,173,284,12715
E02000569,Islington North & Canonbury West,Islington,London,1937,8120,331,314,233,380,9378,1920,9728,379,311,207,320,10945
E02000570,Barnsbury East,Islington,London,1445,7529,338,274,168,228,8537,1283,8360,328,313,172,233,9406
E02000571,Islington East & Arlington,Islington,London,1503,6906,271,270,149,239,7835,1499,8003,308,256,174,226,8967
E02000572,Barnsbury West,Islington,London,1685,6611,289,218,149,267,7534,1590,8973,326,239,162,245,9945
E02000573,Angel,Islington,London,1389,8245,265,303,209,237,9259,1385,10654,351,318,216,252,11791
E02000574,King's Cross & Pentonville,Islington,London,1139,7865,223,199,153,197,8637,997,9892,258,246,130,217,10743
E02000575,Clerkenwell,Islington,London,1536,13160,278,223,133,244,14038,1494,14202,317,262,171,254,15206
E02000576,Old Street & St Luke's,Islington,London,2059,9174,267,212,165,282,10100,1856,10523,281,229,152,274,11459
E02000577,Golborne & Swinbrook,Kensington and Chelsea,London,1228,4457,245,232,187,287,5408,1366,7260,352,285,191,295,8383
E02000578,Ladbroke Grove,Kensington and Chelsea,London,1178,3588,248,206,179,329,4550,1101,4837,235,226,150,222,5670
E02000579,North Kensington,Kensington and Chelsea,London,1593,5296,372,336,216,242,6462,1568,7160,441,348,261,292,8502
E02000580,Portobello,Kensington and Chelsea,London,1212,5474,350,319,222,235,6600,1283,7925,446,341,244,257,9213
E02000581,Notting Dale,Kensington and Chelsea,London,1208,3860,304,337,253,317,5071,1276,5824,337,318,247,327,7053
E02000582,Notting Hill Gate,Kensington and Chelsea,London,1158,4934,296,294,261,342,6127,1099,7227,328,276,208,331,8370
E02000583,Notting Hill West,Kensington and Chelsea,London,1210,4601,315,329,229,248,5722,1092,5928,318,292,213,276,7027
E02000584,Notting Hill South,Kensington and Chelsea,London,1690,5104,387,347,286,364,6488,1489,6229,344,359,239,324,7495
E02000585,Holland Park,Kensington and Chelsea,London,1450,5196,355,355,287,357,6550,1488,7721,395,338,302,336,9092
E02000586,Queen's Gate,Kensington and Chelsea,London,1276,5491,313,284,165,218,6471,1181,6767,313,291,184,224,7779
E02000587,Kensington Abingdon,Kensington and Chelsea,London,1439,4880,340,362,225,336,6143,1247,6581,394,341,235,310,7861
E02000588,Hans Town,Kensington and Chelsea,London,1081,5339,380,361,292,345,6717,1047,5969,391,317,222,281,7180
E02000589,Kensington Gardens,Kensington and Chelsea,London,1221,6698,267,262,174,264,7665,1182,9013,316,248,183,229,9989
E02000590,Brompton,Kensington and Chelsea,London,920,4588,391,340,223,455,5997,833,5433,321,308,226,351,6639
E02000591,Earl's Court,Kensington and Chelsea,London,976,4992,298,291,154,175,5910,1158,7554,297,324,213,217,8605
E02000592,South Kensington,Kensington and Chelsea,London,1213,4815,243,311,180,234,5783,1089,6277,245,231,181,254,7188
E02000593,West Brompton,Kensington and Chelsea,London,1317,5811,342,315,209,216,6893,1151,8017,314,311,207,218,9067
E02000594,Chelsea Manor & Royal Hospital,Kensington and Chelsea,London,1111,4787,480,453,358,561,6639,875,5071,390,370,327,500,6658
E02000595,Chelsea Riverside East,Kensington and Chelsea,London,1238,4966,396,381,264,371,6378,963,5423,311,351,271,327,6683
E02000596,Fulham Road,Kensington and Chelsea,London,1297,5309,349,279,205,278,6420,929,6198,271,263,176,253,7161
E02000597,Chelsea Riverside West,Kensington and Chelsea,London,1260,4618,364,340,217,320,5859,1180,6040,382,343,223,303,7291
E02000598,Tudor Drive,Kingston upon Thames,London,2006,5000,367,329,224,352,6272,2055,5859,404,385,257,338,7243
E02000599,Kingston Vale & Coombe Hill,Kingston upon Thames,London,1511,5453,363,358,262,565,7001,1346,6139,430,407,319,552,7847
E02000600,Kingston Hill,Kingston upon Thames,London,2150,6384,325,299,237,321,7566,2148,7293,324,338,238,308,8501
E02000601,Kingston North,Kingston upon Thames,London,3223,9021,402,330,221,276,10250,3241,10429,453,364,258,303,11807
E02000602,Kingston East & Norbiton West,Kingston upon Thames,London,2179,8639,361,249,176,284,9709,2240,9059,370,302,184,264,10179
E02000603,Norbiton East,Kingston upon Thames,London,2077,5869,316,270,189,269,6913,1948,7081,350,308,197,250,8186
E02000604,New Malden East,Kingston upon Thames,London,2030,6059,380,320,207,350,7316,2069,7653,436,379,248,342,9058
E02000605,New Malden West,Kingston upon Thames,London,1718,5168,406,358,247,447,6626,1840,6427,427,370,286,432,7942
E02000606,Kingston Riverside,Kingston upon Thames,London,1752,8345,361,351,203,338,9598,1647,10378,376,360,237,331,11682
E02000607,Berrylands North,Kingston upon Thames,London,1364,5858,244,230,132,231,6695,1299,5637,261,247,167,242,6554
E02000608,Surbiton North,Kingston upon Thames,London,1181,5659,186,187,122,224,6378,1028,6949,212,226,142,187,7716
E02000609,Malden Manor,Kingston upon Thames,London,1494,4726,386,398,265,406,6181,1488,5886,398,427,276,422,7409
E02000610,Surbiton South,Kingston upon Thames,London,1270,5795,295,283,175,362,6910,1277,6183,298,309,206,354,7350
E02000611,Berrylands South,Kingston upon Thames,London,1624,4286,426,433,287,402,5834,1534,4966,430,429,322,424,6571
E02000612,Motspur Park,Kingston upon Thames,London,1526,4949,457,497,350,479,6732,1577,5881,470,519,355,502,7727
E02000613,Southborough,Kingston upon Thames,London,1916,5259,304,281,212,426,6482,1816,5517,291,308,215,354,6685
E02000614,Tolworth,Kingston upon Thames,London,2031,6143,357,289,225,284,7298,2046,7157,399,330,225,310,8421
E02000615,Hook,Kingston upon Thames,London,1630,4868,312,344,269,377,6170,1606,5706,322,359,266,362,7015
E02000616,Chessington North,Kingston upon Thames,London,1248,3766,296,287,154,250,4753,1226,4220,272,289,180,231,5192
E02000617,Chessington South & Malden Rushett,Kingston upon Thames,London,1993,5592,358,367,236,347,6900,1889,6311,425,365,283,371,7755
E02000619,Lambeth Walk & North Kennington,Lambeth,London,1571,6498,354,280,176,239,7547,1619,8580,393,296,181,261,9711
E02000620,Kennington West & Vauxhall North,Lambeth,London,1666,8076,245,180,187,268,8956,1528,9981,352,232,202,277,11044
E02000621,Vauxhall South,Lambeth,London,1431,10049,301,235,206,210,11001,1450,14371,372,280,182,249,15454
E02000622,Oval,Lambeth,London,1284,6917,219,168,112,178,7594,1251,8846,300,192,124,180,9642
E02000623,Stockwell North,Lambeth,London,1379,5847,292,187,170,224,6720,1381,8150,336,225,190,224,9125
E02000624,Stockwell East,Lambeth,London,1398,6886,190,135,111,220,7542,1536,9506,291,226,117,204,10344
E02000625,Stockwell West,Lambeth,London,1620,6294,143,160,101,164,6862,1714,9688,299,185,107,155,10434
E02000626,Loughborough Road,Lambeth,London,1834,5912,183,139,108,146,6488,1778,8039,288,173,131,182,8813
E02000627,Stockwell South,Lambeth,London,1418,7730,194,157,163,255,8499,1454,10478,265,226,148,239,11356
E02000628,Brixton North,Lambeth,London,1697,7134,242,206,174,235,7991,1833,10826,376,268,169,258,11897
E02000629,Clapham North,Lambeth,London,1176,7226,228,171,98,138,7861,1180,9559,264,188,125,151,10287
E02000630,Clapham Old Town,Lambeth,London,1120,6307,172,170,106,161,6916,1023,7633,264,199,119,172,8387
E02000631,Herne Hill East,Lambeth,London,1701,6887,267,209,170,218,7751,1642,8491,312,251,171,243,9468
E02000632,Acre Lane,Lambeth,London,884,7786,168,111,91,175,8331,907,10840,216,176,108,181,11521
E02000633,Brixton Central,Lambeth,London,1487,6901,277,139,128,155,7600,1390,8432,301,184,145,199,9261
E02000634,Clapham Common North,Lambeth,London,1007,5146,187,157,83,190,5763,1001,7042,237,170,112,181,7742
E02000635,Poets' Corner & Brockwell Park,Lambeth,London,1522,7119,220,169,116,145,7769,1533,8981,317,216,124,186,9824
E02000636,Clapham South,Lambeth,London,1407,6079,216,195,113,135,6738,1389,7244,198,218,141,166,7967
E02000637,Brixton Hill East,Lambeth,London,1226,7189,201,153,128,190,7861,1174,8485,249,190,120,191,9235
E02000638,Brixton Hill West,Lambeth,London,1724,8331,220,152,162,241,9106,1634,10293,282,189,163,242,11169
E02000639,Clapham Park East & Streatham Hill North,Lambeth,London,1443,6075,221,133,118,107,6654,1367,8683,302,188,106,174,9453
E02000640,Clapham Park West,Lambeth,London,1849,7199,212,213,156,247,8027,1800,8539,288,216,185,234,9462
E02000641,Tulse Hill,Lambeth,London,1998,5952,271,145,110,210,6688,1866,7963,318,204,115,218,8818
E02000642,West Dulwich,Lambeth,London,2141,6579,321,267,169,267,7603,1992,7957,354,312,204,265,9092
E02000643,Streatham Hill,Lambeth,London,1725,7120,244,202,117,226,7909,1708,8755,282,204,125,225,9591
E02000644,Leigham Vale & Royal Circus,Lambeth,London,1882,6355,271,175,100,193,7094,1730,7691,281,248,110,201,8531
E02000645,West Norwood East,Lambeth,London,2164,6870,256,208,111,233,7678,2074,8257,291,254,147,214,9163
E02000646,Streatham Central,Lambeth,London,1654,7719,314,260,158,263,8714,1651,9169,347,272,192,279,10259
E02000647,West Norwood West & Streatham East,Lambeth,London,1945,6162,346,279,186,365,7338,1796,7000,402,292,188,340,8222
E02000648,West Norwood South,Lambeth,London,2255,5299,212,209,137,236,6093,2008,6383,267,216,152,214,7232
E02000649,Streatham Green,Lambeth,London,2525,10112,311,226,164,248,11061,2379,11350,355,282,163,272,12422
E02000650,Gipsy Hill,Lambeth,London,1793,5325,245,172,95,168,6005,1850,6907,272,214,121,171,7685
E02000651,Streatham Common,Lambeth,London,1734,6433,276,244,172,297,7422,1728,7478,355,254,182,294,8563
E02000652,Streatham Vale,Lambeth,London,1690,5252,257,195,182,284,6170,1594,6551,312,240,185,306,7594
E02006801,"Lambeth North, Waterloo & South Bank",Lambeth,London,950,9468,299,249,131,235,10382,1028,13245,348,271,173,234,14271
E02000653,Silwood & Pepys,Lewisham,London,2066,9080,185,177,109,151,9702,2066,11391,273,175,124,145,12108
E02000654,Deptford North,Lewisham,London,1987,6190,218,132,114,169,6823,2001,8113,269,177,104,170,8833
E02000655,New Cross Gate,Lewisham,London,1770,6950,178,137,114,166,7545,1799,8877,256,174,128,165,9600
E02000657,New Cross South,Lewisham,London,1575,7728,221,186,127,152,8414,1679,9536,269,224,150,213,10392
E02000658,Telegraph Hill,Lewisham,London,1464,6560,271,192,125,180,7328,1408,7720,320,214,135,212,8601
E02000659,Blackheath West,Lewisham,London,1607,5921,223,205,133,208,6690,1557,6779,275,221,165,213,7653
E02000660,Brockley East & St Johns,Lewisham,London,1383,6647,201,136,99,171,7254,1519,7737,216,172,131,150,8406
E02000661,Blackheath Village,Lewisham,London,1171,4801,230,244,161,279,5715,1270,5496,247,240,183,301,6467
E02000662,Brockley West,Lewisham,London,1809,6301,214,146,102,140,6903,1820,7273,294,164,135,183,8049
E02000663,Loampit & Hilly Fields,Lewisham,London,1209,5496,246,197,134,155,6228,1270,5975,261,189,153,176,6754
E02000664,Lewisham Central & Park,Lewisham,London,2559,11114,301,226,180,301,12122,2753,13430,338,254,182,312,14516
E02000665,Manor House,Lewisham,London,1760,6116,243,233,156,246,6994,1818,6622,274,245,161,260,7562
E02000666,Ladywell,Lewisham,London,1414,5189,219,167,151,250,5976,1509,5803,244,186,156,241,6630
E02000667,Crofton Park,Lewisham,London,1540,4715,236,149,126,168,5394,1474,5082,228,206,137,206,5859
E02000668,Lee,Lewisham,London,1655,5018,278,228,157,242,5923,1659,5258,283,215,176,210,6142
E02000669,Hither Green,Lewisham,London,1580,6093,169,180,127,186,6755,1621,6627,197,189,130,186,7329
E02000670,Catford East & Mountsfield Park,Lewisham,London,1472,4608,156,121,99,190,5174,1401,5209,219,152,133,218,5931
E02000671,Honor Oak,Lewisham,London,1767,6193,256,196,155,199,6999,1853,7082,295,235,156,243,8011
E02000672,Catford Bridge,Lewisham,London,2349,7131,220,180,117,280,7928,2255,8281,281,214,149,276,9201
E02000673,Forest Hill West,Lewisham,London,2002,5941,287,227,146,189,6790,1731,6202,310,218,162,190,7082
E02000674,Corbett Estate,Lewisham,London,1801,5842,288,224,152,290,6796,1715,6471,311,241,205,318,7546
E02000675,Grove Park & Lee South,Lewisham,London,1783,5929,366,298,204,302,7099,1764,6219,407,354,212,321,7513
E02000676,Forest Hill East,Lewisham,London,1742,5743,219,201,140,218,6521,1707,6346,278,197,133,234,7188
E02000677,Culverley Green,Lewisham,London,1538,5095,273,225,138,301,6032,1377,5599,316,265,160,295,6635
E02000678,Further Green,Lewisham,London,1705,4507,176,138,143,210,5174,1573,4917,222,148,122,180,5589
E02000679,Perry Vale,Lewisham,London,1834,5682,285,214,167,218,6566,1898,6302,306,233,171,215,7227
E02000680,Upper Sydenham,Lewisham,London,1709,5214,218,167,124,197,5920,1618,5312,224,176,119,209,6040
E02000681,Bellingham & Perry Hill,Lewisham,London,2063,5618,322,268,185,291,6684,1927,6752,368,325,182,282,7909
E02000682,Forster Park & Southend,Lewisham,London,2220,5830,309,262,150,308,6859,2178,6795,315,278,171,279,7838
E02000683,Chinbrook,Lewisham,London,1481,4274,195,189,159,246,5063,1435,5092,271,202,165,257,5987
E02000685,Sydenham Wells,Lewisham,London,1890,5613,283,241,189,284,6610,1738,6075,292,259,184,290,7100
E02000686,Beckenham Hill,Lewisham,London,1985,4846,200,191,127,146,5510,1979,5709,222,178,126,143,6378
E02000687,Lower Sydenham,Lewisham,London,1658,5722,307,244,148,320,6741,1695,6214,310,262,196,300,7282
E02006783,Downham East,Lewisham,London,1940,4978,198,162,132,254,5724,1968,6107,246,176,134,212,6875
E02006784,Downham West,Lewisham,London,1772,5158,331,275,203,345,6312,1769,5775,370,282,204,335,6966
E02006798,New Cross & Deptford South,Lewisham,London,1472,6279,213,143,122,85,6842,1672,9233,296,176,144,181,10030
E02000689,Wimbledon Park & Durnsford Road,Merton,London,2063,5551,286,186,156,173,6352,2219,7519,340,256,183,201,8499
E02000690,Wimbledon Common,Merton,London,1025,3139,344,370,233,459,4545,1187,4442,416,372,308,478,6016
E02000691,Wimbledon Broadway North,Merton,London,1467,5179,241,214,119,227,5980,1513,6735,272,236,151,252,7646
E02000692,Wimbledon Hill,Merton,London,1373,5172,340,369,219,445,6545,1657,7306,387,406,262,496,8857
E02000693,Colliers Wood,Merton,London,1445,7237,250,205,150,244,8086,1741,9564,308,250,150,274,10546
E02000694,South Wimbledon,Merton,London,1871,6387,291,244,141,176,7239,2100,8027,295,279,157,222,8980
E02000695,Graveney,Merton,London,1594,5781,300,255,227,325,6888,1714,7788,368,273,262,345,9036
E02000696,Lavender Park,Merton,London,1496,5864,235,148,122,158,6527,1703,7809,278,238,121,153,8599
E02000697,Wimbledon Broadway South,Merton,London,1659,6626,227,215,118,178,7364,1790,8167,251,238,120,203,8979
E02000698,Cottenham Park,Merton,London,1821,4804,338,391,267,395,6195,2157,6649,438,423,315,435,8260
E02000699,Wimbledon Chase,Merton,London,1928,5388,274,257,159,278,6356,2032,6832,313,266,185,307,7903
E02000700,Merton Church Road & Phipps Bridge,Merton,London,1821,5774,287,228,138,148,6575,1889,7349,321,244,161,181,8256
E02000701,Mitcham East,Merton,London,1849,5614,274,250,173,271,6582,2049,7725,382,295,219,320,8941
E02000702,Lonesome,Merton,London,2220,5627,314,180,172,223,6516,2286,7087,346,251,157,254,8095
E02000703,Merton Park,Merton,London,1647,4856,404,346,278,416,6300,1661,6080,418,419,290,432,7639
E02000704,Raynes Park,Merton,London,1577,5695,290,235,188,341,6749,1787,7422,315,286,218,331,8572
E02000705,Rowan Road,Merton,London,1808,5560,361,256,224,316,6717,1977,7419,453,320,251,394,8837
E02000706,Mitcham West,Merton,London,2475,6026,306,193,162,211,6898,2539,8018,347,245,172,244,9026
E02000707,Pollards Hill,Merton,London,1736,4889,286,206,145,194,5720,1898,6710,309,249,164,268,7700
E02000708,West Barnes,Merton,London,1797,5290,370,337,220,333,6550,1965,7295,414,379,231,372,8691
E02000709,Cannon Hill,Merton,London,1534,4685,384,377,263,403,6112,1678,5688,411,389,281,448,7217
E02000710,Mitcham South,Merton,London,1830,5362,326,314,253,490,6745,1981,6713,383,366,262,436,8160
E02000711,Morden Central,Merton,London,1943,5985,256,254,146,273,6914,2101,7894,305,260,177,299,8935
E02000712,St Helier North,Merton,London,1965,5618,316,298,194,379,6805,2097,7201,372,338,210,398,8519
E02000713,Lower Morden,Merton,London,1514,4514,372,356,223,365,5830,1575,5510,383,394,237,401,6925
E02000714,Forest Gate North,Newham,London,1763,5700,202,134,112,169,6317,1907,7426,272,157,126,156,8137
E02000715,Little Ilford West,Newham,London,2088,4883,214,135,138,211,5581,2208,6110,211,151,109,165,6746
E02000716,Manor Park North,Newham,London,1831,5180,250,159,109,200,5898,2114,6615,283,169,97,175,7339
E02000717,Manor Park South,Newham,London,2170,5595,231,145,122,159,6252,2418,7473,253,185,113,161,8185
E02000718,Little Ilford East,Newham,London,2235,4652,181,130,113,128,5204,2260,6036,201,135,101,141,6614
E02000719,Forest Gate West,Newham,London,1663,6192,212,226,150,186,6966,1753,7924,260,171,117,154,8626
E02000720,Forest Gate East,Newham,London,1818,5155,279,210,131,183,5958,2023,7345,295,210,134,189,8173
E02000721,Forest Gate South,Newham,London,2445,6477,232,197,123,217,7246,2803,9874,314,217,112,205,10722
E02000722,Stratford East,Newham,London,1534,6295,218,166,83,174,6936,1643,8210,247,187,104,184,8932
E02000723,East Ham North,Newham,London,2536,7671,393,213,210,265,8752,2845,11112,424,234,170,288,12228
E02000724,Plashet East,Newham,London,2545,6582,262,164,193,238,7439,2640,9178,298,192,154,198,10020
E02000725,Stratford Central,Newham,London,1596,7854,266,165,124,148,8557,1876,9502,280,185,114,176,10257
E02000726,Olympic Park & Mill Meads,Newham,London,3492,22359,232,157,124,149,23021,3619,23661,323,184,127,157,24452
E02000727,Plashet West,Newham,London,2167,5831,238,140,124,162,6495,2426,8928,306,175,107,179,9695
E02000728,Wallend North,Newham,London,2004,5446,289,191,120,146,6192,2343,8180,313,188,114,156,8951
E02000729,West Ham Park,Newham,London,1633,4983,281,161,102,158,5685,1678,6446,288,193,109,180,7216
E02000730,Upton Park,Newham,London,2043,6024,357,240,165,253,7039,2448,9607,358,260,171,246,10642
E02000731,East Ham Central,Newham,London,2613,7487,298,242,144,198,8369,2734,9504,318,245,142,207,10416
E02000732,East Ham West,Newham,London,2020,5259,211,153,129,183,5935,2170,7199,249,163,124,180,7915
E02000733,West Ham & Stratford Park,Newham,London,1920,7281,321,252,149,214,8217,2021,9562,338,265,150,172,10487
E02000734,Plaistow North,Newham,London,1628,5363,230,148,110,176,6027,1675,6812,224,176,105,178,7495
E02000735,Plaistow North East,Newham,London,1937,5802,246,202,163,327,6740,2174,7528,259,203,163,230,8383
E02000736,Wallend South,Newham,London,2516,5864,214,167,101,194,6540,2612,7575,242,187,116,163,8283
E02000737,East Ham South,Newham,London,2587,6644,266,266,162,214,7552,2715,8306,320,238,141,203,9208
E02000738,East Ham South West,Newham,London,2418,6091,211,195,98,205,6800,2585,7789,265,183,115,169,8521
E02000739,Plaistow Park,Newham,London,1668,5293,223,163,117,129,5925,1711,7078,258,204,100,130,7770
E02000740,Canning Town North,Newham,London,1496,5056,235,139,92,117,5639,1516,6349,233,166,92,113,6953
E02000741,Plaistow South,Newham,London,2121,5944,280,162,123,153,6662,2235,7377,284,181,116,151,8109
E02000742,Lonsdale Avenue,Newham,London,2419,5667,225,130,123,221,6366,2402,6888,242,160,109,181,7580
E02000743,Canning Town Central,Newham,London,2156,7161,294,193,159,217,8024,2299,9361,318,197,121,218,10215
E02000744,Canning Town East,Newham,London,2301,6454,229,195,106,222,7206,2293,7903,257,199,121,168,8648
E02000745,Beckton North,Newham,London,1862,5743,232,138,122,134,6369,2066,7498,327,194,105,121,8245
E02000746,Beckton,Newham,London,1711,6200,200,118,77,143,6738,1951,8055,264,176,73,118,8686
E02000747,Canning Town South & Bow Creek,Newham,London,2337,10824,293,243,177,218,11755,2383,11533,308,222,166,152,12381
E02000748,Beckton Park,Newham,London,1597,4386,211,113,88,80,4878,1660,6184,238,130,88,108,6748
E02000749,Custom House,Newham,London,2034,5825,241,185,144,141,6536,2213,7808,301,223,129,184,8645
E02000750,Royal Docks & North Woolwich,Newham,London,3235,12544,211,170,106,148,13179,3746,14711,286,186,126,123,15432
E02000751,Woodford Wells,Redbridge,London,1789,6384,573,638,457,775,8827,1982,7449,623,656,501,711,9940
E02000752,Hainault East,Redbridge,London,1760,5091,277,293,160,251,6072,2025,6237,289,293,183,267,7269
E02000753,Hainault West,Redbridge,London,1387,4281,234,186,161,340,5202,1526,5075,261,236,167,263,6002
E02000754,Woodford Green,Redbridge,London,1326,4398,278,245,178,220,5319,1417,4998,296,292,165,251,6002
E02000755,Woodford Bridge,Redbridge,London,1125,3601,228,250,171,218,4468,1163,3944,239,222,186,205,4796
E02000756,Fairlop,Redbridge,London,2819,9072,574,517,363,515,11041,3222,10466,567,548,401,484,12466
E02000757,South Woodford High Road,Redbridge,London,2361,8623,491,454,276,533,10377,2563,9205,493,501,304,494,10997
E02000758,Clayhall North,Redbridge,London,1309,4006,255,252,180,323,5016,1472,4704,286,274,176,314,5754
E02000759,Roding,Redbridge,London,2952,8810,515,374,277,389,10365,3016,9839,528,403,271,409,11450
E02000760,Barkingside North,Redbridge,London,1587,4547,272,265,197,355,5636,1707,5530,327,286,210,340,6693
E02000762,Barkingside West,Redbridge,London,1246,4294,332,262,180,342,5410,1295,4815,317,304,197,335,5968
E02000763,Aldborough Hatch,Redbridge,London,1628,5011,304,227,178,281,6001,1769,5675,292,253,187,247,6654
E02000764,Snaresbrook,Redbridge,London,2006,8209,557,498,414,737,10415,2203,8805,550,554,449,745,11103
E02000765,Barkingside East,Redbridge,London,1535,4518,282,201,159,329,5489,1657,5436,284,229,141,308,6398
E02000767,Newbury Park,Redbridge,London,1936,5371,333,244,234,307,6489,2074,6286,326,272,212,339,7435
E02000768,Wanstead,Redbridge,London,1169,3657,266,282,169,280,4654,1284,4205,273,316,169,296,5259
E02000769,Chadwell Heath West,Redbridge,London,4071,10155,474,316,267,532,11744,4390,11854,538,365,264,578,13599
E02000770,Seven Kings Park,Redbridge,London,1859,5290,308,235,153,274,6260,1914,6266,340,268,173,264,7311
E02000772,Goodmayes North,Redbridge,London,2315,5911,311,176,107,234,6739,2282,6665,313,181,134,190,7483
E02000773,Ley Street,Redbridge,London,2515,6652,313,227,169,224,7585,2503,7603,319,256,181,265,8624
E02000774,Seven Kings Meads Lane,Redbridge,London,1754,4954,271,209,155,216,5805,1967,6084,300,235,149,211,6979
E02000776,Ilford North East,Redbridge,London,1851,4414,272,175,120,157,5138,2073,5620,284,210,135,196,6445
E02000777,Wanstead Flats,Redbridge,London,1154,3865,332,273,151,249,4870,1248,4340,348,315,185,240,5428
E02000779,Ilford North West,Redbridge,London,2355,5908,286,199,107,198,6698,2647,8170,296,200,137,231,9034
E02000780,Ilford South East,Redbridge,London,4932,11459,428,369,249,369,12874,5466,15480,546,413,252,373,17064
E02000781,South Park,Redbridge,London,3567,9727,543,478,328,497,11573,3926,11631,583,486,339,525,13564
E02000782,Ilford South West,Redbridge,London,2906,6990,249,163,178,258,7838,3407,9662,307,219,137,252,10577
E02000783,Loxford Park,Redbridge,London,2234,4951,208,151,111,158,5579,2225,6444,212,161,116,170,7103
E02006800,Goodmayes South,Redbridge,London,3530,9616,493,348,219,282,10958,3965,11764,590,371,224,309,13258
E02006924,Valentines Park & Cranbrook,Redbridge,London,2737,9071,578,472,333,576,11030,3180,10844,638,498,334,579,12893
E02006925,Clayhall South,Redbridge,London,2783,9036,668,547,413,588,11252,2713,10160,674,578,403,592,12407
E02000784,North Barnes,Richmond upon Thames,London,2020,6275,480,487,371,488,8101,2135,8602,550,552,438,577,10719
E02000785,Kew Gardens,Richmond upon Thames,London,1919,6375,451,457,369,499,8151,1884,7712,469,504,371,572,9628
E02000786,Mortlake & South Barnes,Richmond upon Thames,London,2602,7301,508,475,317,402,9003,2786,9747,500,554,352,433,11586
E02000787,North Sheen,Richmond upon Thames,London,2702,7972,455,440,290,392,9549,2840,9975,427,498,316,436,11652
E02000788,East Sheen North,Richmond upon Thames,London,2159,5576,413,351,251,354,6945,2323,7232,419,430,290,376,8747
E02000789,Queen's Road,Richmond upon Thames,London,1267,4273,280,290,210,304,5357,1337,5246,284,305,217,327,6379
E02000790,St Margarets,Richmond upon Thames,London,1547,4360,230,245,110,181,5126,1569,5361,249,220,164,175,6169
E02000791,Richmond Central,Richmond upon Thames,London,1248,4999,270,323,191,302,6085,1421,6409,300,330,231,290,7560
E02000792,Twickenham Marble Hill,Richmond upon Thames,London,1456,4650,319,317,243,365,5894,1526,5694,354,333,282,380,7043
E02000793,Whitton,Richmond upon Thames,London,1690,5255,405,350,269,370,6649,1680,5784,394,371,282,403,7234
E02000794,Twickenham North,Richmond upon Thames,London,1529,4539,277,249,177,285,5527,1544,5364,315,291,193,276,6439
E02000795,"Richmond Park, Sheen Gate & Petersham",Richmond upon Thames,London,1780,4051,303,357,295,399,5405,1769,4979,350,372,329,425,6455
E02000796,Heathfield,Richmond upon Thames,London,2430,6621,476,452,327,485,8361,2429,7686,513,499,345,501,9544
E02000797,Twickenham Town,Richmond upon Thames,London,1656,5362,327,264,165,223,6341,1712,6403,330,288,185,215,7421
E02000798,Twickenham West,Richmond upon Thames,London,2586,7004,422,409,254,413,8502,2715,8280,460,448,294,379,9861
E02000799,Strawberry Hill,Richmond upon Thames,London,1175,4056,312,302,158,226,5054,1168,5313,340,303,214,250,6420
E02000800,Ham,Richmond upon Thames,London,1268,3312,265,214,178,252,4221,1343,3933,265,239,192,217,4846
E02000801,Teddington North,Richmond upon Thames,London,1578,4608,317,302,193,231,5651,1600,5169,327,329,223,233,6281
E02000802,Hampton Hill,Richmond upon Thames,London,1363,4320,336,327,228,359,5570,1436,5062,352,374,254,367,6409
E02000803,Nursery Lands & Hampton North,Richmond upon Thames,London,1982,5732,514,471,271,500,7488,1983,6688,548,544,323,498,8601
E02000804,Teddington Central,Richmond upon Thames,London,1372,4718,338,370,187,350,5963,1362,5306,346,378,259,351,6640
E02000805,Hampton Wick & Teddington East,Richmond upon Thames,London,2264,7392,485,492,296,502,9167,2274,8580,570,512,347,488,10497
E02000806,Hampton Village,Richmond upon Thames,London,2027,6256,607,562,306,558,8289,2077,7088,607,585,398,526,9204
E02000807,Rotherhithe,Southwark,London,1257,7536,265,201,123,127,8252,1258,8660,311,213,122,121,9427
E02000808,Borough & Southwark Street,Southwark,London,1081,9648,261,182,103,179,10373,1039,12513,279,223,123,191,13329
E02000809,Bermondsey North,Southwark,London,1624,12044,277,183,89,97,12690,1387,12005,312,199,107,110,12733
E02000810,Bermondsey East,Southwark,London,2571,10007,336,230,150,217,10940,2231,10445,307,283,150,195,11380
E02000812,London Bridge & Bermondsey West,Southwark,London,1736,8172,263,213,169,263,9080,1640,10935,294,232,158,279,11898
E02000813,Canada Water,Southwark,London,2036,8019,261,212,138,199,8829,1831,9564,292,219,134,170,10379
E02000814,Surrey Quays,Southwark,London,1574,8032,256,178,156,160,8782,1624,10642,327,224,127,164,11484
E02000815,Elephant & Castle,Southwark,London,862,6030,101,63,41,152,6387,962,8177,129,95,82,86,8569
E02000816,South Bermondsey Central,Southwark,London,2040,7679,277,234,142,221,8553,1782,8488,282,207,135,199,9311
E02000817,South Bermondsey East,Southwark,London,1500,4938,237,189,133,290,5787,1289,5673,263,195,117,254,6502
E02000818,Walworth North,Southwark,London,1317,6372,249,230,153,189,7193,1406,9192,293,223,174,216,10098
E02000819,South Bermondsey West,Southwark,London,1680,6428,237,162,140,181,7148,1632,7758,272,177,132,181,8520
E02000820,Kennington East,Southwark,London,1661,7990,273,226,143,222,8854,1552,10161,306,196,158,195,11016
E02000821,Burgess Park,Southwark,London,2053,5182,227,191,104,181,5885,1947,8302,253,201,119,159,9034
E02000822,Walworth South,Southwark,London,1672,5016,164,135,86,146,5547,1500,6882,216,177,86,137,7498
E02000823,Burgess Park West & John Ruskin Street,Southwark,London,1584,6497,273,236,158,199,7363,1508,8308,283,233,177,227,9228
E02000824,Peckham Park Road,Southwark,London,2327,6570,289,226,155,230,7470,2204,8863,344,239,154,222,9822
E02000825,Peckham North West,Southwark,London,2328,6475,196,174,179,167,7191,2302,9230,326,224,145,200,10125
E02000826,Camberwell North,Southwark,London,1816,6656,252,207,149,216,7480,1878,8928,312,232,158,196,9826
E02000827,Camberwell Green,Southwark,London,2310,7882,300,252,163,218,8815,2203,10228,393,296,158,249,11324
E02000828,Peckham North,Southwark,London,1738,6145,253,159,136,177,6870,1769,8640,289,208,138,187,9462
E02000829,Queens Road Peckham,Southwark,London,2003,8560,319,223,213,263,9578,1986,9676,365,276,202,348,10867
E02000830,Camberwell South,Southwark,London,1461,6956,262,236,127,229,7810,1454,8579,271,235,177,244,9506
E02000831,Peckham Rye,Southwark,London,1836,7235,274,241,165,212,8127,1797,8643,298,236,148,248,9573
E02000832,Nunhead North,Southwark,London,2214,7390,337,259,227,328,8541,1926,8259,384,303,174,273,9393
E02000833,North Dulwich,Southwark,London,1837,6200,191,159,98,213,6861,1653,6891,212,166,119,186,7574
E02000834,Peckham Rye Common,Southwark,London,1857,7065,261,252,176,257,8011,1756,7668,310,260,168,224,8630
E02000835,Nunhead South & Newlands,Southwark,London,1844,5257,226,158,122,196,5959,1808,5916,266,172,113,195,6662
E02000836,East Dulwich,Southwark,London,1912,5834,252,200,157,204,6647,1884,6798,336,210,169,242,7755
E02000837,Herne Hill & Dulwich Park,Southwark,London,2336,5818,372,293,233,366,7082,2153,6784,409,352,240,384,8169
E02000838,Dulwich Hill,Southwark,London,2277,6545,316,272,149,257,7539,2202,7712,341,298,188,255,8794
E02000839,Sydenham Hill,Southwark,London,1988,5444,302,299,200,268,6513,1971,6633,334,334,272,329,7902
E02006802,Southwark St George's,Southwark,London,1212,6534,196,147,100,152,7129,1360,10108,265,183,126,173,10855
E02000840,Middleton Circle,Sutton,London,2241,5569,272,208,161,241,6451,2264,6432,292,223,145,237,7329
E02000841,St Helier South,Sutton,London,2146,6106,316,211,172,299,7104,2139,6816,341,218,171,255,7801
E02000842,Stonecot,Sutton,London,1517,5121,390,365,240,329,6445,1612,5800,435,424,250,411,7320
E02000843,Hackbridge,Sutton,London,1956,5819,262,243,146,222,6692,2114,6385,296,252,153,266,7352
E02000844,The Wrythe,Sutton,London,1961,5507,279,269,187,267,6509,1993,6289,306,318,185,303,7401
E02000845,Worcester Park East,Sutton,London,2357,6491,330,308,206,302,7637,2368,6926,347,304,227,333,8137
E02000846,Sutton North,Sutton,London,1617,4681,332,341,239,404,5997,1594,5146,365,335,257,375,6478
E02000847,North Cheam West,Sutton,London,1795,5735,473,537,381,603,7729,1883,6159,498,531,410,540,8138
E02000848,North Cheam East,Sutton,London,1726,5141,294,327,228,352,6342,1766,5538,321,322,267,367,6815
E02000849,Wallington North,Sutton,London,1656,5169,324,371,219,317,6400,1739,5567,360,341,245,324,6837
E02000850,Beddington,Sutton,London,2291,6944,472,413,317,433,8579,2246,7428,510,487,315,433,9173
E02000851,Sutton Central,Sutton,London,2216,6871,304,320,219,415,8129,2520,8071,372,322,246,382,9393
E02000852,Sutton East,Sutton,London,1727,5216,301,269,209,324,6319,1786,5740,331,301,215,378,6965
E02000853,Sutton West,Sutton,London,1834,5165,295,302,191,315,6268,1884,5690,316,304,195,292,6797
E02000854,Carshalton Village,Sutton,London,1545,4897,330,337,209,320,6093,1611,5313,377,314,237,326,6567
E02000855,Cheam High Street,Sutton,London,1539,4931,396,427,300,495,6549,1563,5442,448,430,316,495,7131
E02000856,Wallington South,Sutton,London,1954,5900,393,419,269,358,7339,2011,6423,412,418,277,383,7913
E02000857,Sutton South West,Sutton,London,1747,5661,311,265,242,555,7034,1826,6297,344,321,248,539,7749
E02000858,Roundshaw,Sutton,London,2083,5340,301,266,182,219,6308,2098,6092,305,284,207,224,7112
E02000859,Carshalton on the Hill,Sutton,London,1804,5111,410,418,319,637,6895,1717,5456,434,462,328,637,7317
E02000860,Sutton South & Shanklin,Sutton,London,1716,5705,325,287,189,356,6862,1743,6067,326,325,200,362,7280
E02000861,Carshalton Beeches & Banstead Road,Sutton,London,1488,4649,463,518,329,401,6360,1495,5140,483,497,379,465,6964
E02000863,"Orchard Hill, Woodcote Green & Clockhouse",Sutton,London,1349,4178,408,383,194,340,5503,1307,4508,424,406,254,341,5933
E02006836,Belmont & South Cheam,Sutton,London,1638,4917,450,531,372,632,6902,1674,5591,442,553,411,611,7608
E02000864,Bow North & Fish Island,Tower Hamlets,London,2400,7468,305,228,131,262,8394,2253,9533,300,228,139,231,10431
E02000865,Bethnal Green North East,Tower Hamlets,London,1824,5890,220,182,101,167,6560,1601,7326,215,159,114,158,7972
E02000866,Bow West,Tower Hamlets,London,2086,7810,405,274,161,192,8842,1763,8900,326,245,163,204,9838
E02000867,Bow South,Tower Hamlets,London,2153,9976,241,150,134,146,10647,1871,10945,272,147,108,148,11620
E02000868,Bethnal Green North West,Tower Hamlets,London,1270,5730,144,106,72,146,6198,1209,7215,136,120,88,144,7703
E02000869,Columbia Road,Tower Hamlets,London,1191,4840,220,167,110,138,5475,1065,5355,159,150,87,143,5894
E02000870,Bethnal Green East,Tower Hamlets,London,1454,4922,183,150,76,155,5486,1291,5977,164,133,74,134,6482
E02000871,Bromley-by-Bow East,Tower Hamlets,London,2863,8017,257,154,126,208,8762,2730,10711,242,152,97,188,11390
E02000872,Brick Lane North,Tower Hamlets,London,1602,6993,167,104,71,160,7495,1502,8161,173,99,69,120,8622
E02000873,Mile End West,Tower Hamlets,London,2129,8390,144,141,104,195,8974,1923,11156,156,116,78,141,11647
E02000874,Bethnal Green Central,Tower Hamlets,London,1770,5906,149,118,92,101,6366,1669,7462,176,85,78,114,7915
E02000875,Bromley-by-Bow West,Tower Hamlets,London,3384,9765,265,173,117,139,10459,2978,11428,272,172,112,142,12126
E02000876,Bethnal Green South,Tower Hamlets,London,1335,6354,175,80,59,90,6758,1468,8360,157,111,65,104,8797
E02000877,Mile End East & Burdett Estate,Tower Hamlets,London,3103,9451,247,171,136,216,10221,2898,11755,228,151,133,177,12444
E02000878,Spitalfields,Tower Hamlets,London,1596,9593,273,184,144,204,10398,1633,13799,269,139,108,178,14493
E02000879,Stepney Green,Tower Hamlets,London,1926,6458,232,229,147,350,7416,1810,7914,226,208,134,284,8766
E02000880,Whitechapel,Tower Hamlets,London,1402,4877,137,102,61,144,5321,1367,6124,146,89,56,134,6549
E02000881,Poplar Leaside,Tower Hamlets,London,2571,6366,200,142,90,146,6944,2627,9024,235,145,92,130,9626
E02000882,Limehouse North & Stepney East,Tower Hamlets,London,2657,7321,241,166,117,200,8045,2520,8723,230,168,113,216,9450
E02000883,Poplar Central,Tower Hamlets,London,2486,5735,243,176,133,198,6485,2266,7369,239,163,92,156,8019
E02000884,Aldgate,Tower Hamlets,London,2080,11142,183,130,114,184,11753,2221,13138,201,113,99,139,13690
E02000885,Shadwell North,Tower Hamlets,London,1772,5162,227,190,147,213,5939,1724,6578,182,171,137,187,7255
E02000886,Limehouse East,Tower Hamlets,London,1918,6910,250,165,80,152,7557,1761,7628,209,147,75,111,8170
E02000887,Poplar West,Tower Hamlets,London,2901,7809,276,144,120,171,8520,2541,9518,262,182,104,187,10253
E02000888,Shadwell Basin & Ratcliffe,Tower Hamlets,London,2111,7672,196,115,102,151,8236,1793,8199,183,118,67,117,8684
E02000889,St George in the East & Wapping North,Tower Hamlets,London,1719,6353,247,141,100,120,6961,1724,7992,231,125,77,114,8539
E02000890,Tower Hill & Wapping South,Tower Hamlets,London,863,5272,278,182,110,124,5966,716,5638,211,168,81,110,6208
E02000891,Blackwall & Leamouth,Tower Hamlets,London,3861,15799,245,183,112,173,16512,3372,18114,269,166,123,129,18801
E02000893,Mudchute,Tower Hamlets,London,1790,5667,243,191,100,141,6342,1627,6882,211,180,107,162,7542
E02000894,Millwall South,Tower Hamlets,London,2273,9046,270,181,121,120,9738,2246,10823,241,189,115,122,11490
E02006853,Millwall North,Tower Hamlets,London,1922,8716,139,111,107,111,9184,2033,9839,196,118,77,104,10334
E02006854,Canary Wharf,Tower Hamlets,London,1145,6919,144,69,70,32,7234,974,6567,105,77,32,46,6827
E02000895,Chingford Green West,Waltham Forest,London,1584,4714,406,467,364,645,6596,1649,5790,417,449,354,596,7606
E02000896,Chingford Green East,Waltham Forest,London,1616,5568,479,473,339,569,7428,1768,6509,500,469,342,579,8399
E02000897,Friday Hill,Waltham Forest,London,1872,5184,347,348,272,535,6686,1892,6254,358,338,262,479,7691
E02000898,Larkswood,Waltham Forest,London,1667,4771,413,369,223,456,6232,1641,5577,398,360,280,413,7028
E02000899,Chingford Mount,Waltham Forest,London,1716,5410,388,370,220,552,6940,1856,6433,412,330,258,443,7876
E02000900,South Chingford,Waltham Forest,London,2046,5502,338,311,216,358,6725,2109,6741,373,334,240,320,8008
E02000901,Highams Park East,Waltham Forest,London,2188,6547,435,441,242,351,8016,2148,7439,433,408,274,346,8900
E02000902,Highams Park West,Waltham Forest,London,2487,6216,326,269,213,290,7314,2520,7379,301,280,197,261,8418
E02000903,Higham Hill,Waltham Forest,London,2530,6492,279,239,168,202,7380,2554,8135,326,240,169,200,9070
E02000904,Fulbourne Road & Walthamstow Forest,Waltham Forest,London,2066,5980,269,225,129,190,6793,2044,6770,303,219,153,194,7639
E02000905,Lloyd Park,Waltham Forest,London,2488,7089,240,211,137,204,7881,2483,8168,293,245,137,197,9040
E02000906,William Morris,Waltham Forest,London,2321,6441,230,200,138,210,7219,2389,7997,252,203,136,182,8770
E02000907,Wood Street,Waltham Forest,London,2821,7136,271,255,146,316,8124,2579,8143,288,233,165,270,9099
E02000908,Blackhorse Road,Waltham Forest,London,2813,9064,308,217,169,226,9984,2762,9978,314,220,139,210,10861
E02000909,Upper Walthamstow,Waltham Forest,London,2053,6069,269,229,150,257,6974,2237,7494,325,242,146,225,8432
E02000910,Walthamstow Central,Waltham Forest,London,2168,7660,294,224,159,280,8617,2333,9800,367,272,173,311,10923
E02000911,Walthamstow Market & South Grove,Waltham Forest,London,2505,8379,346,237,184,232,9378,2800,10789,360,242,171,217,11779
E02000912,Markhouse & St James Park,Waltham Forest,London,2227,6085,276,231,212,358,7162,2231,7779,326,234,187,218,8744
E02000913,Whipps Cross,Waltham Forest,London,1932,6217,328,260,178,255,7238,2184,8092,391,268,228,261,9240
E02000914,Baker's Arms,Waltham Forest,London,2591,7668,309,209,159,303,8648,2829,10176,408,270,198,356,11408
E02000915,Leytonstone North,Waltham Forest,London,1710,6687,344,194,145,202,7572,1717,7657,397,235,155,226,8670
E02000916,Lea Bridge,Waltham Forest,London,2330,6796,244,207,157,178,7582,2295,8779,333,217,157,224,9710
E02000917,Leyton North,Waltham Forest,London,2404,7249,228,166,130,171,7944,2221,8724,259,196,131,195,9505
E02000918,Leytonstone East,Waltham Forest,London,2006,6941,292,241,133,196,7803,1974,8235,343,258,159,171,9166
E02000919,Leyton East,Waltham Forest,London,1845,7241,299,202,171,249,8162,1953,9003,312,225,147,246,9933
E02000920,Leyton South,Waltham Forest,London,2109,7382,280,240,124,194,8220,2193,9671,342,240,166,236,10655
E02000921,Leytonstone South West,Waltham Forest,London,2423,7917,343,227,186,186,8859,2313,10201,357,323,195,213,11289
E02000922,Leytonstone South East,Waltham Forest,London,2264,7816,306,232,159,211,8724,2328,9637,362,253,176,253,10681
E02000923,Battersea Park,Wandsworth,London,1167,5794,331,301,236,368,7030,1160,6497,307,317,258,431,7810
E02000924,Nine Elms & Patmore,Wandsworth,London,2529,11226,354,232,177,252,12241,2843,15613,432,299,203,287,16834
E02000925,Battersea Latchmere,Wandsworth,London,1574,5753,211,207,119,204,6494,1544,7233,262,226,139,200,8060
E02000926,St Mary's & Cotton Row,Wandsworth,London,1640,8634,310,325,198,242,9709,1739,11065,343,348,204,247,12207
E02000927,Lavender Hill East,Wandsworth,London,1017,5506,233,217,152,194,6302,1081,6718,267,220,165,196,7566
E02000928,Putney Embankment & Lower Common,Wandsworth,London,1633,5847,347,321,200,240,6955,1680,7896,372,345,237,260,9110
E02000929,York Gardens,Wandsworth,London,1576,5178,229,167,146,212,5932,1588,7348,248,209,152,216,8173
E02000930,Lavender Hill West & Little India,Wandsworth,London,1379,8959,175,163,112,187,9596,1411,11403,217,208,130,181,12139
E02000931,Clapham Common West,Wandsworth,London,1867,7219,158,180,98,171,7826,1943,8350,197,185,126,160,9018
E02000932,Putney Town & Wandsworth Park,Wandsworth,London,1809,9049,350,261,174,184,10018,2105,13134,397,286,215,235,14267
E02000933,Putney West,Wandsworth,London,1483,6214,402,324,234,349,7523,1603,8963,398,405,255,368,10389
E02000934,Clapham Junction & East Hill,Wandsworth,London,1133,8144,224,211,122,185,8886,1189,9399,257,233,142,203,10234
E02000935,Roehampton North West,Wandsworth,London,1690,4723,168,186,131,224,5432,1678,6568,192,188,158,239,7345
E02000936,East Putney,Wandsworth,London,1233,6885,292,314,225,319,8035,1450,10748,310,329,229,342,11958
E02000937,Wandsworth Common,Wandsworth,London,1987,5934,187,163,102,175,6561,1986,7027,246,212,113,155,7753
E02000938,Roehampton North East,Wandsworth,London,2303,7556,335,332,286,480,8989,2408,9795,401,411,280,495,11382
E02000939,Nightingale Lane,Wandsworth,London,2035,5403,262,231,154,289,6339,2031,6374,265,241,174,305,7359
E02000940,Wandsworth South,Wandsworth,London,1541,6344,220,165,137,176,7042,1697,8949,256,197,153,180,9735
E02000941,Earlsfield North,Wandsworth,London,2218,7307,264,259,164,233,8227,2146,11031,293,298,179,231,12032
E02000942,Southfields North,Wandsworth,London,1983,6519,336,333,212,236,7636,2016,8760,375,346,242,287,10010
E02000943,Balham,Wandsworth,London,1444,6726,240,169,144,178,7457,1477,8538,254,202,153,224,9371
E02000944,West Hill North,Wandsworth,London,1529,5080,204,177,115,212,5788,1715,7184,225,206,131,213,7959
E02000945,Roehampton South & Putney Vale,Wandsworth,London,1606,5922,267,213,117,210,6729,1701,7283,272,237,158,199,8149
E02000946,Earlsfield South,Wandsworth,London,1397,6485,246,181,100,165,7177,1514,7079,228,216,109,179,7811
E02000947,Merton Road,Wandsworth,London,2084,6191,241,193,183,195,7003,2082,7969,247,245,171,204,8836
E02000948,Tooting Bec Common,Wandsworth,London,1470,7610,197,223,144,247,8421,1536,9937,249,242,175,280,10883
E02000949,Springfield,Wandsworth,London,1771,7129,298,290,167,247,8131,1708,9057,329,315,209,300,10210
E02000950,West Hill South,Wandsworth,London,1511,5192,261,239,161,208,6061,1575,7000,318,277,192,249,8036
E02000951,Tooting Bec West,Wandsworth,London,967,4784,180,163,80,222,5429,1007,6243,226,177,110,174,6930
E02000952,Tooting Bec East,Wandsworth,London,1067,4404,183,133,131,172,5023,970,5980,202,190,121,158,6651
E02000953,Summerstown,Wandsworth,London,1446,5895,144,118,89,148,6394,1489,6879,169,128,122,132,7430
E02000954,Upper Tooting,Wandsworth,London,1138,4345,206,191,132,188,5062,1099,5844,221,202,141,233,6641
E02000955,Tooting North,Wandsworth,London,1249,4517,204,179,141,215,5256,1285,6415,232,223,131,232,7233
E02000956,Tooting West,Wandsworth,London,1379,6296,173,161,100,184,6914,1353,7811,211,188,103,176,8489
E02000957,Tooting East,Wandsworth,London,2005,8192,311,207,184,266,9160,2100,10737,338,276,174,321,11846
E02000958,Furzedown West,Wandsworth,London,1798,5777,311,271,183,325,6867,1755,6888,372,298,194,342,8094
E02000959,Furzedown East,Wandsworth,London,1845,5809,204,167,150,199,6529,1741,6667,223,194,124,203,7411
E02000960,St John's Wood North,Westminster,London,1794,5511,325,328,242,516,6922,1424,6466,318,298,226,402,7710
E02000961,Abbey Road,Westminster,London,2682,7420,399,313,248,412,8792,2057,9035,347,316,249,332,10279
E02000962,St John's Wood South,Westminster,London,1991,6945,451,452,309,565,8722,1542,8276,410,421,312,458,9877
E02000963,Queen's Park Gardens,Westminster,London,2599,7155,432,328,243,353,8511,1972,8735,451,327,264,309,10086
E02000964,Maida Hill,Westminster,London,2797,9439,489,328,256,351,10863,2159,11291,504,369,286,336,12786
E02000965,Maida Vale,Westminster,London,1805,6824,313,172,128,181,7618,1429,8384,292,224,164,213,9277
E02000966,Little Venice,Westminster,London,2220,7750,431,373,220,369,9143,1769,8623,446,350,225,289,9933
E02000967,Regent's Park,Westminster,London,1533,7797,365,261,216,334,8973,968,7476,283,220,198,283,8460
E02000968,Church Street,Westminster,London,3481,10336,685,478,348,672,12519,2626,12801,624,487,334,535,14781
E02000969,Westbourne,Westminster,London,2548,7195,332,236,213,410,8386,2063,9193,344,261,178,331,10307
E02000970,Marylebone & Park Lane,Westminster,London,1545,8314,478,394,250,360,9796,1075,8236,383,338,224,304,9485
E02000971,Bryanston & Dorset Square,Westminster,London,1358,7431,334,325,208,336,8634,981,8464,302,274,229,256,9525
E02000972,Fitzrovia West & Soho,Westminster,London,1185,9068,295,297,183,279,10122,807,8972,299,244,168,201,9884
E02000973,Westbourne Grove,Westminster,London,1936,8356,398,353,284,295,9686,1425,10170,413,364,241,274,11462
E02000974,Paddington & St George's Fields,Westminster,London,1637,7522,434,362,220,364,8902,1349,8902,373,345,243,300,10163
E02000975,Bayswater East,Westminster,London,1386,8355,252,308,163,215,9293,1046,9200,245,268,162,168,10043
E02000976,Queensway,Westminster,London,1620,8745,328,344,228,264,9909,1369,11097,351,328,242,291,12309
E02000977,"Strand, St James & Mayfair",Westminster,London,739,5534,387,336,219,313,6789,531,8290,326,251,167,225,9259
E02000978,"Knightsbridge, Belgravia & Hyde Park",Westminster,London,1533,8667,432,378,270,466,10213,983,8330,368,353,255,362,9668
E02000979,Central Westminster,Westminster,London,1395,7743,480,398,246,365,9232,1208,8635,414,347,243,301,9940
E02000980,Millbank,Westminster,London,1689,7608,477,403,267,454,9209,1263,8125,399,338,262,323,9447
E02000981,Pimlico North,Westminster,London,1336,7882,370,344,209,285,9090,979,8385,360,296,195,221,9457
E02000982,Victoria,Westminster,London,1760,6092,447,366,217,364,7486,1289,7139,364,328,230,283,8344
E02000983,Pimlico South,Westminster,London,1511,6920,397,360,269,481,8427,1200,7170,320,297,227,342,8356
E02002483,Clavering,Hartlepool,North East,2095,6378,479,500,325,484,8166,2151,6714,511,522,321,518,8586
E02002484,Headland & West View,Hartlepool,North East,2152,6431,552,533,278,503,8297,2187,6741,562,548,303,507,8661
E02002485,Jesmond,Hartlepool,North East,1806,4959,375,433,264,348,6379,1768,5384,396,417,285,314,6796
E02002487,Harbour & Victoria,Hartlepool,North East,886,3694,235,172,123,167,4391,795,3554,252,211,129,152,4298
E02002488,Wooler Road,Hartlepool,North East,993,3580,386,322,229,338,4855,1012,3899,398,381,271,413,5362
E02002489,Old Town & Grange,Hartlepool,North East,1518,4847,412,329,194,430,6212,1374,5122,401,355,198,320,6396
E02002490,Foggy Furze,Hartlepool,North East,1206,4058,330,264,150,206,5008,1192,4139,345,281,166,195,5126
E02002491,Rift House & Summerhill,Hartlepool,North East,1369,3763,332,318,212,460,5085,1309,4040,343,310,213,445,5351
E02002492,Rossmere & Mill,Hartlepool,North East,1328,4081,408,377,231,462,5559,1285,4294,391,415,233,349,5682
E02002493,Seaton Carew,Hartlepool,North East,1121,3921,485,438,285,452,5581,1096,4145,522,486,333,450,5936
E02002494,Owton Manor,Hartlepool,North East,1838,4688,350,293,207,374,5912,1849,5127,367,342,222,320,6378
E02006909,"The Fens, Elwick & Hart",Hartlepool,North East,1683,7070,823,936,607,787,10223,1813,7722,915,943,639,860,11079
E02002496,Middlesbrough Central,Middlesbrough,North East,2479,9916,283,211,148,215,10773,2763,12519,379,268,168,252,13586
E02002497,North Ormesby & Brambles,Middlesbrough,North East,1409,3771,240,221,130,173,4535,1581,4384,278,217,127,174,5180
E02002498,Ayresome,Middlesbrough,North East,2157,6766,236,203,140,162,7507,2832,9004,330,207,146,220,9907
E02002499,Berwick Hills,Middlesbrough,North East,1980,4454,291,240,142,299,5426,2206,5262,364,255,152,267,6300
E02002500,Linthorpe East & Albert Park,Middlesbrough,North East,1276,3830,264,217,129,203,4643,1354,4265,322,255,153,238,5233
E02002501,Park Vale,Middlesbrough,North East,1286,3508,268,179,149,172,4276,1576,4199,309,214,159,188,5069
E02002502,Thorntree,Middlesbrough,North East,2076,5625,479,362,293,386,7145,2220,6384,561,442,266,433,8086
E02002503,Newport & Maze Park,Middlesbrough,North East,1698,4181,275,202,148,229,5035,1791,4690,302,232,142,207,5573
E02002504,Linthorpe West,Middlesbrough,North East,2143,6237,424,370,257,357,7645,2165,6854,472,432,275,398,8431
E02002505,Park End,Middlesbrough,North East,1631,3701,259,199,94,220,4473,1770,4423,300,225,111,195,5254
E02002506,Beechwood & James Cook,Middlesbrough,North East,1398,3431,209,232,153,263,4288,1301,3828,226,227,156,248,4685
E02002507,Acklam,Middlesbrough,North East,1064,3717,283,319,282,327,4928,1153,4010,333,316,257,354,5270
E02002508,Kader,Middlesbrough,North East,919,2880,297,294,253,424,4148,909,3311,298,297,281,416,4603
E02002509,Easterside,Middlesbrough,North East,1213,3140,336,224,154,328,4182,1112,3405,324,286,164,297,4476
E02002510,Trimdon,Middlesbrough,North East,920,3359,435,510,310,394,5008,1205,4068,452,506,375,446,5847
E02002512,Marton West,Middlesbrough,North East,846,3096,325,357,291,383,4452,832,3196,360,379,264,396,4595
E02002513,Stainton & Hemlington,Middlesbrough,North East,1883,5394,635,514,320,515,7378,2060,6242,653,591,358,517,8361
E02002514,Coulby Newham,Middlesbrough,North East,1518,5276,478,460,285,511,7010,1468,5707,549,521,297,464,7538
E02006811,Nunthorpe & Marton East,Middlesbrough,North East,1829,5875,637,693,501,697,8403,2065,6774,700,730,561,713,9478
E02002515,Redcar Town & Coatham,Redcar and Cleveland,North East,1183,4474,308,283,247,408,5720,1021,4524,343,318,214,425,5824
E02002516,Redcar Lakes North,Redcar and Cleveland,North East,1232,3515,291,305,198,312,4621,1237,3781,305,300,220,312,4918
E02002517,Dormanstown,Redcar and Cleveland,North East,1062,3218,271,293,192,308,4282,1045,3448,273,281,208,297,4507
E02002518,Redcar East,Redcar and Cleveland,North East,1852,6653,653,656,409,614,8985,1768,6868,683,671,485,633,9340
E02002519,Redcar Lakes South,Redcar and Cleveland,North East,1479,4199,464,474,336,503,5976,1517,4508,485,472,383,503,6351
E02002520,Marske,Redcar and Cleveland,North East,2048,7381,852,1003,741,921,10898,2026,7808,833,991,814,986,11432
E02002521,Saltburn,Redcar and Cleveland,North East,798,3440,470,447,396,561,5314,783,3635,438,483,380,587,5523
E02002523,Grangetown,Redcar and Cleveland,North East,1874,4029,258,185,138,139,4749,1840,4301,287,206,122,149,5065
E02002524,Brotton,Redcar and Cleveland,North East,1028,3251,314,418,231,264,4478,948,3319,340,401,269,301,4630
E02002525,Eston,Redcar and Cleveland,North East,1323,5016,483,459,395,536,6889,1241,5103,530,480,405,526,7044
E02002526,Skelton,Redcar and Cleveland,North East,1467,4718,500,473,270,307,6268,1399,4837,507,502,299,327,6472
E02002527,Loftus & Skinningrove,Redcar and Cleveland,North East,1033,3065,278,308,176,218,4045,1075,3129,298,285,192,218,4122
E02002529,Bankfields,Redcar and Cleveland,North East,1015,3573,383,388,229,291,4864,1007,3753,327,404,274,290,5048
E02002530,"Boosbeck, Lingdale & Easington",Redcar and Cleveland,North East,1022,3698,423,474,342,373,5310,955,3709,418,481,325,365,5298
E02002532,Guisborough North,Redcar and Cleveland,North East,1110,4056,397,392,263,437,5545,1176,4382,396,416,282,446,5922
E02002533,Guisborough West,Redcar and Cleveland,North East,1132,3464,468,457,285,433,5107,1189,3898,506,506,368,446,5724
E02002534,Guisborough Outer & Upleatham,Redcar and Cleveland,North East,758,3039,437,578,389,492,4935,693,3032,432,562,415,517,4958
E02006812,Ormesby,Redcar and Cleveland,North East,1372,4364,474,466,358,514,6176,1337,4746,497,464,350,540,6597
E02006910,South Bank & Teesville,Redcar and Cleveland,North East,1988,6187,549,512,417,547,8212,2167,7027,647,548,385,556,9163
E02002535,Billingham North & Wolviston,Stockton-on-Tees,North East,1465,5918,597,515,355,486,7871,1430,6157,650,606,378,463,8254
E02002536,Billingham Central,Stockton-on-Tees,North East,1918,5811,507,474,417,644,7853,1737,5888,534,488,382,574,7866
E02002537,Billingham East & Haverton Hill,Stockton-on-Tees,North East,2094,5210,361,287,258,431,6547,1959,5588,377,325,234,408,6932
E02002538,Billingham South,Stockton-on-Tees,North East,1224,3434,322,328,195,277,4556,1109,3611,321,331,228,264,4755
E02002539,"Billingham West, Stillington & Longnewton",Stockton-on-Tees,North East,1617,5599,636,647,423,492,7797,1766,6349,667,685,505,554,8760
E02002540,Norton North,Stockton-on-Tees,North East,924,3296,474,512,333,496,5111,903,3440,486,561,362,470,5319
E02002541,Norton High Street,Stockton-on-Tees,North East,1047,3823,361,352,221,342,5099,980,3817,372,362,233,373,5157
E02002542,Roseworth,Stockton-on-Tees,North East,2021,4941,396,337,224,323,6221,1918,5328,393,392,217,304,6634
E02002543,Hardwick & Salters Lane,Stockton-on-Tees,North East,2383,5481,346,295,203,357,6682,2325,5994,396,343,179,333,7245
E02002544,Norton South,Stockton-on-Tees,North East,1557,5881,381,327,212,336,7137,1536,6354,418,353,217,350,7692
E02002545,Rimswell & Bishopsgarth,Stockton-on-Tees,North East,761,3000,401,400,260,369,4430,747,3087,369,415,265,339,4475
E02002546,Eastbourne & Newham Grange,Stockton-on-Tees,North East,1694,4735,323,287,167,297,5809,1630,5099,359,278,186,265,6187
E02002547,Elm Tree & Grangefield,Stockton-on-Tees,North East,941,3440,430,509,346,527,5252,910,3552,452,507,351,510,5372
E02002548,"Central Stockton, Portrack & Low Hartburn",Stockton-on-Tees,North East,2866,9546,475,385,230,341,10977,3062,10543,547,366,224,299,11979
E02002549,Fairfield,Stockton-on-Tees,North East,1156,4058,516,588,448,630,6240,1174,4306,509,564,511,630,6520
E02002550,Hartburn,Stockton-on-Tees,North East,1101,3799,322,334,236,392,5083,1076,3929,378,312,248,373,5240
E02002551,Thornaby North,Stockton-on-Tees,North East,1171,5173,244,190,128,247,5982,1199,5504,296,202,133,210,6345
E02002552,Thornaby Mandale,Stockton-on-Tees,North East,1744,4371,407,312,145,267,5502,1623,4625,395,368,189,221,5798
E02002553,Thornaby Village,Stockton-on-Tees,North East,1294,3425,352,319,208,351,4655,1160,3519,343,348,225,321,4756
E02002554,Thornaby South,Stockton-on-Tees,North East,1101,3016,312,320,230,301,4179,991,3236,342,348,237,313,4476
E02002555,Eaglescliffe,Stockton-on-Tees,North East,1971,5862,624,601,453,620,8160,1908,6304,608,658,464,670,8704
E02002556,Ingleby Barwick East & Hilton,Stockton-on-Tees,North East,1256,4447,488,355,225,208,5723,1277,4742,525,415,243,251,6176
E02002557,Ingleby Barwick West,Stockton-on-Tees,North East,4268,10899,460,330,190,238,12117,4252,11455,498,390,214,285,12842
E02002558,Yarm,Stockton-on-Tees,North East,1866,6320,787,696,473,649,8925,1860,6814,753,791,539,654,9551
E02002559,"Faverdale, Heighington & Sadberge",Darlington,North East,1726,5580,552,573,355,371,7431,1807,6091,547,580,406,408,8032
E02002560,Harrowgate Hill,Darlington,North East,1204,3716,326,332,233,276,4883,1179,4120,335,333,238,289,5315
E02002561,Whinfield,Darlington,North East,832,3136,445,380,217,295,4473,807,3331,438,456,253,312,4790
E02002562,Rise Carr,Darlington,North East,1014,3741,290,278,198,319,4826,995,3915,307,253,192,283,4950
E02002563,Haughton Le Skerne,Darlington,North East,902,3101,395,334,239,475,4544,929,3361,406,393,240,409,4809
E02002564,Cockerton & Hopetown,Darlington,North East,2072,5859,474,488,339,497,7657,2008,6409,493,481,362,491,8236
E02002565,Pierremont,Darlington,North East,861,3429,214,234,132,204,4213,767,3531,256,255,156,197,4395
E02002566,Central Darlington,Darlington,North East,1180,4901,227,246,146,242,5762,1133,5096,252,254,153,233,5988
E02002567,Albert Hill & Red Hall,Darlington,North East,2021,5202,379,423,289,411,6704,2107,5943,421,440,284,421,7509
E02002568,College & Park West,Darlington,North East,984,3510,358,388,262,498,5016,945,3703,390,404,287,521,5305
E02002569,Hummersknott,Darlington,North East,1379,4612,657,731,564,1071,7635,1392,5044,665,694,602,1019,8024
E02002570,Bank Top,Darlington,North East,1481,4797,420,400,217,456,6290,1418,5276,431,431,249,459,6846
E02002571,Firthmoor,Darlington,North East,1500,3928,290,269,211,309,5007,1444,4220,295,272,218,294,5299
E02002572,Park East,Darlington,North East,1440,4090,277,257,164,185,4973,1374,4419,300,269,172,195,5355
E02002573,Middleton & Hurworth,Darlington,North East,1579,5089,559,598,414,554,7214,1706,5731,593,613,460,617,8014
E02004290,Ouston & Beamish,County Durham,North East,907,3475,404,383,280,327,4869,823,3643,429,392,294,346,5104
E02004291,Pelton & Perkinsville,County Durham,North East,1302,4625,384,373,241,323,5946,1274,4761,378,373,257,350,6119
E02004292,Chester-le-Street North,County Durham,North East,1250,4411,464,637,471,650,6633,1207,4841,471,557,509,703,7081
E02004293,Chester-le-Street Town & Pelton Fell,County Durham,North East,1862,6019,495,469,356,557,7896,1804,6392,525,438,392,568,8315
E02004294,Chester-le-Street South & East,County Durham,North East,1187,5116,537,607,376,494,7130,1110,5106,553,601,420,531,7211
E02004295,Great Lumley & Bournmoor,County Durham,North East,1175,4353,506,524,318,400,6101,1176,4531,503,508,342,444,6328
E02004296,Sacriston,County Durham,North East,1437,5255,523,460,322,367,6927,1481,5650,498,485,317,386,7336
E02004297,Burnopfield,County Durham,North East,1372,4967,451,482,387,466,6753,1312,4940,474,486,389,486,6775
E02004298,"Benfieldside, Hamsterley & Medomsley",County Durham,North East,1643,6041,653,658,431,634,8417,1570,6106,704,656,445,651,8562
E02004299,Stanley North & East,County Durham,North East,1522,5134,600,511,340,431,7016,1415,5183,574,515,365,454,7091
E02004300,Catchgate & Dipton,County Durham,North East,1532,4625,447,515,343,405,6335,1453,4798,466,511,362,408,6545
E02004301,Stanley South,County Durham,North East,2087,5903,470,434,264,397,7468,2040,6231,488,449,311,353,7832
E02004302,Stanley West & Annfield Plain,County Durham,North East,1485,4798,461,417,304,375,6355,1419,5018,442,435,325,355,6575
E02004303,Consett,County Durham,North East,1806,7110,615,613,466,564,9368,1719,7320,654,639,450,652,9715
E02004304,Delves Lane & Leadgate,County Durham,North East,1859,5543,472,490,329,552,7386,1759,5672,467,449,336,539,7463
E02004305,"Bridgehill, Castleside & Harehope Hill",County Durham,North East,2106,6205,505,453,342,382,7887,2073,6521,507,465,330,434,8257
E02004306,Lanchester,County Durham,North East,979,3325,455,483,286,408,4957,1046,3547,465,463,347,421,5243
E02004307,Langley Park & Satley,County Durham,North East,1111,4170,402,358,260,371,5561,1073,4296,412,381,255,320,5664
E02004308,Newton Hall & Brasside,County Durham,North East,1133,5056,589,647,371,414,7077,1091,4905,545,626,423,437,6936
E02004309,Pity Me & Framwellgate Moor,County Durham,North East,1152,3818,361,362,243,406,5190,1147,4228,363,376,244,420,5631
E02004310,Bearpark & Witton Gilbert,County Durham,North East,1387,4833,542,493,304,367,6539,1400,4967,490,503,357,347,6664
E02004311,Sherburn & West Rainton,County Durham,North East,1578,5584,603,601,369,447,7604,1511,5774,584,594,393,473,7818
E02004312,Belmont & Carrville,County Durham,North East,1085,4013,556,677,474,624,6344,1089,4219,507,666,509,657,6558
E02004313,Gilesgate & Old Durham,County Durham,North East,1137,5687,255,298,216,283,6739,1112,5819,269,284,204,261,6837
E02004314,Durham City,County Durham,North East,295,13305,195,178,158,342,14178,246,19545,190,200,137,312,20384
E02004315,"Aykley Heads, Neville's Cross & Langley Moor",County Durham,North East,2242,10769,548,471,307,438,12533,2236,10139,538,494,342,476,11989
E02004316,Esh Winning & Ushaw Moor,County Durham,North East,1187,3969,342,330,209,283,5133,1203,4079,369,345,237,280,5310
E02004317,Brandon & Brancepeth,County Durham,North East,1263,4510,530,512,310,450,6312,1150,4675,477,515,330,436,6433
E02004318,High Shincliffe & Bowburn,County Durham,North East,1127,4172,392,364,257,349,5534,1195,4417,432,365,288,358,5860
E02004319,Coxhoe & Quarrington Hill,County Durham,North East,1422,4884,443,425,332,331,6415,1386,5076,421,405,326,397,6625
E02004320,Seaham Northlea & Westlea,County Durham,North East,1542,5525,532,488,313,558,7416,1453,5493,563,496,332,498,7382
E02004321,Seaham Central & South,County Durham,North East,1582,5427,484,363,286,417,6977,1511,5524,475,381,302,504,7186
E02004322,Murton North & Parkside,County Durham,North East,1768,5047,489,481,333,399,6749,1771,5442,525,508,342,464,7281
E02004323,South Murton & South Hetton,County Durham,North East,1469,5210,381,361,246,399,6597,1369,4965,394,355,265,343,6322
E02004324,Easington & Hawthorn,County Durham,North East,1001,3485,358,365,225,301,4734,982,3745,352,356,245,290,4988
E02004325,Peterlee East,County Durham,North East,1809,5293,423,376,226,399,6717,1939,6096,430,387,244,404,7561
E02004326,Shotton & Haswell,County Durham,North East,1415,4247,324,324,242,304,5441,1409,4563,369,334,247,318,5831
E02004327,Horden,County Durham,North East,946,3509,372,322,285,351,4839,952,3748,335,331,291,368,5073
E02004328,Peterlee West,County Durham,North East,1506,4456,315,361,253,383,5768,1455,4889,321,331,280,392,6213
E02004329,Peterlee South,County Durham,North East,951,3904,462,414,294,368,5442,915,4129,513,401,308,372,5723
E02004330,Blackhall,County Durham,North East,839,3437,416,399,275,349,4876,940,3809,444,402,308,425,5388
E02004331,Thornley & Wheatley Hill,County Durham,North East,1363,4481,343,450,288,362,5924,1326,4552,358,420,332,369,6031
E02004332,Wingate & Castle Eden,County Durham,North East,1416,4581,404,369,277,306,5937,1381,4842,434,366,263,327,6232
E02004333,Tudhoe Grange,County Durham,North East,1014,4058,605,568,303,362,5896,949,4060,589,557,386,388,5980
E02004334,Trimdon & Fishburn,County Durham,North East,1340,4506,408,404,271,311,5900,1260,4552,446,394,310,302,6004
E02004335,Spennymoor East & Ferryhill West,County Durham,North East,1437,4620,415,360,227,310,5932,1537,4912,445,380,265,323,6325
E02004336,Ferryhill East & Cornforth,County Durham,North East,1085,3878,486,469,356,429,5618,1123,4234,497,450,372,461,6014
E02004337,Spennymoor West,County Durham,North East,1886,6182,595,545,329,466,8117,1903,6679,589,632,345,475,8720
E02004338,Chilton,County Durham,North East,1249,4428,407,410,272,340,5857,1203,4764,397,425,291,326,6203
E02004339,Sedgefield & Bishop Middleham,County Durham,North East,1134,3855,442,571,409,436,5713,1095,4058,462,544,430,459,5953
E02004340,Shildon,County Durham,North East,1916,6313,581,593,361,571,8419,2018,6798,593,646,376,559,8972
E02004341,Newton Aycliffe North,County Durham,North East,1485,5311,581,544,387,363,7186,1382,5737,590,606,405,407,7745
E02004342,Newton Aycliffe West,County Durham,North East,1478,3445,214,199,157,273,4288,1410,3771,234,232,162,239,4638
E02004343,Newton Aycliffe East,County Durham,North East,990,3313,311,291,241,358,4514,977,3565,337,324,233,395,4854
E02004344,Newton Aycliffe South,County Durham,North East,1239,4039,504,457,334,557,5891,1230,4484,490,471,321,483,6249
E02004345,"Evenwood, Cockfield & Staindrop",County Durham,North East,1959,7400,982,949,631,807,10769,1897,7823,1021,990,674,852,11360
E02004346,Upper Teesdale,County Durham,North East,744,2963,414,454,228,339,4398,658,3064,404,455,301,311,4535
E02004347,Barnard Castle,County Durham,North East,965,4257,496,514,396,628,6291,1021,4374,498,541,399,667,6479
E02004348,Stanhope & Weardale,County Durham,North East,1116,4515,675,698,461,518,6867,977,4561,645,716,490,568,6980
E02004349,Crook North & Tow Law,County Durham,North East,1996,5632,542,445,353,474,7446,1834,5729,547,503,366,469,7614
E02004350,Crook South,County Durham,North East,1649,5829,650,628,436,500,8043,1653,5993,671,650,456,543,8313
E02004351,Coundon North,County Durham,North East,1462,4428,430,428,254,359,5899,1397,4643,423,427,283,353,6129
E02004352,Bishop Auckland North & Coundon Grange,County Durham,North East,1436,4930,431,457,270,414,6502,1511,5362,475,437,293,446,7013
E02004353,Bishop Auckland Central & West,County Durham,North East,1155,4276,480,518,330,581,6185,1183,4522,470,518,346,547,6403
E02004354,Saint Helen Auckland & West Auckland,County Durham,North East,1681,5629,565,588,349,294,7425,1740,5936,577,599,349,370,7831
E02004355,Bishop Auckland South,County Durham,North East,1493,4412,421,372,241,326,5772,1502,4784,430,422,248,321,6205
E02005702,Longhoughton & Alnmouth,Northumberland,North East,867,3745,499,536,383,576,5739,905,3776,477,586,404,607,5850
E02005703,Alnwick,Northumberland,North East,974,4058,470,442,331,477,5778,966,4167,524,508,345,493,6037
E02005704,"Amble, Shilbottle & Swarland",Northumberland,North East,1788,7389,975,978,638,892,10872,1816,7611,1075,1028,741,886,11341
E02005705,Rothbury & Longframlington,Northumberland,North East,997,4169,765,641,482,578,6635,963,4212,768,697,500,570,6747
E02005706,Berwick-upon-Tweed Town,Northumberland,North East,1636,5599,638,584,421,672,7914,1636,5741,635,633,419,686,8114
E02005707,Berwick-upon-Tweed West & Holy Island,Northumberland,North East,948,3868,629,672,520,537,6226,889,3858,578,640,490,538,6104
E02005708,"Seahouses, Belford & Wooler",Northumberland,North East,1249,5749,988,954,669,833,9193,1145,5238,957,919,681,817,8612
E02005709,Blyth Cowpen,Northumberland,North East,1624,4235,338,297,191,324,5385,1544,4465,326,343,227,310,5671
E02005710,Blyth Town,Northumberland,North East,1681,5917,508,505,330,490,7750,1573,5986,548,531,350,547,7962
E02005711,Blyth Isabella,Northumberland,North East,1592,4782,503,523,326,389,6523,1527,4933,506,521,342,405,6707
E02005712,Blyth Newsham,Northumberland,North East,1831,5423,405,409,228,280,6745,1848,5691,414,421,254,306,7086
E02005713,Blyth South,Northumberland,North East,951,3814,539,505,271,324,5453,909,3799,503,559,322,301,5484
E02005714,North Cramlington,Northumberland,North East,932,3241,390,296,188,95,4210,817,3473,373,359,193,144,4542
E02005715,Cramlington Town & Beaconhill,Northumberland,North East,1689,5173,548,486,333,539,7079,1821,5835,522,516,372,506,7751
E02005716,East Cramlington & Parkside,Northumberland,North East,1621,5462,601,572,272,368,7275,1669,6057,620,639,322,358,7996
E02005717,Holywell & Hartley,Northumberland,North East,1076,4351,556,604,398,598,6507,1047,4443,559,624,481,591,6698
E02005718,Cramlington South,Northumberland,North East,811,3506,565,703,406,425,5605,826,3600,545,716,486,434,5781
E02005719,Seaton Delaval & Seghill,Northumberland,North East,1286,5476,518,571,332,368,7265,1233,5148,529,525,366,384,6952
E02005720,"Widdrington, Lynemouth & Hadston",Northumberland,North East,1729,7563,868,852,476,586,10345,1732,7968,888,847,559,588,10850
E02005721,Morpeth North & Pegswood,Northumberland,North East,899,3430,325,322,191,359,4627,874,3507,385,353,216,356,4817
E02005722,"Longhorsley, Hepscott & Capheaton",Northumberland,North East,1370,4966,601,587,363,402,6919,1479,5756,713,611,394,475,7949
E02005723,Morpeth Central & East,Northumberland,North East,906,3451,460,425,328,607,5271,875,3561,454,433,338,604,5390
E02005724,Morpeth South & West,Northumberland,North East,1133,3613,473,524,391,534,5535,1127,3771,469,583,393,586,5802
E02005725,Ponteland,Northumberland,North East,1087,3638,490,516,374,774,5792,1072,3928,467,577,402,773,6147
E02005726,"Darras Hall, Stamfordham & Heddon",Northumberland,North East,1240,4382,536,590,413,673,6594,1289,4854,546,584,432,684,7100
E02005727,"Bellingham, Otterburn & Redesdale",Northumberland,North East,918,3731,493,505,299,387,5415,864,3691,514,466,329,405,5405
E02005728,Haltwhistle & Bardon Mill,Northumberland,North East,1080,3969,546,596,375,464,5950,974,3896,560,574,413,464,5907
E02005729,Wylam & Ovingham,Northumberland,North East,918,3317,444,403,276,339,4779,862,3416,398,430,309,403,4956
E02005730,Hexham & Acomb,Northumberland,North East,1932,7453,899,937,668,1137,11094,1856,7564,961,973,731,1114,11343
E02005731,Prudhoe,Northumberland,North East,1988,6803,627,615,481,533,9059,1882,7092,594,677,458,567,9388
E02005732,"Stocksfield, Riding Mill & Corbridge",Northumberland,North East,1321,4977,706,786,504,867,7840,1253,4992,757,776,594,848,7967
E02005733,Haydon Bridge & Allendale,Northumberland,North East,1320,4883,693,681,384,519,7160,1223,4917,718,688,459,541,7323
E02005734,Newbiggin,Northumberland,North East,1060,3576,426,413,300,358,5073,999,3670,460,424,282,396,5232
E02005735,Ashington Hirst,Northumberland,North East,1623,4943,366,331,223,313,6176,1488,4973,365,347,235,319,6239
E02005736,Ashington East,Northumberland,North East,1681,5045,482,470,272,294,6563,1699,5336,481,498,332,320,6967
E02005737,Ashington West,Northumberland,North East,1160,4499,493,488,254,395,6129,1242,4706,503,469,331,385,6394
E02005738,Ashington South,Northumberland,North East,747,3070,328,354,199,225,4176,750,3110,337,358,239,244,4288
E02005739,Guide Post & Stakeford,Northumberland,North East,1464,5453,598,545,524,615,7735,1466,5604,588,585,484,652,7913
E02005740,Bedlington Station & Sleekburn,Northumberland,North East,1947,6333,624,585,364,515,8421,1866,6449,585,597,398,521,8550
E02005741,Bedlington Town,Northumberland,North East,1367,5156,590,525,343,570,7184,1322,5296,582,572,388,572,7410
E02001708,Kingston Park & Dinnington,Newcastle upon Tyne,North East,3026,8053,684,592,331,482,10142,3362,9916,737,668,378,548,12247
E02001709,North Gosforth,Newcastle upon Tyne,North East,1975,5874,597,564,424,694,8153,1958,6772,641,621,446,668,9148
E02001710,Fawdon South,Newcastle upon Tyne,North East,1933,6007,456,399,282,552,7696,1910,6938,539,472,313,555,8817
E02001711,Woolsington & Airport,Newcastle upon Tyne,North East,2120,5536,439,388,313,570,7246,2118,6636,448,460,306,555,8405
E02001712,South Gosforth,Newcastle upon Tyne,North East,1551,6155,506,460,284,545,7950,1608,6836,547,505,311,572,8771
E02001713,Coxlodge & West Gosforth,Newcastle upon Tyne,North East,1923,6272,565,511,342,616,8306,1882,7000,587,533,384,593,9097
E02001714,High Heaton,Newcastle upon Tyne,North East,1782,6009,552,426,235,476,7698,1835,6779,575,506,262,462,8584
E02001715,Kenton,Newcastle upon Tyne,North East,2763,6998,482,450,264,492,8686,2747,8031,528,490,281,449,9779
E02001718,Blakelaw,Newcastle upon Tyne,North East,1306,3627,307,300,190,277,4701,1394,4426,325,314,216,276,5557
E02001719,North Heaton,Newcastle upon Tyne,North East,1395,5470,451,417,295,492,7125,1392,6139,487,438,307,469,7840
E02001720,North Jesmond,Newcastle upon Tyne,North East,526,7980,225,219,132,217,8773,517,6812,269,245,152,208,7686
E02001721,Throckley & Newburn,Newcastle upon Tyne,North East,1861,6194,538,629,433,666,8460,1904,6946,551,630,418,666,9211
E02001722,Denton,Newcastle upon Tyne,North East,2086,5802,442,480,345,770,7839,1963,5949,461,451,352,697,7910
E02001723,Cowgate,Newcastle upon Tyne,North East,1669,4040,259,202,167,302,4970,1740,4948,295,228,175,291,5937
E02001724,South Jesmond & Sandyford,Newcastle upon Tyne,North East,453,7534,240,233,176,339,8522,439,6771,243,240,178,315,7747
E02001725,Heaton South,Newcastle upon Tyne,North East,954,8419,219,210,131,245,9224,960,8573,241,224,141,207,9386
E02001726,Fenham,Newcastle upon Tyne,North East,2693,7772,477,458,298,470,9475,2642,8615,534,467,309,471,10396
E02001727,Walkergate,Newcastle upon Tyne,North East,1437,5288,468,459,314,429,6958,1471,5914,571,458,309,474,7726
E02001728,Lemington,Newcastle upon Tyne,North East,1795,5654,541,524,351,497,7567,1766,6165,530,578,380,443,8096
E02001729,Nunsmoor,Newcastle upon Tyne,North East,2822,10556,260,183,118,230,11347,2922,14087,331,211,130,267,15026
E02001730,Shieldfield & Heaton Park,Newcastle upon Tyne,North East,908,18666,302,230,158,186,19542,840,17162,309,241,150,186,18048
E02001731,City Centre & Arthur's Hill,Newcastle upon Tyne,North East,1421,19214,272,253,146,270,20155,1343,25249,337,269,161,258,26274
E02001732,Scotswood,Newcastle upon Tyne,North East,1219,3161,332,258,150,215,4116,1245,3750,311,276,147,190,4674
E02001733,Byker,Newcastle upon Tyne,North East,2398,8169,520,484,300,483,9956,2605,9306,574,495,329,470,11174
E02001734,Benwell,Newcastle upon Tyne,North East,2072,5150,345,354,223,373,6445,2054,6068,353,358,248,373,7400
E02001735,Walker North,Newcastle upon Tyne,North East,1731,4065,259,244,167,267,5002,1642,4651,287,242,170,289,5639
E02001736,Elswick,Newcastle upon Tyne,North East,3958,9383,433,322,203,339,10680,4273,12626,490,387,204,326,14033
E02001737,Walker South,Newcastle upon Tyne,North East,1279,3643,284,301,197,333,4758,1339,4264,299,288,189,291,5331
E02006893,Westerhope,Newcastle upon Tyne,North East,1566,5667,735,850,591,863,8706,1570,6243,730,880,663,934,9450
E02001738,Whitley Bay North,North Tyneside,North East,972,3070,478,559,364,613,5084,1068,3398,454,528,419,598,5397
E02001739,Fordley,North Tyneside,North East,1187,4454,523,512,295,332,6116,1165,4711,487,530,327,376,6431
E02001740,Whitley Sands,North Tyneside,North East,1320,3453,316,383,227,357,4736,1279,3667,318,367,255,385,4992
E02001741,Wideopen & Seaton Burn,North Tyneside,North East,1220,4353,548,576,393,677,6547,1182,4526,543,605,392,655,6721
E02001742,West Monkseaton,North Tyneside,North East,969,3441,404,429,269,398,4941,939,3609,395,444,317,414,5179
E02001743,Whitley Bay Promenade,North Tyneside,North East,1450,4916,406,385,230,312,6249,1397,5199,440,418,250,355,6662
E02001744,Shiremoor North & South Wellfield,North Tyneside,North East,1540,4607,374,347,217,410,5955,1569,5166,376,373,233,395,6543
E02001745,Killingworth West & Camperdown,North Tyneside,North East,1274,4122,342,405,180,293,5342,1316,4305,383,377,235,265,5565
E02001746,Monkseaton,North Tyneside,North East,1607,4994,483,429,318,463,6687,1498,5330,438,484,318,488,7058
E02001747,Cullercoats,North Tyneside,North East,950,3455,435,446,356,580,5272,985,3617,441,464,345,619,5486
E02001748,Shiremoor South & West Allotment,North Tyneside,North East,1839,5397,381,359,185,269,6591,1796,5739,409,373,196,299,7016
E02001749,Killingworth East,North Tyneside,North East,1028,3850,457,415,250,358,5330,1093,3911,435,470,239,384,5439
E02001750,Preston Grange,North Tyneside,North East,1190,4009,434,421,325,500,5689,1176,4186,460,439,314,552,5951
E02001751,Forest Hall & West Moor,North Tyneside,North East,1106,3763,342,348,208,378,5039,1131,4220,370,344,249,368,5551
E02001752,New York,North Tyneside,North East,1329,3851,365,346,212,327,5101,1346,4148,336,319,217,322,5342
E02001753,Tynemouth Priory,North Tyneside,North East,970,3815,479,377,253,406,5330,931,3799,446,443,274,402,5364
E02001754,Tynemouth West,North Tyneside,North East,877,3612,345,344,278,422,5001,838,3652,386,364,276,425,5103
E02001755,Holystone & Benton,North Tyneside,North East,1704,5733,452,469,309,508,7471,1779,6145,514,478,341,496,7974
E02001756,Longbenton,North Tyneside,North East,1800,6259,420,341,263,440,7723,1806,6583,469,380,265,403,8100
E02001757,Preston Billy Mill,North Tyneside,North East,915,3463,378,395,243,410,4889,872,3722,386,399,248,398,5153
E02001758,Battle Hill East,North Tyneside,North East,1019,3412,410,350,184,169,4525,1041,3542,396,386,227,185,4736
E02001759,North Shields,North Tyneside,North East,803,4092,368,345,217,326,5348,807,4196,367,339,223,361,5486
E02001760,Chirton,North Tyneside,North East,1867,5003,272,283,209,271,6038,1899,5335,337,278,199,259,6408
E02001761,Battle Hill West,North Tyneside,North East,841,3246,327,336,281,349,4539,893,3423,365,353,284,370,4795
E02001762,East Benton,North Tyneside,North East,971,3856,426,339,198,227,5046,1144,4112,464,351,226,226,5379
E02001763,Howdon,North Tyneside,North East,1144,4044,384,340,177,273,5218,1140,4317,372,337,222,262,5510
E02001764,Percy Main,North Tyneside,North East,1400,5188,426,317,192,303,6426,1416,5285,441,368,205,320,6619
E02001765,Willington Quay,North Tyneside,North East,1674,4940,353,278,218,327,6116,1599,5024,409,306,227,324,6290
E02001766,Wallsend East,North Tyneside,North East,1473,5182,279,283,163,181,6088,1383,5264,351,289,169,206,6279
E02001767,Wallsend West,North Tyneside,North East,1154,4637,377,307,216,346,5883,1147,4753,402,351,264,338,6108
E02001768,South Shields East,South Tyneside,North East,1495,5588,446,388,257,344,7023,1438,6035,508,407,297,325,7572
E02001769,South Shields West,South Tyneside,North East,1304,5668,427,367,205,294,6961,1267,6918,454,364,218,298,8252
E02001770,Westoe,South Tyneside,North East,832,4391,366,322,211,365,5655,815,4817,371,329,240,353,6110
E02001771,Horsley Hill,South Tyneside,North East,1263,3712,391,359,269,587,5318,1217,3931,411,371,283,439,5435
E02001772,West Park,South Tyneside,North East,897,3357,312,330,213,378,4590,828,3561,309,305,242,382,4799
E02001773,Harton West,South Tyneside,North East,763,3050,404,403,250,410,4517,747,3198,426,426,297,432,4779
E02001774,Jarrow Town,South Tyneside,North East,1015,3498,311,326,199,214,4548,957,3604,325,316,217,228,4690
E02001775,Harton East,South Tyneside,North East,1092,3314,329,305,192,318,4458,1082,3563,319,337,209,354,4782
E02001776,Hebburn North,South Tyneside,North East,1664,5655,461,372,252,382,7122,1737,6009,505,396,218,422,7550
E02001777,Hebburn West,South Tyneside,North East,1074,4100,341,302,189,296,5228,1067,4448,346,348,201,296,5639
E02001778,West Harton,South Tyneside,North East,904,3928,305,295,202,298,5028,878,4041,323,310,188,305,5167
E02001779,Simonside,South Tyneside,North East,1074,3465,327,330,176,275,4573,1016,3606,338,315,197,274,4730
E02001780,Cleadon Park,South Tyneside,North East,1134,3560,351,386,241,346,4884,1174,3862,342,391,281,343,5219
E02001781,Brockley Whins,South Tyneside,North East,1092,3335,299,254,143,255,4286,1112,3513,301,262,135,228,4439
E02001782,Hebburn South,South Tyneside,North East,1987,5787,541,446,318,562,7654,2043,6378,563,475,330,565,8311
E02001783,Biddick Hill,South Tyneside,North East,1770,4374,354,255,185,272,5440,1838,4809,340,296,173,266,5884
E02001784,Primrose,South Tyneside,North East,1192,4050,413,340,267,373,5443,1189,4264,390,353,290,381,5678
E02001785,Whitburn & Marsden,South Tyneside,North East,1307,4539,525,545,373,506,6488,1280,4654,519,550,393,523,6639
E02001786,Whiteleas,South Tyneside,North East,1219,4224,374,333,236,418,5585,1192,4424,416,351,228,407,5826
E02001787,Fellgate & Hedworth,South Tyneside,North East,1009,3160,345,431,230,231,4397,988,3333,343,431,267,279,4653
E02001788,Boldon Colliery,South Tyneside,North East,1009,3737,356,296,188,260,4837,1024,3900,399,339,177,288,5103
E02001789,Cleadon & East Boldon,South Tyneside,North East,906,3137,408,440,311,475,4771,892,3393,387,454,329,507,5070
E02001790,West Boldon,South Tyneside,North East,1068,3684,369,343,265,439,5100,1024,3670,372,380,255,455,5132
E02001791,Fulwell,Sunderland,North East,819,3380,280,359,275,407,4701,796,3447,313,332,261,437,4790
E02001792,Seaburn,Sunderland,North East,865,3960,454,461,348,618,5841,847,4282,507,475,349,631,6244
E02001793,Town End Farm,Sunderland,North East,1767,5262,319,312,199,420,6512,1763,5601,385,309,207,382,6884
E02001794,Hylton Red House & Marley Pots,Sunderland,North East,1804,5290,444,369,350,524,6977,1819,5742,473,404,334,545,7498
E02001795,Southwick,Sunderland,North East,1323,4620,459,394,264,396,6133,1304,4872,486,445,272,386,6461
E02001796,Monkwearmouth,Sunderland,North East,1225,6408,587,519,397,556,8467,1147,6526,548,580,372,599,8625
E02001797,Springwell & Usworth,Sunderland,North East,934,3496,422,407,251,291,4867,887,3663,406,456,278,349,5152
E02001798,North Hylton,Sunderland,North East,1581,5151,473,376,273,387,6660,1575,5496,482,404,285,375,7042
E02001799,Concord and Sulgrave,Sunderland,North East,2069,6063,481,422,239,444,7649,1937,6348,511,457,270,440,8026
E02001800,Albany and Blackfell,Sunderland,North East,1257,4190,495,468,237,195,5585,1130,4348,481,505,250,259,5843
E02001801,Millfield,Sunderland,North East,1109,4793,260,227,105,213,5598,1179,5463,278,239,112,188,6280
E02001802,Pallion North,Sunderland,North East,1654,4225,323,281,200,265,5294,1640,4872,325,315,209,316,6037
E02001803,Sunderland Central & Deptford,Sunderland,North East,1177,7705,364,286,180,312,8847,1168,8382,385,322,183,295,9567
E02001804,South Hylton,Sunderland,North East,1145,4091,317,378,248,360,5394,1089,4164,338,341,256,376,5475
E02001805,Pallion South & High Barnes,Sunderland,North East,840,3493,360,304,296,488,4941,792,3572,377,338,261,481,5029
E02001806,Hendon & Docks,Sunderland,North East,1408,5453,428,351,209,334,6775,1452,6089,454,410,243,340,7536
E02001807,"Columbia, Barmston & Teal Farm",Sunderland,North East,1753,4956,430,448,229,272,6335,1833,5452,473,470,269,337,7001
E02001808,Barnes Park,Sunderland,North East,1088,3990,254,256,170,268,4938,1121,4423,311,241,176,277,5428
E02001809,Washington Town Centre & Biddick,Sunderland,North East,1094,3600,540,560,306,331,5337,1117,3845,525,577,335,351,5633
E02001810,Oxclose and Lambton,Sunderland,North East,1404,5331,657,495,244,238,6965,1334,5444,661,591,288,265,7249
E02001811,Pennywell and Grindon,Sunderland,North East,1766,5504,467,477,308,447,7203,1699,5770,451,482,345,451,7499
E02001812,Hill View & Tunstall,Sunderland,North East,1450,5953,707,712,497,777,8646,1362,6236,731,733,523,833,9056
E02001813,Thorney Close & Plains Farm,Sunderland,North East,2105,6248,395,452,275,340,7710,2121,6710,389,432,311,400,8242
E02001814,Grangetown,Sunderland,North East,1138,3867,347,288,220,325,5047,1095,4118,350,331,207,355,5361
E02001815,"Harraton, Rickleton & Fatfield",Sunderland,North East,1653,5900,810,738,432,411,8291,1557,6249,867,801,485,493,8895
E02001816,Lakeside & Farrington,Sunderland,North East,1119,4146,452,380,311,486,5775,1143,4372,445,445,277,474,6013
E02001817,Silksworth,Sunderland,North East,1219,3987,341,338,269,418,5353,1228,4310,399,319,269,401,5698
E02001818,Ryhope,Sunderland,North East,1845,5820,468,375,246,433,7342,1837,6149,504,374,262,435,7724
E02001819,Herrington & Doxford,Sunderland,North East,899,3844,512,549,367,496,5768,912,4143,523,574,403,573,6216
E02001820,Shiney Row,Sunderland,North East,1843,5719,474,454,323,391,7361,1896,6218,504,505,329,478,8034
E02001821,Hall Farm,Sunderland,North East,864,3595,356,309,182,233,4675,859,3845,378,329,186,274,5012
E02001822,Newbottle & Penshaw,Sunderland,North East,1265,4959,430,375,259,327,6350,1250,5054,446,425,277,370,6572
E02001823,Houghton West,Sunderland,North East,1562,4821,406,363,241,339,6170,1573,5233,437,387,247,335,6639
E02001824,Houghton Town,Sunderland,North East,1555,5076,533,524,394,579,7106,1554,5275,496,542,435,623,7371
E02001825,Hetton-le-Hole North,Sunderland,North East,1036,4332,457,520,343,546,6198,1096,4659,472,501,411,550,6593
E02001826,Hetton-le-Hole South,Sunderland,North East,1599,4400,393,396,234,237,5660,1570,4696,376,408,274,277,6031
E02001682,Ryton,Gateshead,North East,1483,5060,492,530,334,543,6959,1500,5323,494,524,363,528,7232
E02001683,Crawcrook & Greenside,Gateshead,North East,1462,5560,532,543,390,567,7592,1470,5725,569,590,445,576,7905
E02001684,"Pelaw, Felling Shore & Bill Quay",Gateshead,North East,1207,4281,333,307,183,331,5435,1328,4542,350,320,184,329,5725
E02001685,Blaydon South,Gateshead,North East,1624,5145,316,405,279,407,6552,1578,5298,370,384,281,409,6742
E02001686,Blaydon North & Winlaton Mill,Gateshead,North East,939,4047,423,399,386,477,5732,973,4172,442,409,375,524,5922
E02001688,Dunston & Teams,Gateshead,North East,1329,5429,322,269,185,272,6477,1307,5543,307,289,176,258,6573
E02001689,Bensham North,Gateshead,North East,1738,5888,355,327,186,334,7090,1800,6592,363,328,196,354,7833
E02001690,Swalwell,Gateshead,North East,1204,4530,423,405,260,399,6017,1157,4580,442,420,260,426,6128
E02001691,Bensham South & Saltwell,Gateshead,North East,1813,6767,287,232,158,301,7745,1796,7092,336,266,166,237,8097
E02001692,Mount Pleasant & Deckham East,Gateshead,North East,1441,4118,301,234,132,206,4991,1422,4375,260,253,137,203,5228
E02001693,Felling South,Gateshead,North East,1022,3423,323,302,205,369,4622,888,3594,335,313,203,334,4779
E02001694,Dunston Hill,Gateshead,North East,1075,4142,324,356,242,320,5384,1034,4109,362,346,253,349,5419
E02001695,Wardley,Gateshead,North East,980,3750,412,349,232,415,5158,873,3649,417,363,257,347,5033
E02001696,Heworth,Gateshead,North East,1839,5558,540,472,240,504,7314,1773,6029,521,517,285,523,7875
E02001697,Low Fell East,Gateshead,North East,1202,4669,412,415,286,420,6202,1204,4977,439,440,296,470,6622
E02001698,Whickham,Gateshead,North East,1003,3602,504,701,501,700,6008,975,3766,525,692,485,771,6239
E02001699,Windy Nook & Whitehills,Gateshead,North East,1096,4171,400,329,298,403,5601,1074,4238,421,370,264,426,5719
E02001700,Sunniside & Lobley Hill,Gateshead,North East,1777,6194,611,603,408,600,8416,1742,6454,608,688,436,557,8743
E02001701,Low Fell West,Gateshead,North East,947,3683,374,437,349,520,5363,957,3816,390,445,339,518,5508
E02001702,Beacon Lough & Wrekenton,Gateshead,North East,1687,4874,335,355,238,419,6221,1639,5345,358,362,228,403,6696
E02001703,Rowlands Gill & Lockhaugh,Gateshead,North East,855,3074,375,429,313,436,4627,826,3301,369,430,321,456,4877
E02001704,Easedale Gardens,Gateshead,North East,1096,4334,256,344,330,483,5747,1107,4576,294,316,301,526,6013
E02001705,Chopwell & High Spen,Gateshead,North East,1180,4198,457,458,266,410,5789,1110,4306,478,459,294,386,5923
E02001706,Birtley North & Kibblesworth,Gateshead,North East,1623,4718,421,378,303,349,6169,1569,4730,416,391,267,360,6164
E02001707,Birtley South,Gateshead,North East,1356,4805,439,536,380,594,6754,1326,5185,490,507,399,623,7204
E02006841,Gateshead Town,Gateshead,North East,928,7822,261,257,141,203,8684,984,7119,275,265,143,209,8011
E02006842,Gateshead South,Gateshead,North East,1162,3441,207,205,147,338,4338,1132,3634,230,224,164,300,4552
E02002574,Farnworth,Halton,North West,1639,5300,437,512,333,420,7002,1601,5557,442,537,368,428,7332
E02002575,Upton Rocks,Halton,North West,1739,6379,566,439,297,332,8013,1671,6453,556,512,313,374,8208
E02002576,Halton View,Halton,North West,1311,4476,464,405,261,424,6030,1309,4880,467,438,267,388,6440
E02002577,Hough Green,Halton,North West,1658,4588,400,319,275,391,5973,1589,4982,376,368,254,366,6346
E02002578,Victoria Park,Halton,North West,1750,5185,446,365,258,397,6651,1667,5584,427,386,253,356,7006
E02002579,Ditton,Halton,North West,1753,4858,397,361,237,332,6185,1761,5315,431,397,256,364,6763
E02002580,Widnes Riverside,Halton,North West,1719,5304,304,265,183,271,6327,1828,5810,340,281,199,290,6920
E02002581,Hale Bank,Halton,North West,1250,4320,494,514,314,430,6072,1176,4471,463,529,355,488,6306
E02002582,"Sandymoor, Daresbury & Preston Brook",Halton,North West,1690,5658,527,415,206,290,7096,1726,6527,536,501,236,256,8056
E02002583,Halton Castlefield,Halton,North West,1755,4585,397,435,210,217,5844,1801,5151,407,407,245,220,6430
E02002584,Runcorn Halton Road,Halton,North West,1497,4480,403,380,253,390,5906,1456,4932,419,405,258,374,6388
E02002585,Runcorn Town & Westfield,Halton,North West,1911,6914,552,462,326,415,8669,1868,7389,567,497,333,363,9149
E02002586,"Grange, Halton Brook & Hallwood Park",Halton,North West,2340,6086,478,479,279,364,7686,2268,6813,490,492,291,356,8442
E02002587,Norton,Halton,North West,1487,3866,507,336,195,141,5045,1355,4365,488,417,189,158,5617
E02002588,Halton Lea & Brookvale,Halton,North West,1520,4238,559,469,238,228,5732,1459,4771,502,491,243,274,6281
E02002589,Beechwood & Heath,Halton,North West,911,3431,580,573,320,345,5249,930,3697,576,610,352,385,5620
E02002590,Culcheth West & Croft,Warrington,North West,1047,4724,350,395,345,449,6263,1052,5229,367,370,364,467,6797
E02002591,Culcheth East & Hollins Green,Warrington,North West,1122,3675,417,437,312,488,5329,1102,4056,428,404,354,491,5733
E02002592,Winwick & Burtonwood,Warrington,North West,1005,3728,329,420,394,468,5339,1002,4000,331,397,370,505,5603
E02002593,Locking Stumps,Warrington,North West,869,2972,342,341,220,215,4090,847,3356,403,320,242,252,4573
E02002594,Oakwood & Gorse Covert,Warrington,North West,967,3455,341,286,123,130,4335,1000,3953,363,315,159,129,4919
E02002595,Hulme,Warrington,North West,2040,5354,272,235,183,238,6282,1916,5857,314,237,161,245,6814
E02002596,Houghton Green & Fearnhead,Warrington,North West,1222,4800,617,630,370,374,6791,1243,5185,643,643,405,379,7255
E02002597,Blackbrook,Warrington,North West,2275,5668,440,374,268,255,7005,2231,6399,433,412,300,297,7841
E02002598,Kingswood & Whittle Hall,Warrington,North West,2345,6965,347,295,133,187,7927,2457,7424,420,346,166,202,8558
E02002599,Callands & Old Hall,Warrington,North West,2262,7185,573,508,281,356,8903,2189,7765,628,545,345,392,9675
E02002600,Orford,Warrington,North West,1638,5802,438,316,337,418,7311,1748,6709,428,374,325,439,8275
E02002601,Padgate & Paddington,Warrington,North West,1613,5286,436,485,387,547,7141,1614,5923,447,503,433,525,7831
E02002602,Bewsey & Dallam,Warrington,North West,1974,5584,257,209,174,141,6365,2085,6369,265,253,144,159,7190
E02002603,Woolston,Warrington,North West,1123,4004,518,593,294,380,5789,1096,4529,499,565,365,390,6348
E02002604,Great Sankey,Warrington,North West,1202,4297,457,545,419,457,6175,1212,4753,478,502,429,502,6664
E02002605,Hood Manor & Sankey Bridges,Warrington,North West,1751,5632,533,483,288,348,7284,1680,5979,546,528,299,364,7716
E02002606,Fairfield & Howley,Warrington,North West,2214,8381,351,366,237,432,9767,2118,8636,367,365,253,428,10049
E02002607,Central Warrington,Warrington,North West,1976,7732,471,513,417,512,9645,1893,8389,491,521,415,552,10368
E02002608,Penketh & Cuerdley,Warrington,North West,1194,4557,503,593,589,800,7042,1158,4775,468,574,566,848,7231
E02002609,Latchford,Warrington,North West,2182,6366,320,305,228,299,7518,2133,6698,363,322,197,331,7911
E02002610,Lymm,Warrington,North West,2650,7302,695,759,592,711,10059,2538,7928,707,715,632,812,10794
E02002611,Grappenhall,Warrington,North West,1408,4595,408,432,350,589,6374,1368,4980,414,435,351,627,6807
E02002612,Stockton Heath & Hillcliffe,Warrington,North West,1666,5405,482,517,374,686,7464,1615,6005,494,514,416,656,8085
E02002613,"Appleton Thorn, Stretton & Walton",Warrington,North West,1044,4039,383,361,278,350,5411,1158,4746,403,399,315,366,6229
E02002614,Appleton,Warrington,North West,850,3222,424,441,295,384,4766,891,3670,441,462,340,465,5378
E02002615,"Roe Lee, Brownhill & Sunnybower",Blackburn with Darwen,North West,2535,6010,392,497,311,532,7742,2669,6878,422,497,365,577,8739
E02002616,Lammack & Revidge,Blackburn with Darwen,North West,2371,5243,368,324,245,340,6520,2516,6182,382,337,260,367,7528
E02002617,Little Harwood,Blackburn with Darwen,North West,2604,5796,299,206,143,213,6657,2795,7165,347,242,142,201,8097
E02002618,Bastwell,Blackburn with Darwen,North West,1980,4759,301,165,85,200,5510,2204,5646,329,210,108,191,6484
E02002619,Wensley Fold,Blackburn with Darwen,North West,2310,5704,326,232,168,257,6687,2625,6951,345,268,188,296,8048
E02002620,Central Blackburn,Blackburn with Darwen,North West,1988,5959,360,228,160,209,6916,2143,6592,440,272,170,232,7706
E02002621,Audley,Blackburn with Darwen,North West,2362,5520,284,203,113,132,6252,2432,6369,319,246,120,175,7229
E02002622,Shadsworth & Intack,Blackburn with Darwen,North West,3073,6491,394,317,197,242,7641,3227,7597,409,324,198,257,8785
E02002623,"Witton, Mill Hill & Hollin Bank",Blackburn with Darwen,North West,2481,6640,385,348,263,346,7982,2595,7698,400,397,243,331,9069
E02002624,"Beardwood, Pleasington & Livesey",Blackburn with Darwen,North West,1319,4857,480,561,390,613,6901,1429,5321,520,549,442,617,7449
E02002625,Queen's Park & Higher Croft,Blackburn with Darwen,North West,2334,6220,369,344,217,251,7401,2493,7154,416,379,226,270,8445
E02002626,Meadowhead,Blackburn with Darwen,North West,1482,4187,387,417,254,394,5639,1565,4862,406,422,265,407,6362
E02002627,Ewood & Fernhurst,Blackburn with Darwen,North West,1665,5072,277,299,165,209,6022,1554,5230,309,290,198,189,6216
E02002628,North Darwen,Blackburn with Darwen,North West,1248,4142,362,379,239,306,5428,1258,4729,380,385,256,319,6069
E02002629,East Darwen,Blackburn with Darwen,North West,1237,3588,285,222,184,196,4475,1275,4091,311,217,170,209,4998
E02002630,Darwen Town,Blackburn with Darwen,North West,1294,4021,312,259,189,278,5059,1211,4369,285,276,178,321,5429
E02002631,South Darwen & Whitehall,Blackburn with Darwen,North West,1344,5295,520,562,328,359,7064,1449,5921,513,623,345,379,7781
E02002632,"Tockholes, Edgworth & Hoddlesden",Blackburn with Darwen,North West,960,3831,442,451,244,245,5213,960,3979,486,450,328,296,5539
E02002633,Little Bispham & Anchorsholme,Blackpool,North West,1238,4141,506,620,481,725,6473,1107,4498,507,616,517,725,6863
E02002634,Churchtown,Blackpool,North West,1245,4543,504,610,424,628,6709,1190,5030,532,638,467,699,7366
E02002635,Norbreck & Bispham,Blackpool,North West,1208,4484,527,590,451,683,6735,1155,4708,547,622,469,706,7052
E02002636,Warbreck & Bispham Road,Blackpool,North West,1643,5050,421,472,328,375,6646,1473,5311,470,458,330,407,6976
E02002637,Hoohill,Blackpool,North West,1147,3587,317,334,263,398,4899,1151,4105,335,335,308,370,5453
E02002638,North Shore,Blackpool,North West,917,4036,324,288,175,258,5081,1053,5170,364,351,224,290,6399
E02002639,Little Layton & Little Carleton,Blackpool,North West,1492,3791,248,275,150,154,4618,1469,4262,285,268,145,180,5140
E02002640,North East Centre,Blackpool,North West,1749,4288,257,228,158,197,5128,1802,5221,327,258,167,214,6187
E02002641,Queenstown & Layton,Blackpool,North West,1481,5138,422,349,254,444,6607,1403,5643,412,416,291,418,7180
E02002642,Central Blackpool,Blackpool,North West,1216,4809,323,328,164,279,5903,1504,6101,383,301,226,281,7292
E02002643,Park Road,Blackpool,North West,1755,4775,327,304,186,239,5831,1815,5810,361,324,204,267,6966
E02002644,Stanley Park & Great Marton,Blackpool,North West,1404,4728,372,422,310,428,6260,1385,5201,442,420,308,449,6820
E02002645,South Promenade & Seasiders Way,Blackpool,North West,1038,4121,315,295,134,144,5009,1241,5155,388,304,174,173,6194
E02002646,Little Marton & Marton Moss Side,Blackpool,North West,1278,3964,434,441,299,388,5526,1238,4535,435,492,311,431,6204
E02002647,Victoria,Blackpool,North West,1705,4908,354,369,282,319,6232,1717,5607,404,403,261,333,7008
E02002648,Hawes Side,Blackpool,North West,1579,4281,376,360,269,315,5601,1532,4591,384,388,277,322,5962
E02002649,South Shore,Blackpool,North West,1480,4891,440,454,351,517,6653,1433,5686,449,491,402,574,7602
E02002650,Common Edge,Blackpool,North West,1306,4650,522,598,430,577,6777,1303,5187,574,603,454,621,7439
E02002651,Squires Gate,Blackpool,North West,1350,4535,409,520,402,661,6527,1283,4957,468,516,457,647,7045
E02003811,Cranage & Goostrey,Cheshire East,North West,1130,3771,508,552,359,445,5635,1270,4319,503,527,422,483,6254
E02003812,Holmes Chapel,Cheshire East,North West,1091,3270,404,525,351,562,5112,1163,3800,365,524,393,548,5630
E02003813,Middlewich West,Cheshire East,North West,858,3603,456,412,299,485,5255,816,3737,463,431,332,431,5394
E02003814,Middlewich East,Cheshire East,North West,1743,5118,408,324,205,219,6274,1731,5761,421,390,233,261,7066
E02003815,Buglawton,Cheshire East,North West,1583,4139,379,388,290,429,5625,1608,4699,371,386,287,393,6136
E02003816,Congleton Town,Cheshire East,North West,1193,4254,445,488,331,452,5970,1158,4564,419,502,376,442,6303
E02003817,Congleton West Heath,Cheshire East,North West,1155,3688,521,527,388,606,5730,1230,4331,513,606,426,572,6448
E02003818,"Hightown, Mossley & Timbersbrook",Cheshire East,North West,791,3009,446,444,324,366,4589,824,3363,455,493,372,456,5139
E02003819,Sandbach North,Cheshire East,North West,959,3360,428,539,402,500,5229,1001,3939,435,548,432,540,5894
E02003820,Sandbach Ettiley Heath & Wheelock,Cheshire East,North West,1931,5905,418,356,271,270,7220,2005,6512,380,370,273,323,7858
E02003821,Sandbach Heath,Cheshire East,North West,768,3149,362,399,337,401,4648,846,3509,404,389,327,449,5078
E02003822,"Scholar Green, Rode Heath & Brereton",Cheshire East,North West,1679,6205,786,896,622,698,9207,1750,6908,804,896,657,721,9986
E02003823,Alsager East,Cheshire East,North West,1097,3452,434,540,424,588,5438,1145,3924,412,522,455,606,5919
E02003824,Alsager West,Cheshire East,North West,1076,3227,353,414,276,334,4604,1213,3829,341,425,304,370,5269
E02003825,Crewe Leighton,Cheshire East,North West,1229,4333,305,230,128,122,5118,1145,4455,313,271,149,134,5322
E02003826,Crewe North East,Cheshire East,North West,1915,4973,334,343,229,326,6205,1995,5705,387,351,247,300,6990
E02003827,Crewe Coppenhall & Underwood,Cheshire East,North West,2241,6040,381,377,289,380,7467,2184,6773,395,367,314,388,8237
E02003828,Crewe North West,Cheshire East,North West,1665,4025,295,313,241,341,5215,1655,4576,262,310,199,258,5605
E02003829,Crewe Sydney & Gateway,Cheshire East,North West,779,3382,400,407,333,386,4908,704,3576,370,413,351,412,5122
E02003830,Crewe Town & Victoria Avenue,Cheshire East,North West,1747,5408,306,243,199,283,6439,1759,5990,331,257,186,313,7077
E02003831,Haslington & Weston,Cheshire East,North West,1628,5816,614,631,451,567,8079,1619,6204,606,664,490,587,8551
E02003832,Crewe Mill Street & College,Cheshire East,North West,1229,4667,209,184,98,167,5325,1211,5247,237,196,126,173,5979
E02003833,Wistaston Green,Cheshire East,North West,1145,3772,315,316,245,301,4949,1233,4256,325,309,262,302,5454
E02003834,Crewe Gresty Road,Cheshire East,North West,1413,4773,267,244,170,256,5710,1343,5243,244,244,153,233,6117
E02003835,Crewe South West & Wistaston,Cheshire East,North West,1124,4305,573,675,469,652,6674,1181,4800,596,631,535,734,7296
E02003836,Nantwich North East,Cheshire East,North West,972,3922,473,571,362,708,6036,1010,4059,477,553,377,741,6207
E02003837,Nantwich South East & Wybunbury,Cheshire East,North West,2857,8999,674,705,442,567,11387,2894,9994,732,813,535,590,12664
E02003838,Willaston & Shavington,Cheshire East,North West,1286,4018,446,479,331,434,5708,1442,4812,438,512,387,441,6590
E02003839,Nantwich South West,Cheshire East,North West,1133,3821,456,512,422,654,5865,1054,4155,430,533,443,663,6224
E02003840,"Audlem, Bunbury & Wrenbury",Cheshire East,North West,1592,5943,870,805,548,794,8960,1646,6614,906,861,598,847,9826
E02003853,Disley & Lyme Park,Cheshire East,North West,992,3430,391,452,294,543,5110,994,3874,415,467,341,440,5537
E02003854,Poynton West,Cheshire East,North West,1155,3390,487,511,315,437,5140,1143,3882,435,512,363,470,5662
E02003855,Poynton East,Cheshire East,North West,1067,3280,511,568,416,601,5376,1033,3618,451,573,487,671,5800
E02003856,Handforth & Dean Row,Cheshire East,North West,2052,6664,534,565,418,636,8817,2115,7515,525,582,433,634,9689
E02003857,Lacey Green & Wilmslow Park,Cheshire East,North West,1344,4036,372,376,189,286,5259,1441,4661,362,427,207,288,5945
E02003858,Wilmslow Town,Cheshire East,North West,1212,4078,405,438,264,613,5798,1285,4893,406,458,327,607,6691
E02003859,"Mobberley, Plumley & High Legh",Cheshire East,North West,1864,6789,829,880,665,940,10103,2002,7388,793,885,656,940,10662
E02003860,Fulshaw Park & Lindow,Cheshire East,North West,1569,4057,360,443,290,511,5661,1611,4717,374,447,311,522,6371
E02003861,Knutsford North,Cheshire East,North West,1257,3633,338,376,321,455,5123,1232,4040,332,354,323,476,5525
E02003862,Prestbury & Adlington,Cheshire East,North West,740,2601,405,463,331,575,4375,745,3049,421,419,393,550,4832
E02003863,South Knutsford & Bexton,Cheshire East,North West,1312,3636,427,429,370,541,5403,1304,4097,406,451,366,591,5911
E02003864,Alderley Edge & Chelford,Cheshire East,North West,1285,4690,537,539,397,830,6993,1321,5367,560,601,435,772,7735
E02003865,Bollington,Cheshire East,North West,1421,4694,476,544,343,437,6494,1438,5248,514,536,372,477,7147
E02003866,Macclesfield Tytherington,Cheshire East,North West,1030,3513,363,425,287,352,4940,1046,3969,391,427,312,406,5505
E02003867,Macclesfield Upton Priory & Greenside,Cheshire East,North West,1551,4503,383,438,254,400,5978,1530,4892,427,412,307,412,6450
E02003868,Macclesfield East & Hurdsfield,Cheshire East,North West,1491,5171,461,416,280,470,6798,1475,5630,446,480,309,469,7334
E02003869,Macclesfield Bollinbrook,Cheshire East,North West,1194,4207,399,457,328,552,5943,1155,4557,420,464,381,535,6357
E02003870,Central Macclesfield,Cheshire East,North West,1647,6950,457,463,296,505,8671,1613,7626,496,472,300,477,9371
E02003871,Macclesfield Weston,Cheshire East,North West,1284,3961,420,386,298,412,5477,1336,4496,393,434,294,393,6010
E02003872,Gawsworth & Macclesfield Forest,Cheshire East,North West,1354,5381,719,778,573,790,8241,1379,5926,743,792,629,808,8898
E02003873,Macclesfield South & Lyme Green,Cheshire East,North West,1248,3783,275,290,177,268,4793,1197,4126,272,279,166,266,5109
E02003794,"Elton, Mickle Trafford & Great Barrow",Cheshire West and Chester,North West,1589,5043,541,613,393,427,7017,1578,5456,541,628,430,429,7484
E02003795,"Capenhurst, Saughall & Moston",Cheshire West and Chester,North West,1044,3233,381,404,266,449,4733,1055,3828,397,422,307,459,5413
E02003796,Upton East,Cheshire West and Chester,North West,1410,4049,415,418,363,610,5855,1413,4648,448,426,362,666,6550
E02003797,Upton West & Heath,Cheshire West and Chester,North West,1845,6245,498,530,381,760,8414,1716,6724,523,530,368,673,8818
E02003798,Blacon North,Cheshire West and Chester,North West,1370,3721,282,283,212,205,4703,1456,4341,305,292,213,241,5392
E02003799,Blacon South,Cheshire West and Chester,North West,1503,4324,341,339,252,354,5610,1559,4885,365,344,259,392,6245
E02003800,"Kelsall, Tarvin & Ashton Hayes",Cheshire West and Chester,North West,1256,3706,452,530,363,537,5588,1264,4039,432,523,439,538,5971
E02003801,Vicars Cross & Hoole East,Cheshire West and Chester,North West,1382,3995,388,367,266,441,5457,1416,4680,390,396,283,470,6219
E02003802,Chester Boughton West & Hoole,Cheshire West and Chester,North West,924,6414,410,382,252,452,7910,865,6765,429,385,263,419,8261
E02003803,Chester City & Garden Quarter,Cheshire West and Chester,North West,637,8073,331,303,230,358,9295,601,8514,342,340,246,400,9842
E02003804,Chester Boughton East,Cheshire West and Chester,North West,1090,4266,306,305,207,383,5467,1156,4798,347,335,229,387,6096
E02003805,"Christleton, Guilden Sutton & Waverton",Cheshire West and Chester,North West,1056,3527,440,444,370,459,5240,1059,3803,426,436,384,512,5561
E02003806,Boughton Heath & Huntington,Cheshire West and Chester,North West,1649,4532,427,365,300,491,6115,1672,5055,452,386,313,524,6730
E02003807,Chester Handbridge Park,Cheshire West and Chester,North West,1211,4534,507,633,439,683,6796,1261,5353,515,630,547,657,7702
E02003808,Lache,Cheshire West and Chester,North West,1360,4129,337,277,160,189,5092,1354,4533,312,292,164,201,5502
E02003809,"Dodleston, Tattenhall & Duddon",Cheshire West and Chester,North West,1373,4521,536,590,403,588,6638,1277,4812,537,566,440,642,6997
E02003810,"Churton, Farndon & Malpas",Cheshire West and Chester,North West,1660,5051,656,634,487,606,7434,1703,5884,643,693,472,661,8353
E02003841,Neston & Parkgate,Cheshire West and Chester,North West,1254,4457,544,612,452,632,6697,1235,4651,597,638,471,660,7017
E02003842,"Hooton, Willaston & Ness",Cheshire West and Chester,North West,749,2890,446,491,314,467,4608,735,3234,441,519,379,530,5103
E02003843,Little Sutton North & Overpool,Cheshire West and Chester,North West,1066,3626,378,329,252,374,4959,1045,4127,407,359,251,438,5582
E02003844,Little Neston,Cheshire West and Chester,North West,918,3643,516,541,385,473,5558,974,3991,493,557,396,522,5959
E02003845,Ellesmere Port Town & Rossmore,Cheshire West and Chester,North West,2100,6290,401,287,200,394,7572,2372,7477,401,305,209,355,8747
E02003846,Little Sutton East,Cheshire West and Chester,North West,1638,4123,258,249,228,304,5162,1637,4716,281,251,196,321,5765
E02003847,Little Sutton West,Cheshire West and Chester,North West,1493,5970,567,635,335,466,7973,1532,6447,625,581,395,497,8545
E02003848,Ellesmere Port Pooltown Road,Cheshire West and Chester,North West,991,3082,251,224,167,290,4014,1055,3587,231,235,179,302,4534
E02003849,Wolverham & Stanlow,Cheshire West and Chester,North West,1801,4822,312,306,208,240,5888,1906,5572,305,309,238,255,6679
E02003850,Great Sutton,Cheshire West and Chester,North West,854,2977,378,354,219,268,4196,869,3311,317,361,228,320,4537
E02003851,Whitby & Stanney Woods,Cheshire West and Chester,North West,912,3337,347,363,251,341,4639,927,3774,331,398,266,371,5140
E02003852,Ellesmere Port South,Cheshire West and Chester,North West,1016,3812,440,395,315,421,5383,993,4157,465,433,327,463,5845
E02003874,Frodsham,Cheshire West and Chester,North West,1566,5180,551,689,485,700,7605,1568,5725,591,662,503,714,8195
E02003875,"Comberbach, Acton Bridge & Whitley",Cheshire West and Chester,North West,866,3564,512,536,370,408,5390,856,3796,506,556,409,434,5701
E02003876,Barnton,Cheshire West and Chester,North West,1082,3216,361,372,227,237,4413,1150,3575,348,407,252,234,4816
E02003877,Helsby & Kingsley,Cheshire West and Chester,North West,1415,5336,648,729,448,715,7876,1425,5934,656,729,548,729,8596
E02003878,Lostock & Wincham,Cheshire West and Chester,North West,1504,5149,590,587,353,568,7247,1506,5590,619,630,393,566,7798
E02003879,Northwich Central & Winnington,Cheshire West and Chester,North West,1861,5656,284,317,189,363,6809,1868,6048,318,296,202,365,7229
E02003880,Weaverham,Cheshire West and Chester,North West,1151,3576,440,430,283,347,5076,1140,3907,413,445,321,386,5472
E02003881,Greenbank,Cheshire West and Chester,North West,1069,3827,334,299,161,183,4804,1049,4089,361,333,182,187,5152
E02003882,Rudheath West & Leftwich,Cheshire West and Chester,North West,1790,5839,515,461,266,421,7502,1880,6472,535,481,309,426,8223
E02003883,Hartford & Kingsmead,Cheshire West and Chester,North West,2006,6576,553,600,395,570,8694,1925,7159,597,620,437,595,9408
E02003884,Sandiway,Cheshire West and Chester,North West,1545,4494,643,674,456,675,6942,1455,4959,597,675,506,681,7418
E02003885,Davenham & Moulton,Cheshire West and Chester,North West,1106,3437,413,397,261,374,4882,1115,3840,386,459,310,371,5366
E02003886,Wharton,Cheshire West and Chester,North West,1371,4117,314,283,186,243,5143,1403,4580,296,288,201,287,5652
E02003887,Winsford North,Cheshire West and Chester,North West,1233,4091,360,369,234,205,5259,1297,4571,368,362,261,232,5794
E02003888,Winsford Central,Cheshire West and Chester,North West,1169,4001,275,298,212,314,5100,1215,4502,289,309,213,331,5644
E02003889,Winsford Over,Cheshire West and Chester,North West,1473,3433,233,269,237,255,4427,1521,4038,276,256,258,286,5114
E02003890,Winsford Glebe Green,Cheshire West and Chester,North West,1285,4041,336,306,265,255,5203,1380,4572,377,330,265,249,5793
E02003891,Tarporley & Eddisbury Hill,Cheshire West and Chester,North West,1056,3255,436,476,386,434,4987,1065,3743,474,530,390,492,5629
E02003965,Wigton & Silloth,Allerdale,North West,1692,6372,784,786,606,847,9395,1695,6626,786,847,618,868,9745
E02003966,"Boltons, Warnell & Solway Coast",Allerdale,North West,962,4056,539,594,379,476,6044,976,4303,595,620,390,499,6407
E02003967,Aspatria & Abbeytown,Allerdale,North West,1418,4915,581,584,367,513,6960,1386,4944,571,614,388,512,7029
E02003968,"Maryport, Dearham & Crosby",Allerdale,North West,1428,5336,664,645,440,598,7683,1389,5452,587,628,465,546,7678
E02003969,"Flimby, Ellenborough & Broughton Moor",Allerdale,North West,1380,4018,370,353,258,335,5334,1367,4207,339,391,258,352,5547
E02003970,West Cockermouth & Great Broughton,Allerdale,North West,1216,4808,619,580,353,543,6903,1216,4893,610,601,384,545,7033
E02003971,East Cockermouth & Buttermere,Allerdale,North West,1170,4466,628,584,428,591,6697,1083,4680,618,633,416,613,6960
E02003972,Workington North & Seaton,Allerdale,North West,1586,5479,505,546,421,542,7493,1514,5644,502,590,370,541,7647
E02003973,Workington West,Allerdale,North West,1716,5442,480,407,286,389,7004,1682,5664,495,450,288,380,7277
E02003974,Workington East,Allerdale,North West,1421,4618,450,485,352,479,6384,1484,4623,439,479,351,448,6340
E02003975,"Harrington, Stainburn & Great Clifton",Allerdale,North West,1221,4162,475,467,327,514,5945,1227,4334,462,493,354,509,6152
E02003976,Keswick & Derwent Valley,Allerdale,North West,842,3883,427,515,404,638,5867,796,4108,435,486,365,623,6017
E02003977,Askam & Dalton North,Barrow-in-Furness,North West,1022,3878,398,373,245,313,5207,946,3985,386,384,262,335,5352
E02003978,Dalton South,Barrow-in-Furness,North West,901,3345,316,371,298,325,4655,879,3712,353,336,274,396,5071
E02003979,Hawcoat & Furness Abbey,Barrow-in-Furness,North West,1052,4090,522,651,472,743,6478,1080,4379,539,657,523,759,6857
E02003980,Orsmgill & Hindpool,Barrow-in-Furness,North West,1309,4029,375,309,239,226,5178,1391,4423,387,339,234,262,5645
E02003981,Parkside,Barrow-in-Furness,North West,1146,4188,326,332,265,335,5446,1041,4448,333,342,249,336,5708
E02003982,Roose,Barrow-in-Furness,North West,1461,4448,482,489,376,373,6168,1558,4978,453,522,406,435,6794
E02003983,Abbotsmead & Salthouse,Barrow-in-Furness,North West,1492,4731,345,373,241,319,6009,1498,5049,382,366,223,273,6293
E02003984,Barrow Central,Barrow-in-Furness,North West,1263,4191,323,292,206,318,5330,1330,4449,315,296,197,259,5516
E02003985,Walney Island North,Barrow-in-Furness,North West,1118,3997,449,444,351,382,5623,1079,4104,408,482,363,400,5757
E02003986,Walney Island South & Barrow Island,Barrow-in-Furness,North West,1010,3781,393,431,278,298,5181,967,3946,372,407,308,306,5339
E02003987,Longtown & Border,Carlisle,North West,888,3491,457,411,290,376,5025,830,3239,366,368,227,335,4535
E02003988,Brampton & Irthing,Carlisle,North West,1055,3811,467,494,348,476,5596,922,3891,508,514,340,499,5752
E02003989,Carlisle Belah,Carlisle,North West,1232,4021,469,467,407,496,5860,1234,4454,484,515,414,590,6457
E02003990,"Kingmoor, Houghton & Whiteclosegate",Carlisle,North West,1886,5950,662,662,452,770,8496,1926,6398,670,702,465,776,9011
E02003991,Belle Vue & Burgh,Carlisle,North West,1182,4328,561,549,395,492,6325,1133,4433,573,569,439,521,6535
E02003992,Central Carlisle,Carlisle,North West,1102,5648,439,350,244,423,7104,1009,5793,419,384,259,387,7242
E02003993,"Wetheral, Corby & Geltsdale",Carlisle,North West,1341,4925,730,708,466,621,7450,1270,5078,724,749,497,627,7675
E02003994,Longsowerby & Caldewgate,Carlisle,North West,1267,4531,329,318,272,519,5969,1245,4783,322,350,234,462,6151
E02003995,Raffles & Morton,Carlisle,North West,2013,5972,473,498,372,500,7815,2163,6442,491,500,362,555,8350
E02003996,Denton Holme & Harraby Green,Carlisle,North West,1564,6618,410,336,239,336,7939,1467,6763,417,379,220,307,8086
E02003997,Botcherby & Harraby,Carlisle,North West,2213,5742,482,399,276,407,7306,2269,6393,481,425,274,383,7956
E02003998,Currock & Upperby,Carlisle,North West,1542,4032,320,350,252,321,5275,1438,4123,324,321,240,338,5346
E02003999,Garlands & Dalston,Carlisle,North West,2055,6451,745,725,511,746,9178,2075,7128,741,774,579,735,9957
E02004000,Parton & Distington,Copeland,North West,837,3141,347,315,208,351,4362,858,3174,324,350,227,320,4395
E02004001,Whitehaven Harbour & Corkickle,Copeland,North West,738,3326,338,319,232,341,4556,688,3459,322,334,230,337,4682
E02004002,"Hensingham, Hillcrest & Aikbank",Copeland,North West,1701,6055,593,593,413,606,8260,1567,6114,593,629,439,602,8377
E02004003,"Cleator Moor, Frizington & Ennerdale",Copeland,North West,1885,7302,696,677,482,578,9735,1863,7493,750,728,493,590,10054
E02004004,"Mirehouse, Kells & Woodhouse",Copeland,North West,2134,5941,537,474,284,463,7699,2093,6231,556,517,309,504,8117
E02004005,Egremont & Moor Row,Copeland,North West,1342,4704,490,464,371,397,6426,1329,4839,495,467,373,431,6605
E02004006,"Thornhill, Gosforth & Seascale",Copeland,North West,1286,4991,671,626,480,635,7403,1214,4936,683,651,471,628,7369
E02004007,Millom & Duddon Valley,Copeland,North West,1558,5740,682,750,500,589,8261,1540,5952,688,729,518,636,8523
E02004008,"Langwathby, Kirkoswald & Alston Moor",Eden,North West,886,3717,548,507,283,366,5421,920,3787,550,534,315,345,5531
E02004009,"Hesket, Lazonby & Skelton",Eden,North West,930,3704,441,441,277,380,5243,881,3627,469,423,312,395,5226
E02004010,Penrith Central & West,Eden,North West,1321,4667,362,367,258,540,6194,1221,4887,326,387,280,495,6375
E02004011,Penrith Outer,Eden,North West,1555,5766,732,745,590,876,8709,1606,6433,724,791,590,871,9409
E02004012,"Askham, Ullswater & Greystoke",Eden,North West,741,3141,464,422,326,413,4766,699,3260,403,439,314,416,4832
E02004013,"Appleby, Shap & Kirkby Thore",Eden,North West,1503,5539,810,803,495,699,8346,1469,5827,766,782,544,703,8622
E02004014,"Kirkby Stephen, Tebay & Brough",Eden,North West,1110,4320,630,586,431,561,6528,1084,4372,611,616,455,574,6628
E02004015,"Windermere North, Ambleside & Langdales",South Lakeland,North West,722,3792,434,444,385,638,5693,657,4530,438,392,376,561,6297
E02004016,Windermere South & Staveley,South Lakeland,North West,1270,4826,511,620,430,603,6990,1133,5619,509,539,446,544,7657
E02004017,Kendal North & Burneside,South Lakeland,North West,1488,5331,528,519,363,592,7333,1448,5780,528,567,372,588,7835
E02004018,Kendal Town & Greenside,South Lakeland,North West,1478,5323,453,458,278,457,6969,1418,5644,469,456,284,408,7261
E02004019,Kendal East & Whinfell,South Lakeland,North West,1123,4485,598,685,422,593,6783,990,4612,571,652,466,642,6943
E02004020,Kendal South,South Lakeland,North West,1480,5027,548,558,422,722,7277,1381,5349,528,620,413,654,7564
E02004021,Hawkshead & Cartmel Fell,South Lakeland,North West,649,2995,428,515,337,418,4693,598,3192,406,482,372,393,4845
E02004022,"Coniston, Broughton & Kirkby",South Lakeland,North West,719,3114,500,486,337,349,4786,725,3288,465,485,315,362,4915
E02004023,Sedbergh & Kirkby Lonsdale,South Lakeland,North West,1013,3270,522,493,353,546,5184,1081,3652,461,525,368,540,5546
E02004024,"Burton-in-Kendal, Levens & Natland",South Lakeland,North West,1128,3965,608,640,425,646,6284,1106,4332,541,642,500,653,6668
E02004025,"Arnside, Milnthorpe & Holme",South Lakeland,North West,1197,4177,652,749,516,721,6815,1123,4414,616,727,556,763,7076
E02004026,Ulverston,South Lakeland,North West,1278,4960,505,502,337,553,6857,1254,5186,464,517,347,469,6983
E02004027,Grange-over-Sands & Cartmel Peninsula,South Lakeland,North West,880,4085,702,842,639,1007,7275,845,4284,711,799,662,986,7442
E02004028,Swarthmoor & Low Furness,South Lakeland,North West,1147,4230,586,706,454,601,6577,1083,4462,575,676,513,658,6884
E02005176,Harle Syke & Lanehead,Burnley,North West,1792,5148,496,546,326,454,6970,1826,5808,489,534,407,407,7645
E02005177,Queensgate,Burnley,North West,1342,3425,293,277,196,411,4602,1463,4122,306,317,204,377,5326
E02005178,Central Burnley & Daneshouse,Burnley,North West,3150,6338,276,196,125,230,7165,3423,8059,319,232,158,215,8983
E02005179,Padiham,Burnley,North West,1810,5453,477,467,349,406,7152,1927,5957,494,473,329,421,7674
E02005180,Habergham & Ightenhill,Burnley,North West,1178,3914,447,462,248,452,5523,1153,4288,474,492,316,438,6008
E02005181,Whittlefield & Rose Grove,Burnley,North West,1303,3883,336,312,218,279,5028,1368,4335,331,329,236,261,5492
E02005182,Bank Hall & Fulledge,Burnley,North West,1259,3696,281,276,216,297,4766,1329,4196,275,300,222,279,5272
E02005183,Brunshaw & Brownside,Burnley,North West,1043,3447,356,442,273,369,4887,1017,3816,364,391,283,360,5214
E02005184,"Cliviger, Worsthorne & Lane Bottom",Burnley,North West,727,2835,419,462,313,266,4295,668,3045,395,463,329,308,4540
E02005185,Barclay Hills & Trinity,Burnley,North West,2110,5625,368,364,227,274,6858,2300,6495,405,365,230,276,7771
E02005186,Hapton & Lowerhouse,Burnley,North West,965,3734,358,392,217,218,4919,1040,4038,353,396,221,265,5273
E02006881,Rose Hill & Burnley Wood,Burnley,North West,2032,6042,517,602,393,490,8044,2173,6877,587,585,428,476,8953
E02005189,Clayton Brook,Chorley,North West,1102,3520,281,279,171,240,4491,1108,3603,291,274,202,252,4622
E02005190,Brindle & Withnell,Chorley,North West,975,3768,440,419,256,279,5162,887,3904,406,465,314,359,5448
E02005191,Clayton-le-Woods,Chorley,North West,1765,5634,568,621,356,396,7575,1786,6003,596,634,404,432,8069
E02005192,Whittle-le-Woods & Anglezarke,Chorley,North West,1689,5961,422,401,244,276,7304,1708,5914,439,420,275,321,7369
E02005193,Euxton,Chorley,North West,1430,4839,604,663,415,422,6943,1469,5298,579,656,466,481,7480
E02005194,Chorley North,Chorley,North West,1413,4720,475,478,373,477,6523,1364,5252,481,458,371,478,7040
E02005195,Croston & Mawdesley,Chorley,North West,1065,5366,479,493,291,378,7007,1059,5102,439,500,323,408,6772
E02005196,Chorley West,Chorley,North West,2278,6259,549,663,439,585,8495,2366,6561,573,665,456,621,8876
E02005197,Chorley East,Chorley,North West,1474,4709,326,347,235,265,5882,1452,4912,343,339,245,278,6117
E02005198,Chorley Town & South,Chorley,North West,1929,6236,427,494,340,421,7918,1873,6345,394,510,371,446,8066
E02005199,Eccleston & Charnock Richard,Chorley,North West,1211,4449,526,615,420,435,6445,1199,4650,507,608,458,500,6723
E02005200,Chorley South West,Chorley,North West,2168,6076,384,308,195,308,7271,1998,6031,380,362,203,288,7264
E02005201,Coppull,Chorley,North West,1546,5143,515,430,359,377,6824,1487,5259,462,466,377,434,6998
E02005202,Adlington & Rivington,Chorley,North West,1778,6113,647,703,493,597,8553,1710,6235,607,689,512,616,8659
E02005203,"Elswick, Singleton & Weeton",Fylde,North West,1396,4520,583,582,413,458,6556,1495,5913,621,640,483,512,8169
E02005204,Kirkham & Wesham,Fylde,North West,2179,7387,675,718,514,545,9839,2240,8007,688,795,523,613,10626
E02005205,Clifton & Newton-with-Scales,Fylde,North West,1136,4255,414,485,311,324,5789,1014,4237,398,465,344,328,5772
E02005206,St Annes North & Airport,Fylde,North West,1328,4129,511,519,360,501,6020,1199,4304,537,505,380,507,6233
E02005207,Heyhouses & Park,Fylde,North West,1284,4504,664,754,498,789,7209,1206,4781,652,746,582,819,7580
E02005208,St Annes Town,Fylde,North West,1324,5785,672,758,538,1108,8861,1249,6389,681,757,594,1092,9513
E02005209,Warton & Freckleton,Fylde,North West,1335,4891,588,645,425,532,7081,1328,5162,635,641,517,588,7543
E02005210,Ansdell & Fairhaven,Fylde,North West,1339,5290,815,902,713,1278,8998,1313,5512,811,891,738,1271,9223
E02005211,Lytham,Fylde,North West,1252,5164,607,732,515,836,7854,1067,5112,594,692,623,837,7858
E02005212,Great Harwood,Hyndburn,North West,2079,6601,618,645,473,574,8911,2056,6951,599,647,462,628,9287
E02005213,Clayton-le-Moors & Huncoat,Hyndburn,North West,2255,7011,599,611,352,512,9085,2331,7575,653,663,392,502,9785
E02005214,Rishton,Hyndburn,North West,1181,3932,349,378,279,305,5243,1188,4404,369,385,301,310,5769
E02005215,Accrington North East,Hyndburn,North West,2509,7507,609,634,439,674,9863,2491,8142,612,621,446,580,10401
E02005216,Church,Hyndburn,North West,1220,3308,232,313,164,176,4193,1162,3604,264,285,202,200,4555
E02005217,Accrington West,Hyndburn,North West,3871,7608,367,329,240,328,8872,4022,8960,389,335,263,351,10298
E02005218,Oswaldtwistle,Hyndburn,North West,1426,4427,351,442,270,381,5871,1394,4747,349,418,308,406,6228
E02005219,Accrington South East,Hyndburn,North West,1461,5213,477,513,343,391,6937,1461,5655,493,514,351,398,7411
E02005220,Broadfield & Knuzden,Hyndburn,North West,868,3580,422,463,353,380,5198,885,3644,428,457,336,390,5255
E02005221,"Carnforth, Silverdale & Warton",Lancaster,North West,1559,5540,732,750,563,742,8327,1531,5846,774,808,566,764,8758
E02005222,Kellet & Lune Valley,Lancaster,North West,1004,3481,469,531,367,468,5316,873,3701,479,552,398,501,5631
E02005223,Hest Bank & Bolton-le-Sands,Lancaster,North West,1051,3806,550,624,433,676,6089,1033,4187,593,651,480,664,6575
E02005224,Bare,Lancaster,North West,665,2496,389,470,430,789,4574,603,2593,397,459,447,790,4686
E02005225,Halton & Caton,Lancaster,North West,1020,3147,385,430,280,404,4646,1009,3477,400,439,305,429,5050
E02005226,Morecambe Town,Lancaster,North West,1661,4790,417,357,265,388,6217,1610,5250,418,381,276,421,6746
E02005228,Morecambe South West,Lancaster,North West,1249,3547,320,294,230,361,4752,1172,3804,328,325,187,293,4937
E02005229,Morecambe West End,Lancaster,North West,1193,3815,262,266,139,193,4675,1186,4244,281,234,165,188,5112
E02005230,Morecambe Westgate,Lancaster,North West,1310,3750,452,480,318,408,5408,1355,4255,451,493,379,450,6028
E02005231,Skerton & Vale,Lancaster,North West,1623,5356,379,366,192,252,6545,1716,5798,411,374,201,285,7069
E02005233,Lancaster East,Lancaster,North West,1415,5214,323,270,161,224,6192,1622,5940,356,306,188,213,7003
E02005234,Lancaster Central,Lancaster,North West,941,7376,263,172,129,231,8171,933,7144,243,230,151,226,7994
E02005235,Moorlands & Greaves,Lancaster,North West,672,4822,130,145,89,173,5359,571,4074,139,130,88,140,4571
E02005236,Heysham & Overton,Lancaster,North West,2826,8083,767,835,593,680,10958,2719,8575,826,885,699,767,11752
E02005237,"Marsh, Haverbreaks & Scotforth West",Lancaster,North West,1931,7102,484,499,299,508,8892,1928,7356,493,492,325,479,9145
E02005238,Scotforth East & Bowerham,Lancaster,North West,1098,3657,265,290,211,335,4758,1070,3844,321,283,186,349,4983
E02005239,"University, Galgate & Dolphinholme",Lancaster,North West,1085,9335,424,446,278,351,10834,1176,16243,430,452,290,406,17821
E02006871,Scale Hall & Torrisholme,Lancaster,North West,2273,7039,699,694,545,772,9749,2294,7712,741,712,569,772,10506
E02005240,Barnoldswick North,Pendle,North West,1014,3250,339,278,211,272,4350,1140,3610,298,332,243,332,4815
E02005241,Barnoldswick South,Pendle,North West,914,3383,348,375,227,283,4616,960,3624,366,391,221,266,4868
E02005242,Earby & Salterforth,Pendle,North West,1129,3611,409,417,255,347,5039,1079,3834,400,448,280,323,5285
E02005243,Colne Horsfield,Pendle,North West,878,2969,297,300,167,322,4055,928,3254,306,346,190,285,4381
E02005244,Colne Vivary Bridge,Pendle,North West,1369,3540,320,293,179,270,4602,1308,3837,285,318,171,300,4911
E02005245,"East Colne, Foulridge & Trawden",Pendle,North West,1026,4179,491,460,325,373,5828,1121,4329,444,476,360,360,5969
E02005246,Colne Waterside,Pendle,North West,985,3293,290,269,161,210,4223,1074,3668,282,262,171,237,4620
E02005247,"Barrowford, Higham & Pendleside",Pendle,North West,1501,5587,700,769,490,624,8170,1571,5868,706,799,562,646,8581
E02005248,Nelson Bradley,Pendle,North West,1844,4264,254,225,150,190,5083,2131,5259,324,235,153,210,6181
E02005249,Nelson East,Pendle,North West,2632,6438,372,346,234,289,7679,2879,7412,435,357,237,290,8731
E02005250,Nelson West,Pendle,North West,2390,5253,264,208,143,254,6122,2782,6486,324,244,138,256,7448
E02005251,Marsden,Pendle,North West,1617,4085,403,410,272,418,5588,1769,4546,346,405,269,397,5963
E02005252,Brierfield & Reedley,Pendle,North West,2187,5564,498,463,342,404,7271,2557,6830,488,491,376,442,8627
E02005253,Grimsargh & Goosnargh,Preston,North West,1239,3745,370,430,274,361,5180,1289,4383,395,453,308,399,5938
E02005254,Broughton & Wychnor,Preston,North West,1529,4227,415,441,312,387,5782,1942,5594,491,501,362,448,7396
E02005255,Fulwood,Preston,North West,1702,5092,481,536,416,627,7152,1855,5973,510,543,442,649,8117
E02005256,Longsands,Preston,North West,1200,4258,317,268,196,374,5413,1227,4658,336,306,237,419,5956
E02005257,Ingol,Preston,North West,1266,3555,348,311,200,342,4756,1188,3667,307,321,210,319,4824
E02005258,Cadley & College,Preston,North West,1512,4568,457,456,358,527,6366,1620,5394,440,478,378,618,7308
E02005259,Brookfield & Holme Slack,Preston,North West,2448,6082,459,399,291,493,7724,2550,7066,489,443,298,504,8800
E02005260,Haslam Park,Preston,North West,1245,3797,387,360,320,490,5354,1179,4383,365,399,314,476,5937
E02005261,Ribbleton,Preston,North West,2819,6222,416,291,176,297,7402,2828,7376,452,365,209,307,8709
E02005262,Lea & Marina,Preston,North West,1231,4420,277,245,149,192,5283,1340,4857,320,284,187,220,5868
E02005263,Moor Park,Preston,North West,1549,5003,193,137,120,140,5593,1597,5832,228,154,111,176,6501
E02005264,Plungington & University,Preston,North West,2006,9505,336,287,200,244,10572,2047,10528,398,289,202,233,11650
E02005265,Ashton-on-Ribble & Larches,Preston,North West,2259,6643,499,416,327,520,8405,2280,7602,536,459,341,495,9433
E02005266,St Matthew's,Preston,North West,2239,5700,259,183,134,179,6455,2420,7343,280,208,115,171,8117
E02005267,St George's,Preston,North West,1173,5532,178,133,82,119,6044,1240,6618,171,127,72,119,7107
E02005268,Frenchwood & Fishwick,Preston,North West,2493,5785,330,245,195,285,6840,2547,7109,370,266,203,285,8233
E02005269,Preston Town Centre,Preston,North West,1382,8610,323,239,137,213,9522,1646,9896,351,263,143,230,10883
E02005270,"Waddington, Gisburn & Slaidburn",Ribble Valley,North West,1069,4332,517,570,359,438,6216,1174,4773,568,553,425,492,6811
E02005271,Clitheroe North,Ribble Valley,North West,1385,4706,446,476,329,582,6539,1339,5018,428,495,361,574,6876
E02005272,Clitheroe South,Ribble Valley,North West,1663,5256,478,484,295,553,7066,1667,5628,453,550,331,536,7498
E02005273,"Longridge North, Ribchester & Chipping",Ribble Valley,North West,925,3534,365,412,268,388,4967,848,3613,422,379,315,395,5124
E02005274,"Read, Sabden & Chatburn",Ribble Valley,North West,1267,4469,430,591,346,429,6265,1261,4886,464,561,387,465,6763
E02005275,Longridge South,Ribble Valley,North West,1148,3359,348,328,231,393,4659,1005,3587,378,376,272,364,4977
E02005276,Whalley & Brockhall,Ribble Valley,North West,1572,5603,575,522,370,476,7546,1483,5846,537,553,416,538,7890
E02005277,Wilpshire & Mellor,Ribble Valley,North West,1284,4879,567,686,522,663,7317,1282,5336,617,643,554,710,7860
E02005278,"Crawshawbooth, Reedsholme & Water",Rossendale,North West,1460,5044,533,489,223,270,6559,1415,5253,528,486,262,310,6839
E02005279,Haslingden,Rossendale,North West,2253,6504,470,464,311,480,8229,2189,6895,475,499,320,431,8620
E02005280,Bacup,Rossendale,North West,2354,6836,583,501,313,413,8646,2446,7266,604,550,343,370,9133
E02005281,Rawtenstall,Rossendale,North West,1840,5599,459,403,288,391,7140,1843,5919,448,424,303,392,7486
E02005284,Helmshore,Rossendale,North West,1113,3556,408,439,260,370,5033,1043,3686,395,445,314,411,5251
E02005285,Townsend Fold & Edenfield,Rossendale,North West,1090,3837,411,432,240,416,5336,1054,3976,374,465,314,361,5490
E02005286,Whitworth,Rossendale,North West,1452,4906,456,446,295,330,6433,1385,5107,448,454,318,386,6713
E02006884,Waterfoot & Stacksteads,Rossendale,North West,2460,7785,704,688,431,476,10084,2394,8058,695,708,474,537,10472
E02005287,Penwortham North,South Ribble,North West,1010,3122,329,335,204,361,4351,941,3414,318,344,247,366,4689
E02005288,Gregson Lane & Coupe Green,South Ribble,North West,920,3568,410,440,365,430,5213,883,3584,423,405,348,359,5119
E02005289,Penwortham South,South Ribble,North West,855,3490,423,441,317,405,5076,922,3670,410,472,327,426,5305
E02005290,Walton-le-Dale,South Ribble,North West,1304,4679,365,379,214,296,5933,1142,4629,379,394,256,319,5977
E02005291,Lower Penwortham North,South Ribble,North West,1033,3506,312,321,226,241,4606,1035,3757,307,349,231,296,4940
E02005292,Lower Penwortham South,South Ribble,North West,1201,3417,323,333,192,369,4634,1145,3589,321,355,209,313,4787
E02005293,Bamber Bridge West,South Ribble,North West,948,3196,304,348,278,379,4505,941,3289,310,336,240,414,4589
E02005294,Bamber Bridge East,South Ribble,North West,1381,4302,303,297,212,317,5431,1472,4728,306,321,233,301,5889
E02005295,Lostock Hall,South Ribble,North West,1325,4605,410,367,297,373,6052,1290,4811,437,405,307,400,6360
E02005296,New Longton & Hutton,South Ribble,North West,960,3290,403,493,344,489,5019,1029,3636,393,504,348,476,5357
E02005297,Longton & Walmer Bridge,South Ribble,North West,1302,4716,590,651,451,632,7040,1255,5030,549,642,492,658,7371
E02005298,Farington,South Ribble,North West,1365,4696,489,473,259,367,6284,1453,5014,462,470,300,367,6613
E02005299,Leyland North,South Ribble,North West,1603,5049,298,284,209,251,6091,1484,5258,347,327,232,274,6438
E02005300,Moss Side,South Ribble,North West,951,3173,348,316,184,144,4165,901,3263,364,329,194,185,4335
E02005301,Leyland South West,South Ribble,North West,1152,3835,367,350,286,399,5237,1043,3963,373,357,287,397,5377
E02005302,Leyland South East & Buckshaw Village,South Ribble,North West,1510,4403,423,466,321,392,6005,1530,4930,428,484,337,410,6589
E02005303,Seven Stars,South Ribble,North West,1354,3766,374,324,220,288,4972,1324,4010,347,337,224,306,5224
E02005304,Hesketh Bank & Tarleton,West Lancashire,North West,1437,5040,581,664,421,531,7237,1445,5438,570,695,521,549,7773
E02005305,Rufford & Banks,West Lancashire,North West,1136,4312,584,634,426,495,6451,1130,4749,674,656,471,527,7077
E02005306,"Scarisbrick, Halsall & Haskayne",West Lancashire,North West,1027,4214,573,608,381,485,6261,1031,4501,599,611,404,541,6656
E02005307,Burscough,West Lancashire,North West,1713,5498,515,595,401,584,7593,1686,6020,531,614,440,538,8143
E02005308,"Parbold, Appley Bridge & Wrightington",West Lancashire,North West,1056,3777,446,531,411,490,5655,992,4022,429,529,434,498,5912
E02005309,Ormskirk North & West,West Lancashire,North West,1351,4953,466,501,432,618,6970,1391,5321,509,550,419,632,7431
E02005310,Ormskirk Town & East,West Lancashire,North West,970,6577,389,412,339,599,8316,913,5478,366,453,357,552,7206
E02005311,Bickerstaffe & Newburgh,West Lancashire,North West,751,4260,388,411,330,421,5810,708,3928,423,422,327,420,5520
E02005312,Skelmersdale Ashurst,West Lancashire,North West,957,3711,413,363,181,286,4954,974,4080,416,402,222,280,5400
E02005313,Skelmersdale Central,West Lancashire,North West,2167,5523,330,320,203,248,6624,2105,6165,387,326,237,271,7386
E02005314,Skelmersdale West,West Lancashire,North West,1151,4034,328,320,256,316,5254,1134,4208,340,317,265,336,5466
E02005315,Aughton,West Lancashire,North West,1327,4277,510,606,506,790,6689,1290,4815,506,603,518,808,7250
E02005316,Skelmersdale East,West Lancashire,North West,1635,4069,272,262,169,232,5004,1537,4466,270,260,206,213,5415
E02005317,Skelmersdale South East,West Lancashire,North West,1808,4482,293,286,179,203,5443,1811,5009,299,292,197,160,5957
E02005318,Upholland,West Lancashire,North West,1271,4509,464,417,358,540,6288,1232,4764,465,469,340,523,6561
E02005319,Fleetwood Town,Wyre,North West,1342,5007,478,439,343,411,6678,1483,5734,507,440,328,436,7445
E02005320,Fleetwood Warren,Wyre,North West,1136,3444,369,322,264,433,4832,1108,3505,332,325,268,437,4867
E02005321,Fleetwood Rossall & Chatsworth,Wyre,North West,1109,3353,406,494,397,512,5162,1115,3512,455,440,383,497,5287
E02005322,"Preesall, Stalmine & Hambleton",Wyre,North West,1386,5293,868,1008,757,999,8925,1363,5543,867,1078,778,980,9246
E02005323,Fleetwood South East,Wyre,North West,1572,4424,455,445,297,316,5937,1564,4819,446,470,305,349,6389
E02005324,"Bonds, Bilsborrow & Wyresdale",Wyre,North West,1039,4134,458,447,327,466,5832,1056,4188,426,453,312,467,5846
E02005325,Garstang & Catterall,Wyre,North West,1349,4892,723,850,631,889,7985,1345,5125,756,874,704,961,8420
E02005326,Cleveleys West,Wyre,North West,1141,4629,646,693,536,879,7383,1077,4923,626,717,526,807,7599
E02005327,"Pilling, Great Eccleston & Inskip",Wyre,North West,1026,3678,483,497,368,412,5438,1019,3922,471,516,376,410,5695
E02005328,Cleveleys East,Wyre,North West,953,4233,620,654,502,652,6661,988,4326,602,671,513,678,6790
E02005329,Thornton West,Wyre,North West,1763,5793,485,541,422,574,7815,1770,5912,475,531,387,606,7911
E02005330,Thornton East & Carleton West,Wyre,North West,1433,5146,640,757,518,658,7719,1247,5023,641,756,565,676,7661
E02005331,Poulton North & Carleton East,Wyre,North West,1157,4480,548,592,426,731,6777,1252,4800,552,617,446,755,7170
E02005332,Poulton South,Wyre,North West,1263,4785,633,611,495,754,7278,1261,5178,602,648,508,727,7663
E02000984,Dunscar & Egerton,Bolton,North West,1316,4542,476,528,316,332,6194,1338,4928,467,564,385,355,6699
E02000985,Bromley Cross & Bradshaw,Bolton,North West,1150,4078,482,572,417,556,6105,1201,4496,467,585,433,595,6576
E02000986,Eagley & Sharples,Bolton,North West,1513,5284,414,426,355,514,6993,1535,5419,420,463,358,536,7196
E02000987,Horwich North,Bolton,North West,1134,4558,371,424,293,425,6071,1170,5086,384,422,336,401,6629
E02000988,Astley Bridge & Waters Meeting,Bolton,North West,1917,5606,431,333,257,354,6981,2078,6319,411,361,260,391,7742
E02000989,Harwood,Bolton,North West,1268,4391,550,676,567,675,6859,1287,4885,527,676,567,772,7427
E02000990,Horwich South & Middlebrook,Bolton,North West,1432,4899,463,468,296,339,6465,1489,5561,460,531,342,343,7237
E02000991,Smithills,Bolton,North West,1487,4781,391,378,256,357,6163,1690,5351,398,386,290,354,6779
E02000992,Blackrod & Butterwick Fields,Bolton,North West,1081,3549,336,396,288,396,4965,1123,3923,350,391,331,410,5405
E02000993,Hall I' th' Wood,Bolton,North West,2148,5195,304,244,131,229,6103,2354,5871,314,277,151,189,6802
E02000994,Halliwell & Brownlow Fold,Bolton,North West,2149,5298,347,280,188,205,6318,2523,6407,349,285,184,210,7435
E02000995,Doffcocker & Moss Bank,Bolton,North West,1826,4720,425,429,310,489,6373,1823,5288,421,492,312,531,7044
E02000996,Breightmet North,Bolton,North West,2240,5043,328,326,194,372,6263,2268,5682,332,343,229,357,6943
E02000997,Horwich East,Bolton,North West,1086,3680,363,376,267,343,5029,1186,4142,396,366,297,400,5601
E02000998,Gilnow & Victory,Bolton,North West,2414,6093,342,263,208,246,7152,2893,7557,388,312,195,263,8715
E02000999,Central Bolton,Bolton,North West,1696,5421,291,273,191,286,6462,1869,6384,349,271,187,245,7436
E02001000,Tonge,Bolton,North West,1796,5793,473,439,304,501,7510,1922,6726,471,451,330,485,8463
E02001001,Heaton & Deane,Bolton,North West,2116,5565,383,285,198,353,6784,2221,6139,373,311,236,346,7405
E02001002,Breightmet South & Darcy Lever,Bolton,North West,2148,5775,531,572,295,382,7555,2133,6276,532,609,363,378,8158
E02001003,Lostock & Ladybridge,Bolton,North West,1340,4126,462,512,387,528,6015,1411,4565,456,558,404,541,6524
E02001004,Rumworth North,Bolton,North West,2479,5314,293,229,173,200,6209,2631,6818,316,237,164,230,7765
E02001005,Burnden & Great Lever,Bolton,North West,2346,5704,314,221,171,258,6668,2752,6954,373,278,160,290,8055
E02001006,Rumworth South,Bolton,North West,2312,5172,267,224,172,202,6037,2532,6318,277,233,160,208,7196
E02001007,Little Lever,Bolton,North West,1710,5751,707,852,459,454,8223,1757,6261,663,848,577,480,8829
E02001008,Lever Edge,Bolton,North West,2669,5249,268,202,167,258,6144,2985,6414,305,240,192,358,7509
E02001009,Daubhill & Fernhill Gate,Bolton,North West,1769,4379,311,352,256,324,5622,1981,5135,338,329,271,320,6393
E02001010,Farnworth North,Bolton,North West,1525,4022,245,158,100,149,4674,1727,4632,278,218,140,247,5515
E02001011,Westhoughton East,Bolton,North West,1676,6061,539,589,368,462,8019,1625,6125,622,632,430,484,8293
E02001012,Harper Green,Bolton,North West,2176,5134,327,319,251,229,6260,2359,5887,341,313,237,269,7047
E02001013,Over Hulton,Bolton,North West,1091,3649,315,367,356,369,5056,1116,3865,345,332,345,411,5298
E02001014,Westhoughton West,Bolton,North West,1455,5040,436,445,298,355,6574,1565,5621,470,453,316,373,7233
E02001015,Farnworth South,Bolton,North West,1507,5115,432,425,366,478,6816,1555,5536,402,446,311,362,7057
E02001016,Highfield & New Bury,Bolton,North West,2148,5301,315,343,202,234,6395,2332,6054,318,347,193,231,7143
E02001017,Kearsley & Stoneclough,Bolton,North West,2140,6859,497,555,380,424,8715,2157,7132,531,577,402,424,9066
E02001018,Westhoughton Daisy Hill,Bolton,North West,1427,4894,412,381,186,218,6091,1415,5268,463,416,219,222,6588
E02001019,Ramsbottom,Bury,North West,1714,5602,480,478,321,374,7255,1584,5912,497,521,369,446,7745
E02001020,Summerseat,Bury,North West,953,3024,451,552,348,482,4857,971,3362,399,570,405,511,5247
E02001021,Nuttall & Tottington,Bury,North West,1254,4600,435,460,314,421,6230,1152,4917,453,466,334,422,6592
E02001022,Walmersley & Limefield,Bury,North West,1399,4693,438,492,350,521,6494,1476,5120,451,505,356,502,6934
E02001023,Higher Woodhill,Bury,North West,1088,3349,373,422,256,223,4623,1188,3715,359,424,274,266,5038
E02001024,Walshaw & Woolfold,Bury,North West,1516,5010,479,495,312,373,6669,1431,5265,462,517,348,388,6980
E02001025,Fairfield & Jericho,Bury,North West,1910,4907,346,330,206,335,6124,1849,5485,369,367,231,330,6782
E02001026,Fernhill & Pimhole,Bury,North West,2619,6996,347,307,172,284,8106,2975,8343,393,339,216,245,9536
E02001027,Whitehead Park,Bury,North West,1558,4822,283,290,183,276,5854,1561,5011,297,313,187,307,6115
E02001028,Elton Vale,Bury,North West,1112,3806,533,640,526,615,6120,1125,4251,527,631,539,666,6614
E02001029,Buckley Wells & Fishpool,Bury,North West,1650,4953,309,281,156,251,5950,1840,5571,333,311,182,265,6662
E02001030,Ainsworth & Bradley Fold,Bury,North West,1027,3716,330,338,211,232,4827,1000,4125,383,364,232,245,5349
E02001031,Redvales & Hollins,Bury,North West,1285,4171,320,350,248,253,5342,1421,4595,340,350,265,317,5867
E02001032,Black Lane,Bury,North West,1466,4640,410,448,324,415,6237,1476,4994,416,450,350,351,6561
E02001033,Bank Top & Radcliffe Ees,Bury,North West,1275,3948,232,236,153,188,4757,1301,4277,246,269,141,193,5126
E02001034,Radcliffe,Bury,North West,1756,5497,324,348,238,308,6715,1877,5904,370,367,251,368,7260
E02001035,Unsworth,Bury,North West,1237,3986,381,419,404,494,5684,1264,4604,417,462,382,528,6393
E02001036,Outwood Gate,Bury,North West,1724,4849,375,340,201,238,6003,1694,5048,345,392,213,244,6242
E02001037,Whitefield West & Park Lane,Bury,North West,1208,3985,463,463,336,538,5785,1266,4429,477,506,377,556,6345
E02001038,Whitefield East,Bury,North West,1026,3732,265,263,209,314,4783,1009,3900,283,284,193,301,4961
E02001039,Besses,Bury,North West,1930,5416,295,294,239,310,6554,2045,6012,309,305,221,326,7173
E02001040,Kirkhams & Holyrood,Bury,North West,1129,3791,354,332,238,315,5030,1156,4256,338,337,271,332,5534
E02001041,Prestwich East,Bury,North West,1367,5075,342,309,198,411,6335,1441,5654,358,340,237,398,6987
E02001042,Prestwich Central,Bury,North West,1198,4006,322,343,222,321,5214,1339,4539,356,344,238,295,5772
E02001043,Prestwich Clough & Rainsough,Bury,North West,1071,3413,248,256,145,340,4402,1103,3905,263,229,184,309,4890
E02001044,Sedgley Park,Bury,North West,3416,5090,347,284,197,234,6152,3402,6010,377,309,201,280,7177
E02001045,Boothroyden & Higher Blackley,Manchester,North West,2007,4905,357,366,238,326,6192,2179,6033,404,402,240,298,7377
E02001046,Blackley,Manchester,North West,2666,6559,351,310,232,296,7748,3078,8423,382,357,241,296,9699
E02001047,Charlestown,Manchester,North West,2352,6239,405,368,268,322,7602,2479,7482,440,423,278,395,9018
E02001048,Crumpsall North & Heaton Park,Manchester,North West,2271,5606,328,315,199,309,6757,2582,6670,338,338,214,325,7885
E02001049,New Moston,Manchester,North West,2059,6020,443,426,304,435,7628,2332,6988,503,466,315,481,8753
E02001050,Hapurhey North,Manchester,North West,2223,5471,273,256,156,184,6340,2684,6639,294,250,156,188,7527
E02001051,Moston West,Manchester,North West,2338,5541,336,286,177,319,6659,2809,7050,367,265,206,257,8145
E02001052,Crumpsall South,Manchester,North West,4110,8801,401,270,201,418,10091,4796,12515,482,319,211,383,13910
E02001053,Hapurhey South & Monsall,Manchester,North West,3152,6928,338,284,200,232,7982,3645,8996,399,321,192,251,10159
E02001055,Newton Heath,Manchester,North West,2329,5575,383,363,227,314,6862,2531,6561,395,371,257,281,7865
E02001056,Clayton Vale,Manchester,North West,2373,4964,294,263,211,212,5944,2683,6606,353,288,189,224,7660
E02001057,New Islington & Miles Platting,Manchester,North West,1711,8858,310,214,130,196,9708,1968,11382,313,261,121,176,12253
E02001059,"Beswick, Eastlands & Openshaw Park",Manchester,North West,3209,7775,316,266,191,210,8758,3505,9465,387,276,209,230,10567
E02001061,Openshaw & Gorton North,Manchester,North West,2649,6131,373,331,222,260,7317,3016,8156,425,350,214,276,9421
E02001062,Ardwick,Manchester,North West,2327,8090,193,156,120,145,8704,2731,11855,245,183,133,192,12608
E02001063,Hulme & University,Manchester,North West,1621,12643,119,97,62,104,13025,1991,13989,141,81,72,95,14378
E02001064,Belle Vue & West Gorton,Manchester,North West,2915,6483,280,228,161,259,7411,3117,8446,358,250,199,312,9565
E02001065,Abbey Hey,Manchester,North West,2675,5951,342,244,208,251,6996,2677,6862,371,277,204,244,7958
E02001066,Victoria Park,Manchester,North West,1940,10509,188,158,107,195,11157,2225,12565,272,198,113,198,13346
E02001067,Gorton South,Manchester,North West,3292,6945,261,234,154,238,7832,3581,8622,333,259,178,208,9600
E02001068,Moss Side West,Manchester,North West,3221,6607,218,144,160,279,7408,3646,9317,286,192,169,301,10265
E02001069,Rusholme West & Moss Side East,Manchester,North West,2747,9289,205,158,130,177,9959,3110,12881,247,186,139,199,13652
E02001070,Rusholme East,Manchester,North West,1632,10615,201,160,144,198,11318,1875,14791,283,203,131,193,15601
E02001071,Levenshulme North,Manchester,North West,4266,9159,331,240,195,253,10178,5259,13259,424,321,189,278,14471
E02001072,Whalley Range North,Manchester,North West,1726,6661,198,152,117,184,7312,1867,8193,313,178,130,214,9028
E02001073,Chorlton North,Manchester,North West,1460,7005,345,285,170,281,8086,1693,7908,405,295,188,344,9140
E02001074,Fallowfield West & Whalley Range South,Manchester,North West,2665,7959,353,242,210,402,9166,2864,9671,413,298,222,426,11030
E02001075,Levenshulme Central,Manchester,North West,2179,5996,196,156,113,131,6592,2329,7691,258,170,124,134,8377
E02001076,Fallowfield Central,Manchester,North West,1018,10524,127,76,81,122,10930,1095,11127,182,134,75,133,11651
E02001077,Chorlton South,Manchester,North West,1232,5087,311,218,125,228,5969,1399,6075,367,265,179,217,7103
E02001078,Levenshulme South & Burnage North,Manchester,North West,2321,6662,405,349,260,403,8079,2509,8076,463,375,290,408,9612
E02001079,Withington North & Old Moat,Manchester,North West,1757,6292,224,191,179,237,7123,1983,7525,291,228,173,239,8456
E02001080,Ladybarn,Manchester,North West,1034,7889,193,205,136,207,8630,1090,8069,252,203,165,218,8907
E02001081,Beech Road & Chorlton Meadows,Manchester,North West,1233,4327,234,183,125,230,5099,1197,4829,273,237,145,189,5673
E02001082,Withington West,Manchester,North West,818,5298,211,126,118,163,5916,864,5815,230,204,112,174,6535
E02001083,West Didsbury,Manchester,North West,1091,6644,157,132,79,101,7113,1216,7208,178,159,100,148,7793
E02001084,Withington East,Manchester,North West,1390,6078,314,199,158,240,6989,1534,6799,331,288,163,275,7856
E02001085,Burnage South,Manchester,North West,2321,5157,275,232,191,196,6051,2385,6610,317,256,192,217,7592
E02001086,Merseybank & Barlow Moor,Manchester,North West,1249,4519,209,194,150,274,5346,1379,5779,253,229,180,288,6729
E02001087,Didsbury Village,Manchester,North West,1649,6394,441,373,243,357,7808,1737,7477,470,430,315,404,9096
E02001088,Northern Moor,Manchester,North West,2182,5657,375,305,207,333,6877,2222,6439,418,336,185,315,7693
E02001089,East Didsbury,Manchester,North West,1537,5168,344,301,192,343,6348,1728,6340,391,345,222,373,7671
E02001090,Northenden,Manchester,North West,1055,4246,330,338,204,323,5441,1178,4874,401,336,224,325,6160
E02001091,Baguley West & Brooklands,Manchester,North West,1467,5083,399,393,259,364,6498,1594,5742,456,423,312,363,7296
E02001092,Baguley East & Wythenshawe Park,Manchester,North West,1946,5472,335,272,175,298,6552,2095,6495,353,339,198,270,7655
E02001093,Benchill North & Sharston,Manchester,North West,2358,5816,331,311,201,362,7021,2715,7130,378,352,239,312,8411
E02001094,Benchill South & Wythenshawe Central,Manchester,North West,2721,5927,329,296,154,188,6894,3027,7227,376,314,195,191,8303
E02001095,Newall Green,Manchester,North West,1909,5245,351,365,167,235,6363,2138,6684,405,374,210,225,7898
E02001096,Wythenshawe East & Peel Hall,Manchester,North West,1599,4726,409,325,185,293,5938,1720,5663,456,386,201,281,6987
E02001097,Woodhouse Park & Airport,Manchester,North West,1820,5185,383,273,184,237,6262,2046,6439,382,324,185,257,7587
E02006902,City Centre North & Collyhurst,Manchester,North West,557,6556,112,61,37,32,6798,646,6946,109,72,43,47,7217
E02006912,Piccadilly & Ancoats,Manchester,North West,366,17303,122,68,67,131,17691,238,14262,121,108,62,126,14679
E02006913,Cheetham Hill,Manchester,North West,1324,5656,133,104,91,96,6080,1682,7175,160,137,95,120,7687
E02006914,University North & Whitworth Street,Manchester,North West,398,10270,46,20,17,62,10415,435,9317,52,30,24,28,9451
E02006915,Strangeways,Manchester,North West,2379,6603,173,157,79,94,7106,2790,8248,274,171,118,119,8930
E02006916,Hulme Park & St George's,Manchester,North West,587,5762,89,60,41,57,6009,745,6187,111,81,45,63,6487
E02006917,Castlefield & Deansgate,Manchester,North West,338,6815,119,27,24,24,7009,226,5184,69,47,30,15,5345
E02001098,Shaw & Crompton,Oldham,North West,975,3200,386,534,391,365,4876,987,3559,390,512,401,417,5279
E02001099,Wood End,Oldham,North West,1057,3692,317,344,225,281,4859,1026,3828,325,317,238,263,4971
E02001100,Clough & Shaw Side,Oldham,North West,951,3472,371,419,277,466,5005,990,3774,380,415,337,398,5304
E02001101,Royton North,Oldham,North West,934,3216,390,461,261,268,4596,961,3593,401,455,319,295,5063
E02001102,Royton East & Cowlishaw,Oldham,North West,1056,3883,302,313,215,243,4956,1177,3997,313,340,204,219,5073
E02001103,"Diggle, Delph & Denshaw",Oldham,North West,784,3237,393,420,254,355,4659,815,3419,395,413,306,396,4929
E02001104,Moorside & Sholver,Oldham,North West,1616,4565,318,314,183,173,5553,1666,4965,308,336,188,220,6017
E02001105,Royton South West,Oldham,North West,955,3567,368,429,308,392,5064,988,3643,349,431,329,359,5111
E02001106,Royton South East,Oldham,North West,950,3514,326,337,268,373,4818,993,3896,304,367,295,388,5250
E02001107,Chadderton North,Oldham,North West,1525,3901,279,294,231,259,4964,1740,4473,291,288,224,290,5566
E02001108,Derker,Oldham,North West,1630,3566,179,184,139,175,4243,1652,3916,191,193,124,191,4615
E02001109,Waterhead,Oldham,North West,1555,4892,386,315,219,298,6110,1607,5242,392,364,209,277,6484
E02001110,"New Delph, Dobcross & Austerlands",Oldham,North West,1006,3848,417,506,300,386,5457,1019,3967,431,489,337,382,5606
E02001111,Oldham Town North,Oldham,North West,2060,4719,238,188,170,260,5575,2372,6141,294,224,154,227,7040
E02001112,Middleton Junction,Oldham,North West,961,3494,420,369,214,258,4755,993,3745,446,442,242,260,5135
E02001113,Busk,Oldham,North West,2814,6031,223,132,127,166,6679,2837,6856,230,159,124,196,7565
E02001114,Chadderton Central,Oldham,North West,1964,5333,368,431,275,425,6832,2022,5767,399,399,345,407,7317
E02001115,Lees & Hey,Oldham,North West,1060,3615,330,333,250,260,4788,1107,3838,337,311,254,280,5020
E02001116,Salem,Oldham,North West,2465,4583,240,181,84,201,5289,2629,5296,265,204,116,169,6050
E02001117,Greenfield & Uppermill,Oldham,North West,1034,3600,405,426,283,383,5097,1023,3751,414,465,328,398,5356
E02001118,Springhead & Grasscroft,Oldham,North West,979,3662,350,369,294,376,5051,985,3903,387,397,299,429,5415
E02001119,Alexandra Park,Oldham,North West,3640,7504,306,163,178,282,8433,3896,8621,396,203,150,317,9687
E02001121,Oldham Town South,Oldham,North West,2883,5451,188,148,107,142,6036,2671,5864,232,149,105,157,6507
E02001123,Alt,Oldham,North West,1781,4233,272,277,179,199,5160,1937,4692,284,266,183,223,5648
E02001124,Chadderton South East,Oldham,North West,1577,4066,260,225,184,245,4980,1648,4425,274,242,188,210,5339
E02001125,Chadderton South West,Oldham,North West,1564,5201,395,394,211,374,6575,1647,5350,398,394,249,394,6785
E02001126,Hathershaw,Oldham,North West,2573,5623,281,231,177,225,6537,2662,6292,317,254,176,237,7276
E02001127,Lime Side & Garden Suburb,Oldham,North West,2002,4738,327,263,182,203,5713,2067,5386,348,291,198,202,6425
E02001128,Failsworth East,Oldham,North West,1486,4835,387,346,282,363,6213,1523,5103,391,389,296,323,6502
E02001129,Failsworth West,Oldham,North West,1154,3992,315,249,219,302,5077,1363,4409,299,308,180,290,5486
E02001130,Holt Lane End & Bardsley,Oldham,North West,803,3412,331,291,263,301,4598,886,3792,336,314,248,355,5045
E02001131,Failsworth South,Oldham,North West,969,3112,258,266,289,358,4283,1082,3568,267,275,264,333,4707
E02006860,Werneth,Oldham,North West,4580,9698,439,243,204,352,10936,4995,11512,543,334,205,398,12992
E02001132,Littleborough North & Calderbook,Rochdale,North West,1201,3990,369,368,242,318,5287,1170,4307,384,387,275,332,5685
E02001133,Littleborough West & Wardle,Rochdale,North West,1311,3873,407,421,248,243,5192,1348,4275,416,437,293,231,5652
E02001134,Littleborough South & Smithy Bridge,Rochdale,North West,1082,3834,381,435,285,323,5258,1100,4110,393,440,334,320,5597
E02001135,Hurstead & Smallbridge,Rochdale,North West,2226,4907,291,314,208,257,5977,2355,5618,275,315,239,240,6687
E02001136,"Healey, Syke & Shawclough",Rochdale,North West,1731,5795,519,480,311,441,7546,1867,6210,557,520,361,445,8093
E02001137,Hooley Bridge & Norden West,Rochdale,North West,1042,3817,438,362,213,253,5083,1018,4034,430,393,247,268,5372
E02001138,Norden East & Bagslate Moor,Rochdale,North West,1413,4982,566,552,449,595,7144,1482,5425,559,589,442,589,7604
E02001139,Wardleworth & Newbold Brow,Rochdale,North West,2841,6206,342,194,173,203,7118,3046,7302,386,235,158,232,8313
E02001140,Spotland Bridge,Rochdale,North West,2064,5078,348,262,214,344,6246,2098,5384,334,310,204,343,6575
E02001141,Central Rochdale & Mandale Park,Rochdale,North West,3108,8313,416,300,220,314,9563,3418,9499,466,366,221,319,10871
E02001142,Springfield Park,Rochdale,North West,1021,3233,384,403,291,466,4777,1015,3611,405,426,355,487,5284
E02001143,Kingsway,Rochdale,North West,3179,7392,385,350,219,291,8637,3287,8191,424,344,238,311,9508
E02001144,Milnrow West,Rochdale,North West,1176,4117,356,346,239,254,5312,1175,4228,348,378,249,285,5488
E02001145,Milnrow East & Newhey,Rochdale,North West,1333,4343,412,450,305,300,5810,1284,4633,421,465,337,304,6160
E02001146,Deeplish,Rochdale,North West,2738,6303,280,193,163,311,7250,2844,7338,381,228,173,285,8405
E02001147,Balderstone & Kirkholt,Rochdale,North West,2484,6255,421,336,247,304,7563,2635,6856,417,379,240,307,8199
E02001148,Castleton & Trub,Rochdale,North West,2172,6377,584,593,400,506,8460,2183,6847,555,613,416,518,8949
E02001149,Heywood Town,Rochdale,North West,2232,6560,529,465,307,427,8288,2272,7178,540,532,313,420,8983
E02001150,Heywood Heap Bridge & Darnhill,Rochdale,North West,2013,5549,468,432,261,326,7036,2165,6079,468,445,244,332,7568
E02001151,Heywood Hopwood & Siddal Moor,Rochdale,North West,2030,6268,502,554,344,463,8131,2057,6707,523,550,379,452,8611
E02001152,North Middleton & Stakehill,Rochdale,North West,1853,6074,500,415,276,367,7632,2180,6892,546,452,286,341,8517
E02001153,Langley & Wood Side,Rochdale,North West,2898,7052,482,436,248,406,8624,3264,8314,539,477,275,352,9957
E02001154,Middleton East,Rochdale,North West,1979,6801,459,408,248,360,8276,2106,7081,539,446,257,390,8713
E02001155,Middleton Town & Rhodes,Rochdale,North West,1291,4766,418,329,245,380,6138,1342,4898,400,372,243,348,6261
E02001156,Alkrington,Rochdale,North West,1761,5733,540,541,350,721,7885,1863,6354,583,577,408,686,8608
E02001157,Little Hulton North,Salford,North West,2324,4945,302,292,175,335,6049,2467,5742,314,296,191,302,6845
E02001158,Walkden North West,Salford,North West,1480,3637,316,274,166,286,4679,1412,4168,271,295,168,260,5162
E02001159,Walkden North East,Salford,North West,1600,4321,218,284,146,193,5162,1681,4936,244,259,169,193,5801
E02001160,Little Hulton South,Salford,North West,1923,4219,315,273,184,223,5214,2083,4984,286,302,187,249,6008
E02001161,Clifton,Salford,North West,1013,3823,284,254,232,322,4915,975,4019,320,297,229,344,5209
E02001162,Swinton Newtown,Salford,North West,1029,3767,287,363,272,378,5067,1050,3888,275,388,243,373,5167
E02001163,Walkden South,Salford,North West,1683,5789,519,548,411,538,7805,1806,6403,483,555,423,513,8377
E02001164,Clifton Green & Pendlebury East,Salford,North West,1730,5274,256,208,167,133,6038,1719,6968,252,249,157,168,7794
E02001165,Swinton West,Salford,North West,1217,3763,255,279,198,256,4751,1266,4280,261,266,211,270,5288
E02001166,Broughton Park,Salford,North West,2523,3699,323,254,170,340,4786,2765,4917,314,283,190,313,6017
E02001167,Kersal Dale,Salford,North West,1653,4539,274,274,169,278,5534,1880,5501,293,296,170,252,6512
E02001168,Swinton Worsley Road,Salford,North West,2004,5949,454,453,273,449,7578,2115,6828,497,477,284,432,8518
E02001169,Ellenbrook & Boothstown,Salford,North West,1962,6267,639,619,383,500,8408,2015,7103,634,689,447,513,9386
E02001170,Worsley,Salford,North West,1855,5616,482,610,416,702,7826,1895,6252,469,618,462,713,8514
E02001171,Swinton South East & Pendlebury West,Salford,North West,1106,3592,311,339,235,330,4807,1101,4077,321,354,245,346,5343
E02001172,Higher Broughton,Salford,North West,4751,9450,446,330,274,443,10943,5393,11677,459,372,256,391,13155
E02001173,Cromwell Road & Broad Street,Salford,North West,1628,5609,244,223,168,199,6443,1918,7138,254,237,161,172,7962
E02001174,Lightoaks,Salford,North West,869,3733,276,254,158,286,4707,914,4098,301,281,184,274,5138
E02001175,Winton & Westwood,Salford,North West,1590,4667,307,270,188,250,5682,1608,5323,293,269,196,268,6349
E02001176,Eccles,Salford,North West,1913,7402,555,576,367,654,9554,1970,8263,568,578,421,683,10513
E02001177,Weaste & Seedley,Salford,North West,2506,8816,552,453,355,562,10738,2637,10142,538,497,344,532,12053
E02001178,Salford Central & University,Salford,North West,1278,13289,208,162,97,102,13858,1657,15882,207,182,88,119,16478
E02001179,Langworthy Buile Hill,Salford,North West,1173,4694,254,247,157,240,5592,1293,5617,262,249,171,214,6513
E02001180,Pendleton,Salford,North West,1184,4718,218,163,123,139,5361,1193,5477,216,189,108,151,6141
E02001181,Peel Green,Salford,North West,1384,3946,237,230,132,189,4734,1388,4356,244,212,147,196,5155
E02001182,Barton upon Irwell,Salford,North West,1472,4230,282,202,154,226,5094,1561,5061,246,237,148,229,5921
E02001183,Patricroft,Salford,North West,1438,4568,239,195,149,202,5353,1483,5182,254,212,163,192,6003
E02001184,Ordsall & Salford Quays,Salford,North West,1708,12867,320,255,168,172,13782,2101,13772,318,329,186,179,14784
E02001185,Higher Irlam,Salford,North West,2155,5906,491,499,438,455,7789,2061,6544,475,477,446,545,8487
E02001186,Lower Irlam & Cadishead,Salford,North West,2269,6590,379,437,355,404,8165,2282,7223,391,446,343,416,8819
E02001187,Reddish Vale View,Stockport,North West,1445,4421,352,341,244,279,5637,1381,4932,370,360,283,301,6246
E02001188,North Reddish,Stockport,North West,1961,5623,302,285,197,223,6630,1904,5890,306,316,179,212,6903
E02001189,Central Reddish,Stockport,North West,1492,5332,427,420,284,353,6816,1549,5799,439,424,302,386,7350
E02001190,Brinnington,Stockport,North West,2008,4478,257,216,130,302,5383,2115,5403,283,220,140,258,6304
E02001191,Woodley,Stockport,North West,881,3356,417,388,280,367,4808,917,3670,396,440,273,383,5162
E02001192,Heaton Chapel & Shaw Road,Stockport,North West,1223,4502,290,272,235,482,5781,1142,4829,343,263,209,391,6035
E02001193,South Reddish & Heaton Norris,Stockport,North West,1180,4232,263,247,174,247,5163,1212,4645,251,254,165,242,5557
E02001194,Heaton Moor,Stockport,North West,1304,3868,338,316,233,304,5059,1310,4293,364,345,233,399,5634
E02001195,Bredbury,Stockport,North West,1336,4471,429,383,279,401,5963,1380,4893,415,435,331,402,6476
E02001196,Romiley & Compstall,Stockport,North West,1434,4394,450,536,390,592,6362,1318,4767,477,556,427,621,6848
E02001197,Norris Bank,Stockport,North West,1369,3941,338,288,167,270,5004,1350,4323,367,305,207,270,5472
E02001198,Bredbury Green,Stockport,North West,1454,4284,367,494,389,579,6113,1374,4612,383,448,395,638,6476
E02001199,Heaton Mersey,Stockport,North West,1478,4992,444,392,247,382,6457,1546,5477,445,469,279,394,7064
E02001200,"Central Stockport, Portwood & Shaw Heath",Stockport,North West,1446,5108,324,316,155,232,6135,1502,5519,348,303,169,233,6572
E02001201,Woodbank Park,Stockport,North West,1219,3627,270,252,169,254,4572,1163,3802,274,258,180,262,4776
E02001202,Edgeley,Stockport,North West,1221,4391,217,194,130,159,5091,1271,4667,243,232,139,157,5438
E02001203,Marple Bridge & Mellor,Stockport,North West,1013,3252,412,479,336,406,4885,1048,3634,423,453,359,436,5305
E02001204,Cheadle Heath,Stockport,North West,1965,5941,421,330,185,381,7258,1803,6147,444,377,221,353,7542
E02001205,Heaviley,Stockport,North West,1480,5529,372,334,211,261,6707,1496,5777,374,357,242,302,7052
E02001206,Marple & Rose Hill,Stockport,North West,1324,4078,452,429,332,635,5926,1327,4517,431,482,324,622,6376
E02001207,Offerton East & Bosden Farm,Stockport,North West,1241,4212,446,429,269,380,5736,1205,4432,483,468,286,387,6056
E02001208,Cheadle East,Stockport,North West,1468,4867,365,284,230,358,6104,1379,5056,373,328,242,411,6410
E02001209,Davenport,Stockport,North West,1621,5195,331,283,207,302,6318,1526,5414,344,309,176,270,6513
E02001210,Offerton West,Stockport,North West,1712,4307,336,343,289,418,5693,1640,4859,368,321,295,375,6218
E02001211,Gatley North,Stockport,North West,1283,3787,325,322,215,476,5125,1393,4293,346,349,260,402,5650
E02001212,Adswood,Stockport,North West,1903,4394,238,186,153,195,5166,1840,4881,257,223,135,214,5710
E02001213,Woodsmoor & Mile End,Stockport,North West,1971,6415,505,446,319,481,8166,1858,6715,502,453,346,488,8504
E02001214,Gatley South & Cheadle West,Stockport,North West,1451,4402,448,432,363,558,6203,1488,4979,430,494,381,609,6893
E02001215,Marple & Hawk Green,Stockport,North West,1063,3214,396,483,321,478,4892,1037,3606,411,511,356,491,5375
E02001216,Cheadle Hulme Orrishmere,Stockport,North West,1453,4264,487,453,324,500,6028,1521,4805,460,477,355,515,6612
E02001217,Hazel Grove North,Stockport,North West,1314,4181,294,382,266,474,5597,1275,4469,306,390,266,487,5918
E02001218,Bramhall North West,Stockport,North West,1178,3420,368,370,256,397,4811,1111,3773,391,412,303,462,5341
E02001219,Hazel Grove West,Stockport,North West,939,3034,368,387,304,392,4485,873,3188,363,390,316,420,4677
E02001220,Cheadle Hulme West,Stockport,North West,1168,3346,342,324,243,282,4537,1149,3675,327,335,248,300,4885
E02001221,Hazel Grove East & South,Stockport,North West,1047,3327,346,429,306,441,4849,992,3689,350,396,345,485,5265
E02001222,Heald Green West,Stockport,North West,1216,3639,414,407,296,475,5231,1294,4031,414,439,314,501,5699
E02001223,Bramhall North East,Stockport,North West,1191,3802,383,423,321,535,5464,1177,4297,454,426,366,575,6118
E02001224,High Lane,Stockport,North West,770,3043,400,519,440,622,5024,739,3385,416,539,462,645,5447
E02001225,Cheadle Hulme South East,Stockport,North West,1426,4271,377,462,321,526,5957,1480,4705,416,466,332,514,6433
E02001226,Heald Green East,Stockport,North West,1509,4247,355,354,262,367,5585,1526,4620,380,372,266,421,6059
E02001227,Bramhall West,Stockport,North West,1073,3130,304,439,339,563,4775,1086,3269,335,376,346,531,4857
E02001228,Bramhall South & Woodford,Stockport,North West,1009,3141,334,378,308,527,4688,1101,3805,376,361,324,560,5426
E02001229,Mossley,Tameside,North West,1969,6513,521,546,316,318,8214,1954,6961,570,567,346,346,8790
E02001230,Ashton North,Tameside,North West,1045,3522,349,432,336,293,4932,1107,3873,365,444,342,316,5340
E02001231,Carrbrook & Micklehurst,Tameside,North West,1605,4491,367,402,193,156,5609,1527,4915,377,426,208,200,6126
E02001232,Hurst Cross,Tameside,North West,1885,5254,347,385,251,365,6602,1925,5819,358,403,275,311,7166
E02001233,Ashton Waterloo,Tameside,North West,1637,4725,442,430,290,363,6250,1752,5205,468,469,316,372,6830
E02001234,Smallshaw,Tameside,North West,1823,4828,336,334,212,290,6000,1969,5481,330,362,235,310,6718
E02001235,Ashton East,Tameside,North West,1431,4624,304,286,205,271,5690,1519,5166,328,289,225,256,6264
E02001236,Stalybridge North,Tameside,North West,1320,3682,242,248,176,287,4635,1456,4191,271,263,175,262,5162
E02001237,Stalybridge East & Swineshaw,Tameside,North West,1482,4531,350,321,156,275,5633,1489,4900,317,346,196,257,6016
E02001238,Droylsden East,Tameside,North West,1485,4863,429,438,294,384,6408,1474,5257,449,460,309,403,6878
E02001239,Droylsden Central,Tameside,North West,1974,5993,406,394,296,376,7465,2048,6611,430,391,310,380,8122
E02001240,Droylsden West,Tameside,North West,1181,3846,305,307,230,278,4966,1252,4432,314,322,208,258,5534
E02001241,Ashton Central,Tameside,North West,2628,7090,433,314,197,197,8231,2951,8317,448,364,207,219,9555
E02001242,Audenshaw,Tameside,North West,1269,4214,340,309,241,365,5469,1355,4561,378,338,271,352,5900
E02001243,Stalybridge South,Tameside,North West,1306,4951,499,534,325,394,6703,1295,5355,506,557,396,421,7235
E02001244,Dukinfield East & Hough Hill,Tameside,North West,929,3192,347,418,257,254,4468,955,3456,358,398,296,274,4782
E02001245,Dukinfield West,Tameside,North West,1647,5310,406,352,217,298,6583,1580,5707,400,373,233,289,7002
E02001246,Newtonmoor,Tameside,North West,1467,4467,379,380,261,401,5888,1474,4888,381,410,247,403,6329
E02001247,Guide Bridge,Tameside,North West,1391,4391,325,311,223,301,5551,1458,5015,373,335,229,312,6264
E02001248,Hyde North,Tameside,North West,2662,7308,475,415,274,263,8735,2723,7989,496,482,283,294,9544
E02001249,Denton North,Tameside,North West,1235,3963,291,279,227,291,5051,1232,4390,308,282,229,292,5501
E02001250,Godley,Tameside,North West,1119,4054,384,429,275,273,5415,1064,4291,392,414,304,290,5691
E02001251,"Mottram, Hollingworth & Broadbottom",Tameside,North West,946,3577,429,409,266,306,4987,945,3868,445,436,284,332,5365
E02001252,Dane Bank,Tameside,North West,1224,4410,364,416,337,552,6079,1215,4817,413,441,325,556,6552
E02001253,Denton West,Tameside,North West,880,3057,250,283,195,259,4044,910,3403,287,270,232,261,4453
E02001254,Denton East,Tameside,North West,1028,3474,304,329,252,251,4610,1029,3784,291,359,244,275,4953
E02001255,Hattersley,Tameside,North West,1823,4094,283,274,180,245,5076,2042,5024,287,285,163,253,6012
E02001256,Hyde South,Tameside,North West,2428,6732,366,349,269,440,8156,2380,7288,394,385,308,469,8844
E02001257,Denton South,Tameside,North West,1688,5322,504,527,444,545,7342,1732,5957,512,540,436,594,8039
E02001258,Cheetham Fold & Gee Cross,Tameside,North West,1254,4228,476,457,339,440,5940,1318,4631,431,484,345,500,6391
E02001259,Old Trafford,Trafford,North West,2638,7796,260,181,144,312,8693,2658,9336,343,231,153,323,10386
E02001260,Trafford Park West & Kingsway Park,Trafford,North West,1505,4616,370,455,306,345,6092,1483,5125,394,432,336,376,6663
E02001261,Gorse Hill,Trafford,North West,2010,5713,274,210,149,225,6571,1971,6352,309,252,167,233,7313
E02001262,Firswood,Trafford,North West,1832,5702,295,243,204,371,6815,1970,6633,365,294,199,400,7891
E02001263,Davyhulme,Trafford,North West,1556,4861,467,527,353,541,6749,1564,5362,483,522,428,613,7408
E02001264,Trafford Park East & Sevenways,Trafford,North West,1971,5385,319,269,250,309,6532,1941,5966,364,305,236,322,7193
E02001265,Flixton & Moorside,Trafford,North West,1603,4989,435,425,297,400,6546,1592,5561,461,469,291,413,7195
E02001266,Lostock & Stretford Meadows,Trafford,North West,1393,4449,333,308,201,324,5615,1362,4730,330,349,224,313,5946
E02001267,Urmston East,Trafford,North West,1293,4743,359,342,237,581,6262,1231,4832,364,378,266,496,6336
E02001268,Urmston West,Trafford,North West,1210,4080,448,424,327,488,5767,1235,4535,435,467,343,491,6271
E02001269,Stretford East,Trafford,North West,1699,5385,415,311,197,377,6685,1680,6006,406,363,219,365,7359
E02001270,Sale North,Trafford,North West,1844,5412,326,326,246,388,6698,1826,5748,351,346,260,447,7152
E02001271,Ashton upon Mersey North,Trafford,North West,1335,4018,358,294,218,348,5236,1421,4474,360,321,207,331,5693
E02001272,Sale East,Trafford,North West,1847,4915,436,380,304,495,6530,1663,5182,407,416,319,478,6802
E02001273,Sale Central,Trafford,North West,2024,6542,419,403,299,517,8180,1976,6508,434,421,307,554,8224
E02001274,Ashton upon Mersey South,Trafford,North West,1448,4556,494,537,405,625,6617,1507,5117,506,531,418,629,7201
E02001275,Partington,Trafford,North West,2284,5036,366,297,222,370,6291,2120,5728,403,371,226,340,7068
E02001276,Sale Moor,Trafford,North West,1918,4878,418,357,233,374,6260,1939,5467,387,404,250,359,6867
E02001277,Broadheath & Firsway,Trafford,North West,2454,6209,301,315,235,207,7267,2337,6636,342,309,261,221,7769
E02001278,West Timperley,Trafford,North West,1943,5214,433,454,227,443,6771,1952,5690,430,439,293,420,7272
E02001279,Timperley North,Trafford,North West,1799,5102,438,385,305,463,6693,1778,5534,451,455,318,440,7198
E02001280,Timperley East,Trafford,North West,1866,4964,403,448,284,469,6568,1810,5479,405,453,357,496,7190
E02001281,Timperley South,Trafford,North West,1515,4304,414,463,359,562,6102,1574,4910,416,457,388,581,6752
E02001282,Altrincham East,Trafford,North West,2345,6491,401,343,266,363,7864,2312,7056,414,371,269,359,8469
E02001283,"Altrincham West, Dunham & Warburton",Trafford,North West,1910,5887,428,498,385,655,7853,1966,6438,454,473,413,661,8439
E02001284,Hale,Trafford,North West,2084,5120,335,343,213,356,6367,1917,5565,394,354,251,357,6921
E02001285,Bowdon,Trafford,North West,1574,4593,427,459,366,630,6475,1490,5074,466,478,378,620,7016
E02001286,Hale Barns,Trafford,North West,1772,4539,452,481,400,711,6583,1852,5148,498,485,421,696,7248
E02001287,Standish North,Wigan,North West,1107,3700,318,333,250,287,4888,1109,4105,292,359,289,299,5344
E02001288,Standish South,Wigan,North West,1317,4719,502,553,352,479,6605,1351,5197,505,557,372,503,7134
E02001289,Shevington,Wigan,North West,1635,5867,674,801,507,619,8468,1630,6222,693,766,557,666,8904
E02001290,Aspull & Red Rock,Wigan,North West,989,3793,373,405,280,324,5175,974,3893,344,385,298,408,5328
E02001291,Beech Hill,Wigan,North West,1590,4730,382,393,301,332,6138,1480,5039,401,396,311,351,6498
E02001292,Wigan Marylebone & Bottling Wood,Wigan,North West,1241,5031,458,487,325,517,6818,1263,5418,472,460,379,535,7264
E02001293,New Springs,Wigan,North West,1031,3753,354,416,286,263,5072,1072,3971,329,418,309,319,5346
E02001294,Wigan Central,Wigan,North West,1301,5326,343,315,244,364,6592,1276,5742,336,342,226,396,7042
E02001295,Wigan East,Wigan,North West,1455,5025,401,310,231,315,6282,1309,5082,383,328,219,289,6301
E02001296,Laithwaite & Marsh Green,Wigan,North West,2639,5972,347,338,218,259,7134,2451,5942,343,321,224,254,7084
E02001297,Pemberton North,Wigan,North West,1187,4283,392,373,213,260,5521,1202,4339,381,373,235,261,5589
E02001298,Ince-in-Makerfield,Wigan,North West,1951,5474,359,343,233,305,6714,1885,5678,338,359,241,257,6873
E02001299,Hindley West,Wigan,North West,1617,5758,422,442,360,397,7379,1490,5953,405,435,373,408,7574
E02001300,Pemberton South,Wigan,North West,1523,5120,455,432,359,416,6782,1484,5252,432,444,376,423,6927
E02001301,Wigan South,Wigan,North West,1867,5916,397,356,237,367,7273,1849,5979,387,407,262,368,7403
E02001302,Hindley East,Wigan,North West,1610,4777,430,466,327,389,6389,1591,5134,399,477,362,400,6772
E02001303,Atherton North,Wigan,North West,2022,5735,400,339,218,264,6956,2073,5980,371,373,246,265,7235
E02001304,Orrell & Longshaw,Wigan,North West,2308,7670,714,851,620,761,10616,2234,7812,665,819,620,869,10785
E02001305,Hindley Green,Wigan,North West,1394,4966,520,593,435,339,6853,1403,5155,516,579,446,434,7130
E02001306,Worsley Mesnes & Hawkley,Wigan,North West,1137,4406,461,609,354,315,6145,1177,4550,446,587,395,354,6332
E02001307,Winstanley,Wigan,North West,2253,7130,751,804,435,422,9542,2151,7402,675,808,510,430,9825
E02001308,Atherton South East & Tyldesley West,Wigan,North West,1021,3703,361,361,315,367,5107,938,3730,381,352,308,342,5113
E02001309,Atherton South West,Wigan,North West,1510,5272,436,392,327,379,6806,1455,5336,445,442,333,422,6978
E02001310,Platt Bridge & Spring View,Wigan,North West,2107,5945,453,394,261,263,7316,2072,6174,406,428,291,278,7577
E02001311,Tyldesley North,Wigan,North West,1511,5249,472,498,315,302,6836,1496,5356,491,474,295,337,6953
E02001312,Abram & Bickershaw,Wigan,North West,1680,5496,403,417,221,219,6756,1709,5866,399,392,266,209,7132
E02001313,Leigh North,Wigan,North West,1796,5064,365,406,282,323,6440,1772,5264,400,406,295,295,6660
E02001314,Tyldesley South,Wigan,North West,1761,5352,439,416,208,205,6620,1643,5397,455,420,257,231,6760
E02001315,"Astley, Blackmoor & Mosley Common",Wigan,North West,1578,5009,435,521,373,354,6692,1648,5656,448,529,402,404,7439
E02001316,Leigh Central,Wigan,North West,1179,4650,245,269,153,198,5515,1454,5128,271,269,195,194,6057
E02001317,Leigh East & Higher Folds,Wigan,North West,1593,5426,465,482,315,390,7078,1565,5793,449,490,383,413,7528
E02001318,Ashton-in-Makerfield North,Wigan,North West,1384,4667,523,492,368,438,6488,1326,4905,477,523,396,431,6732
E02001319,Leigh West,Wigan,North West,1478,5070,392,382,255,235,6334,1621,5538,388,408,269,297,6900
E02001320,Leigh South East,Wigan,North West,1308,4890,391,405,308,353,6347,1271,4910,369,415,365,373,6432
E02001321,Ashton-in-Makerfield East,Wigan,North West,1530,5055,467,454,364,368,6708,1448,5263,466,487,381,401,6998
E02001322,Ashton-in-Makerfield West,Wigan,North West,1134,4340,466,505,401,472,6184,1092,4399,444,501,434,502,6280
E02001323,Leigh South,Wigan,North West,1539,4813,433,479,364,341,6430,1369,4963,411,462,386,399,6621
E02001324,Golborne,Wigan,North West,1668,5309,429,438,286,371,6833,1588,5387,410,453,309,377,6936
E02001325,Lowton,Wigan,North West,1343,4837,513,519,349,387,6605,1417,5463,512,550,414,404,7343
E02001326,Lowton Common,Wigan,North West,1468,4694,439,574,364,392,6463,1407,4878,426,534,427,434,6699
E02001327,Kirkby North East,Knowsley,North West,2358,4919,486,309,151,139,6004,2607,6489,547,372,166,131,7705
E02001328,Kirkby North West,Knowsley,North West,1957,6480,565,497,336,388,8266,2008,7261,599,546,337,408,9151
E02001329,Kirkby South East,Knowsley,North West,1447,4896,457,259,166,266,6044,1512,5533,506,291,135,245,6710
E02001330,Kirkby South West & Field Lane,Knowsley,North West,1965,5736,523,345,178,309,7091,1936,6543,591,396,192,305,8027
E02001331,Knowsley Village & Southdene,Knowsley,North West,2080,6230,623,483,263,442,8041,2122,7234,638,538,277,420,9107
E02001332,Stockbridge Village,Knowsley,North West,1541,4711,273,306,256,281,5827,1680,5357,288,275,295,350,6565
E02001333,Prescot,Knowsley,North West,1742,5600,406,383,262,468,7119,1820,6214,460,373,295,416,7758
E02001334,Page Moss & Fincham,Knowsley,North West,1387,3737,222,211,153,207,4530,1562,4785,272,235,163,181,5636
E02001335,Whiston North,Knowsley,North West,1473,5197,384,374,235,380,6570,1508,5658,407,389,230,370,7054
E02001336,Longview & Knowsley Park,Knowsley,North West,1641,4483,329,248,185,376,5621,1685,5163,309,277,164,286,6199
E02001337,Mosscroft & Bakers Green,Knowsley,North West,1207,3809,262,223,160,315,4769,1137,4176,288,243,149,333,5189
E02001338,Huyton Farm,Knowsley,North West,1282,3612,234,250,233,294,4623,1256,4144,264,264,217,309,5198
E02001339,Whiston South,Knowsley,North West,1370,3923,300,288,218,293,5022,1346,4384,296,280,232,286,5478
E02001340,Court Hey & Swanside,Knowsley,North West,1787,5857,497,421,350,547,7672,1816,6413,549,475,326,563,8326
E02001341,Huyton East,Knowsley,North West,1569,4644,361,267,245,385,5902,1568,5275,422,340,224,355,6616
E02001342,Huyton West & Roby,Knowsley,North West,1119,4419,458,420,300,587,6184,1209,5054,499,437,324,653,6967
E02001343,"Halsnead, Cronton & Halewood East",Knowsley,North West,1230,4490,500,411,278,409,6088,1156,4748,492,446,287,357,6330
E02001344,Halewood North,Knowsley,North West,910,3459,285,260,139,346,4489,928,3908,339,294,146,298,4985
E02001345,Halewood Central,Knowsley,North West,854,3417,368,313,218,305,4621,836,3647,395,331,226,318,4917
E02001346,Halewood South,Knowsley,North West,1599,4692,369,276,185,339,5861,1644,5526,421,313,175,322,6757
E02001347,Fazakerley North,Liverpool,North West,1639,5056,339,277,218,331,6221,1662,5677,393,318,210,331,6929
E02001348,Walton Vale,Liverpool,North West,1244,4452,364,259,184,282,5541,1270,4799,391,294,249,285,6018
E02001349,Orrell Park,Liverpool,North West,1458,5047,414,354,206,279,6300,1302,6392,449,381,237,312,7771
E02001350,Croxteth West & Gillmoss,Liverpool,North West,1745,4895,422,308,211,438,6274,1910,5724,463,384,242,433,7246
E02001351,Fazakerley South,Liverpool,North West,1738,5744,400,294,212,300,6950,1895,7770,460,344,219,285,9078
E02001352,Walton North,Liverpool,North West,1400,4820,310,255,196,200,5781,1328,4869,330,275,182,226,5882
E02001353,Croxteth East,Liverpool,North West,1386,4820,386,254,172,283,5915,1276,5131,433,325,191,239,6319
E02001354,Walton East,Liverpool,North West,1605,4777,380,283,203,335,5978,1722,5470,424,347,214,290,6745
E02001355,Walton Hall,Liverpool,North West,1248,4235,351,306,212,288,5392,1333,4737,356,321,211,250,5875
E02001356,Norris Green East,Liverpool,North West,2485,5100,233,228,127,214,5902,2682,6051,265,234,166,172,6888
E02001357,Norris Green West,Liverpool,North West,1737,4229,331,230,179,347,5316,1784,5094,363,270,200,348,6275
E02001358,Walton South,Liverpool,North West,1480,4570,276,259,201,226,5532,1517,5289,313,289,178,227,6296
E02001359,Croxteth Park,Liverpool,North West,889,3389,349,298,192,274,4502,961,3825,415,325,216,285,5066
E02001360,Kirkdale North,Liverpool,North West,1696,5567,476,412,259,288,7002,1896,6627,510,452,254,284,8127
E02001361,Anfield North,Liverpool,North West,1416,4647,411,360,258,325,6001,1490,5364,462,366,262,313,6767
E02001362,Muirhead Avenue,Liverpool,North West,1236,4404,412,338,273,522,5949,1406,5176,477,397,266,491,6807
E02001363,Yewtree,Liverpool,North West,1795,4865,305,301,208,282,5961,1847,5454,354,276,225,299,6608
E02001364,Anfield West,Liverpool,North West,1255,3781,272,234,133,225,4645,1303,4371,277,254,122,226,5250
E02001365,Anfield East,Liverpool,North West,2064,6336,325,291,244,306,7502,2232,7470,398,298,218,339,8723
E02001366,Tuebrook,Liverpool,North West,1652,5964,383,316,280,417,7360,1743,6751,436,360,243,361,8151
E02001367,Sandfield Park & Holly Lodge,Liverpool,North West,1652,5796,546,548,370,585,7845,1624,6189,586,580,390,582,8327
E02001368,Kirkdale South & Vauxhall,Liverpool,North West,1354,4332,396,339,214,343,5624,1457,5431,440,364,246,297,6778
E02001369,Everton West,Liverpool,North West,1249,5597,423,405,251,291,6967,1436,6361,466,440,255,305,7827
E02001370,Everton East,Liverpool,North West,1521,4465,339,334,241,294,5673,1610,5408,393,337,257,279,6674
E02001371,Knotty Ash,Liverpool,North West,1676,4561,302,229,178,277,5547,1734,5344,314,281,194,341,6474
E02001372,Dovecot,Liverpool,North West,924,3754,324,270,216,439,5003,1015,4109,379,338,209,439,5474
E02001373,Fairfield East,Liverpool,North West,1796,6075,413,367,230,306,7391,1763,6709,444,399,217,356,8125
E02001374,Fairfield West & Newsham Park,Liverpool,North West,1573,6997,328,292,180,200,7997,1698,8127,375,292,193,214,9201
E02001375,Stoneycroft,Liverpool,North West,1262,4173,369,338,231,376,5487,1290,4799,404,347,247,369,6166
E02001376,Kensington,Liverpool,North West,1858,6696,297,246,175,225,7639,1951,8365,340,265,175,229,9374
E02001377,Edge Hill,Liverpool,North West,1274,13853,265,271,181,229,14799,1497,16324,323,262,188,266,17363
E02001378,Wavertree East,Liverpool,North West,1367,4995,372,371,228,409,6375,1339,5244,417,419,230,381,6691
E02001380,Broad Green,Liverpool,North West,1386,4614,415,494,263,477,6263,1406,5142,440,458,286,405,6731
E02001381,Wavertree West,Liverpool,North West,2069,6829,321,254,162,240,7806,2393,8071,354,298,188,209,9120
E02001382,Childwall East,Liverpool,North West,1247,4241,392,325,274,313,5545,1334,4774,418,383,275,376,6226
E02001383,"Chinatown, St James & Georgian Quarter",Liverpool,North West,974,8103,229,201,120,196,8849,951,8570,258,251,112,186,9377
E02001384,Wavertree South,Liverpool,North West,1249,9087,254,171,132,235,9879,1429,8603,257,200,124,185,9369
E02001385,Toxteth Park,Liverpool,North West,2923,6312,214,177,152,233,7088,3182,8054,262,187,150,244,8897
E02001386,Belle Vale,Liverpool,North West,1411,4554,487,451,357,459,6308,1534,5563,479,535,361,432,7370
E02001387,Childwall West & Wavertree Green,Liverpool,North West,1377,4730,497,389,244,521,6381,1427,5321,535,492,298,471,7117
E02001388,Wavertree Penny Lane,Liverpool,North West,1358,6250,284,184,133,290,7141,1205,6424,295,250,169,277,7415
E02001389,Princes Park,Liverpool,North West,861,5283,272,187,114,175,6031,1010,5807,267,216,113,135,6538
E02001390,Toxteth,Liverpool,North West,2005,6196,397,348,211,380,7532,2153,7558,426,384,235,336,8939
E02001391,Netherley,Liverpool,North West,1215,3398,283,312,235,319,4547,1326,4226,299,313,232,294,5364
E02001392,Gateacre,Liverpool,North West,999,3350,410,424,294,574,5052,1058,3725,420,436,332,559,5472
E02001393,Calderstones,Liverpool,North West,1218,4413,546,528,318,479,6284,1243,5073,552,587,382,515,7109
E02001394,Mossley Hill West & Sefton Park,Liverpool,North West,1083,7031,420,404,283,440,8578,1073,7132,434,424,307,447,8744
E02001395,Mossley Hill East,Liverpool,North West,1168,3703,336,315,227,347,4928,1165,4013,377,328,238,342,5298
E02001396,Dingle,Liverpool,North West,1176,5580,372,361,204,280,6797,1253,5890,376,371,234,244,7115
E02001397,Woolton,Liverpool,North West,1066,4348,552,466,318,608,6292,1079,4557,577,515,322,576,6547
E02001398,St Michael's & Otterspool,Liverpool,North West,1022,5311,380,339,253,416,6699,1081,5809,423,395,249,374,7250
E02001399,West Allerton,Liverpool,North West,1368,4217,435,361,289,423,5725,1322,4646,478,423,292,437,6276
E02001400,Allerton,Liverpool,North West,1220,4244,346,300,223,369,5482,1339,4847,417,348,247,344,6203
E02001401,Hunts Cross,Liverpool,North West,1313,4639,471,399,318,564,6391,1462,5215,475,471,315,583,7059
E02001402,Aigburth & Grassendale,Liverpool,North West,1682,5652,518,517,350,498,7535,1732,5887,587,522,374,481,7851
E02001403,Garston,Liverpool,North West,1397,4435,283,212,140,217,5287,1356,4652,277,248,153,198,5528
E02001404,Speke West & Airport,Liverpool,North West,1705,4959,304,243,189,267,5962,1682,5595,357,258,197,227,6634
E02001405,Speke East,Liverpool,North West,2504,5921,448,330,207,278,7184,2506,7057,508,393,206,278,8442
E02006932,Central & Islington,Liverpool,North West,381,16926,93,53,27,35,17134,403,17212,97,77,48,39,17473
E02006933,Albert Dock & Queen's Dock,Liverpool,North West,589,7415,214,142,78,101,7950,706,7058,245,205,111,94,7713
E02006934,Pier Head,Liverpool,North West,314,7841,86,63,35,42,8067,331,6040,98,87,32,32,6289
E02001406,Rainford,St. Helens,North West,1120,4153,541,733,538,635,6600,1166,4489,537,695,585,682,6988
E02001407,Billinge,St. Helens,North West,800,3072,514,538,408,451,4983,750,3278,502,538,415,507,5240
E02001408,Garswood,St. Helens,North West,830,3285,420,440,313,273,4731,826,3377,389,478,329,321,4894
E02001409,Moss Bank,St. Helens,North West,1894,6089,654,683,378,493,8297,1807,6490,624,728,416,475,8733
E02001410,Haydock East,St. Helens,North West,1092,3522,325,363,243,311,4764,1092,3668,314,359,251,298,4890
E02001411,Haydock West,St. Helens,North West,1012,3479,321,394,273,403,4870,947,3605,312,357,288,422,4984
E02001412,Windle & Denton's Green,St. Helens,North West,1765,5530,543,438,334,461,7306,1673,5811,490,531,317,508,7657
E02001413,Blackbrook,St. Helens,North West,1533,5555,672,731,414,386,7758,1556,5964,658,772,464,413,8271
E02001414,Eccleston,St. Helens,North West,909,2991,349,408,297,516,4561,916,3185,341,414,294,517,4751
E02001415,Earlestown North,St. Helens,North West,1544,4337,278,276,187,214,5292,1437,4607,294,295,233,239,5668
E02001416,Broad Oak,St. Helens,North West,1459,4008,323,258,134,247,4970,1433,4243,329,304,148,233,5257
E02001417,Town Centre West,St. Helens,North West,1263,5010,348,278,195,299,6130,1203,5315,367,282,217,301,6482
E02001418,Earlestown South,St. Helens,North West,1163,3887,252,243,192,278,4852,1254,4348,300,234,197,282,5361
E02001419,Town Centre East & Fingerpost,St. Helens,North West,1422,4700,329,313,213,314,5869,1530,5399,342,289,212,289,6531
E02001420,Newton-le-Willows,St. Helens,North West,2347,7495,515,447,356,488,9301,2416,7739,528,476,354,524,9621
E02001421,West Park,St. Helens,North West,1796,6907,554,498,326,467,8752,1789,7219,581,497,401,458,9156
E02001422,Derbyshire Hill,St. Helens,North West,1681,4288,276,226,149,245,5184,1551,4524,316,225,154,229,5448
E02001423,Eccleston Park,St. Helens,North West,993,3942,405,420,298,436,5501,1018,4116,439,448,349,428,5780
E02001424,Thatto Heath & Lea Green,St. Helens,North West,3185,9057,638,674,492,619,11480,3147,9888,625,734,486,699,12432
E02001425,Sutton Leach,St. Helens,North West,1647,6330,704,628,439,501,8602,1741,6962,714,686,477,560,9399
E02001426,Rainhill North,St. Helens,North West,859,3140,311,357,332,443,4583,894,3428,297,342,296,473,4836
E02001427,Bold & Clock Face,St. Helens,North West,2066,6422,535,605,352,379,8293,2179,7169,529,590,389,369,9046
E02001428,Rainhill South,St. Helens,North West,825,2978,355,408,397,563,4701,823,3395,341,403,403,565,5107
E02001429,Crossens,Sefton,North West,1034,3573,517,561,403,621,5675,1034,3888,498,577,413,614,5990
E02001430,Marshside,Sefton,North West,1063,3878,514,496,369,643,5900,1031,4293,492,542,402,640,6369
E02001431,Hesketh Park,Sefton,North West,775,3540,652,706,596,1220,6714,824,3849,609,716,607,1115,6896
E02001432,Southport Waterfront,Sefton,North West,1156,5575,515,557,377,864,7888,1122,6394,562,526,414,758,8654
E02001433,Southport High Park,Sefton,North West,1697,4797,375,318,283,309,6082,1648,5005,357,333,223,301,6219
E02001434,Meols Cop,Sefton,North West,1532,4684,415,356,205,261,5921,1480,4963,393,338,241,243,6178
E02001435,Southport South,Sefton,North West,1798,5385,411,374,251,368,6789,1553,5748,425,408,249,352,7182
E02001436,Southport Kew,Sefton,North West,1788,5484,488,435,299,504,7210,1752,6119,541,507,340,486,7993
E02001437,Birkdale,Sefton,North West,1158,4901,719,838,636,1352,8446,1090,5117,699,843,668,1315,8642
E02001438,Hillside,Sefton,North West,1383,4400,445,405,297,386,5933,1255,4657,452,405,300,358,6172
E02001439,Ainsdale East,Sefton,North West,1228,3851,401,416,304,446,5418,1209,4191,418,398,300,449,5756
E02001440,Ainsdale West,Sefton,North West,696,2861,502,632,552,659,5206,666,3206,513,616,549,686,5570
E02001441,Formby West & Freshfield North,Sefton,North West,974,3209,513,599,509,622,5452,963,3643,489,575,513,667,5887
E02001442,Formby Central & Freshfield South,Sefton,North West,925,3142,427,495,427,772,5263,881,3376,388,489,434,720,5407
E02001443,Formby South West,Sefton,North West,883,2900,386,421,366,562,4635,887,3281,378,431,362,586,5038
E02001444,Formby South East & Ince Blundell,Sefton,North West,952,3104,356,376,322,452,4610,906,3473,358,372,341,491,5035
E02001445,Maghull North West & Lydiate,Sefton,North West,1029,3711,510,453,376,659,5709,1046,4143,495,507,385,605,6135
E02001446,Maghull North East,Sefton,North West,1023,3883,436,459,410,565,5753,1124,4198,408,460,384,603,6053
E02001447,Maghull South East,Sefton,North West,838,3077,410,430,324,649,4890,868,3452,405,412,349,599,5217
E02001448,Maghull South West,Sefton,North West,1119,3896,443,405,313,510,5567,1086,4199,454,413,307,552,5925
E02001449,Hightown & Thornton,Sefton,North West,1437,5223,742,601,430,602,7598,1537,5884,734,610,478,603,8309
E02001450,Blundellsands,Sefton,North West,1254,4655,603,613,457,674,7002,1296,5057,621,653,450,701,7482
E02001451,Netherton North,Sefton,North West,1238,3578,296,306,194,431,4805,1202,3957,308,326,198,393,5182
E02001452,Ford,Sefton,North West,1370,4177,287,271,182,384,5301,1157,4285,327,299,186,331,5428
E02001453,Crosby East,Sefton,North West,1543,5312,566,478,374,556,7286,1504,5601,600,510,398,549,7658
E02001454,Aintree East & Waddicar,Sefton,North West,1152,4214,407,360,290,551,5822,1211,4626,432,398,298,522,6276
E02001455,Aintree West & Old Roan,Sefton,North West,1126,4527,375,370,271,445,5988,1124,4756,423,372,251,442,6244
E02001456,Brighton le Sands & Crosby West,Sefton,North West,1269,4594,468,424,292,453,6231,1252,4776,521,392,302,453,6444
E02001457,Netherton South,Sefton,North West,1410,4396,351,256,171,306,5480,1388,4639,363,258,158,292,5710
E02001458,Waterloo,Sefton,North West,1380,5098,415,329,227,272,6341,1361,5446,415,365,209,302,6737
E02001459,Litherland North,Sefton,North West,1572,4431,357,286,221,317,5612,1463,4830,396,308,208,304,6046
E02001460,Seaforth North,Sefton,North West,1186,4843,418,382,293,449,6385,1169,5050,439,402,295,442,6628
E02001461,Litherland South,Sefton,North West,1223,4029,368,378,261,334,5370,1256,4578,378,376,259,310,5901
E02001462,Seaforth South,Sefton,North West,1759,5110,347,295,207,182,6141,1706,5426,351,304,189,205,6475
E02001463,Orrell,Sefton,North West,1526,4375,292,323,219,320,5529,1606,5160,320,306,207,307,6300
E02001464,Bootle North,Sefton,North West,1557,4517,301,266,192,191,5467,1573,5077,311,286,196,217,6087
E02001465,Bootle South,Sefton,North West,1419,4683,397,307,212,249,5848,1364,5291,399,339,194,248,6471
E02001466,Bootle East,Sefton,North West,1793,5406,414,419,263,376,6878,1820,6197,482,388,292,370,7729
E02001467,New Brighton,Wirral,North West,1184,4877,519,493,361,511,6761,1088,4894,551,469,394,522,6830
E02001468,Wallasey East,Wirral,North West,1336,4909,396,348,258,372,6283,1348,5278,452,382,272,417,6801
E02001469,Wallasey Village,Wirral,North West,1253,4597,499,505,338,573,6512,1207,4830,571,492,368,556,6817
E02001470,Wallasey Central,Wirral,North West,1493,5078,564,450,333,475,6900,1521,5541,577,483,365,444,7410
E02001471,Egremont,Wirral,North West,1735,4812,397,332,212,338,6091,1638,5178,370,371,219,312,6450
E02001472,Leasowe,Wirral,North West,1405,4366,373,313,208,346,5606,1408,4772,401,363,208,321,6065
E02001473,Liscard,Wirral,North West,1499,4845,445,411,320,409,6430,1355,5025,442,423,306,414,6610
E02001474,Seacombe,Wirral,North West,1801,4597,283,284,175,204,5543,1858,5023,306,261,182,232,6004
E02001475,Leasowe South & Moreton East,Wirral,North West,1504,3775,313,326,203,301,4918,1539,4168,307,322,208,291,5296
E02001476,Poulton,Wirral,North West,1914,5055,293,285,185,239,6057,1899,5592,325,306,182,252,6657
E02001477,Bidston Hill,Wirral,North West,1985,4753,348,256,156,183,5696,2066,5378,328,256,170,222,6354
E02001478,Moreton West,Wirral,North West,1451,4620,590,537,330,472,6549,1462,5095,558,628,360,545,7186
E02001479,Great Meols,Wirral,North West,1052,3735,427,406,264,305,5137,1013,3953,476,423,262,344,5458
E02001480,Hoylake,Wirral,North West,1289,4485,512,442,352,711,6502,1217,4824,494,513,352,746,6929
E02001481,Claughton North,Wirral,North West,1325,4984,466,480,387,463,6780,1379,5482,506,504,377,466,7335
E02001482,Birkenhead Central,Wirral,North West,1542,5528,372,267,209,275,6651,1493,6141,418,314,205,262,7340
E02001483,Saughall Massie,Wirral,North West,1180,4253,602,548,305,432,6140,1117,4464,566,529,353,418,6330
E02001484,Upton West,Wirral,North West,1397,4496,518,544,377,679,6614,1403,4830,538,566,383,600,6917
E02001485,Noctorum North & Upton East,Wirral,North West,1569,4173,325,299,207,340,5344,1640,4584,316,323,207,313,5743
E02001486,Claughton South & Oxton North,Wirral,North West,923,4919,598,604,438,672,7231,888,4793,597,617,414,722,7143
E02001487,Birkenhead South,Wirral,North West,2433,6256,356,296,199,194,7301,2337,6625,405,309,234,197,7770
E02001488,Oxton South,Wirral,North West,1658,5346,387,369,299,363,6764,1552,5599,395,393,273,358,7018
E02001489,Greasby,Wirral,North West,1168,4406,707,691,433,680,6917,1184,4587,648,733,486,703,7157
E02001490,Noctorum South,Wirral,North West,1528,4916,478,544,375,392,6705,1485,5398,490,592,404,428,7312
E02001491,Woodchurch,Wirral,North West,1488,4097,386,361,187,351,5382,1484,4518,395,368,198,305,5784
E02001492,West Kirby,Wirral,North West,1331,4388,506,520,410,677,6501,1274,4592,491,538,386,689,6696
E02001493,Tranmere,Wirral,North West,1794,5266,378,340,206,291,6481,1942,6085,404,335,225,286,7335
E02001494,Caldy & Newton,Wirral,North West,1183,3731,573,587,394,575,5860,1193,4115,550,618,426,570,6279
E02001495,Egerton Park,Wirral,North West,1583,4904,448,353,300,398,6403,1511,5204,441,388,280,409,6722
E02001496,Prenton,Wirral,North West,1107,3694,391,355,294,424,5158,1047,3771,379,371,289,394,5204
E02001497,Bebington New Ferry,Wirral,North West,1748,5124,389,377,254,296,6440,1753,5542,412,397,240,359,6950
E02001498,Woodhey,Wirral,North West,1465,4521,401,396,281,419,6018,1364,4744,407,409,301,387,6248
E02001499,Thursaston & Irby,Wirral,North West,1037,3558,491,513,380,642,5584,1041,3848,501,548,376,619,5892
E02001500,Pensby & Thingwall,Wirral,North West,1268,4230,544,536,414,544,6268,1196,4507,496,558,404,602,6567
E02001501,Higher Bebington,Wirral,North West,1509,4811,433,498,327,425,6494,1348,5024,433,489,358,453,6757
E02001502,Lower Bebington & Bromborough Pool,Wirral,North West,1826,5839,519,499,397,564,7818,1778,6132,509,490,385,558,8074
E02001503,Heswall,Wirral,North West,1161,4038,528,549,456,719,6290,1137,4254,516,555,472,735,6532
E02001504,"Poulton, Raby Mere & Thornton Hough",Wirral,North West,1015,3734,554,672,498,743,6201,1020,3936,547,662,518,723,6386
E02001505,Bromborough North,Wirral,North West,1111,3796,345,375,312,406,5234,1114,4107,374,364,292,437,5574
E02001506,Gayton & Lower Heswall,Wirral,North West,1320,4431,711,776,578,949,7445,1305,4921,669,787,587,948,7912
E02001507,Bromborough South,Wirral,North West,1174,3907,456,621,423,558,5965,1143,4098,485,569,449,601,6202
E02001508,Eastham,Wirral,North West,1604,4950,485,414,319,521,6689,1602,5276,447,440,311,477,6951
E02003314,Hoo Peninsula,Medway,South East,1071,3693,482,474,320,335,5304,1107,4058,508,502,335,374,5777
E02003315,Cliffe,Medway,South East,1065,3363,357,377,200,231,4528,1038,3669,333,422,230,236,4890
E02003316,Hoo St Werburgh & High Halstow,Medway,South East,2379,6654,547,579,404,410,8594,2578,7446,569,622,447,446,9530
E02003317,Wainscott & City Estate,Medway,South East,1386,4199,311,324,238,373,5445,1464,4472,329,347,256,368,5772
E02003318,Broomhill,Medway,South East,1042,3637,359,351,266,319,4932,1012,3781,368,369,252,350,5120
E02003319,Strood North & Frindsbury,Medway,South East,1878,5519,317,300,167,275,6578,1861,5690,333,266,190,267,6746
E02003320,Chatham Maritime,Medway,South East,1834,6556,308,223,153,168,7408,1915,6550,335,290,201,202,7578
E02003321,Rede Common,Medway,South East,1524,3971,286,306,209,273,5045,1504,4288,292,307,222,286,5395
E02003322,Gillingham North,Medway,South East,1613,6000,210,174,120,188,6692,1504,5717,238,187,122,180,6444
E02003323,Gillingham North East,Medway,South East,1920,4922,263,218,145,225,5773,1856,5090,295,230,162,223,6000
E02003324,Strood South & Temple Marsh,Medway,South East,2414,6305,344,358,189,252,7448,2484,6769,387,360,204,252,7972
E02003325,Gillingham Central,Medway,South East,1854,5214,246,173,136,151,5920,1881,5628,270,190,142,154,6384
E02003326,Gillingham East,Medway,South East,1815,5143,305,329,195,234,6206,1687,5422,317,327,217,241,6524
E02003327,Rochester West,Medway,South East,1405,5053,264,339,194,280,6130,1310,5026,312,330,240,302,6210
E02003328,Chatham Central and Rochester Riverside,Medway,South East,2060,6932,285,202,165,183,7767,2236,7239,323,229,167,225,8183
E02003329,Gillingham South,Medway,South East,1775,4642,244,200,120,158,5364,1763,5030,240,239,134,150,5793
E02003330,Rochester East,Medway,South East,1519,4330,275,268,156,198,5227,1521,4632,307,248,178,216,5581
E02003331,Twydall,Medway,South East,1836,5351,472,430,313,453,7019,1771,5771,513,443,338,468,7533
E02003332,Gillingham South East,Medway,South East,1266,3903,300,300,187,344,5034,1224,4121,346,342,216,367,5392
E02003333,Luton,Medway,South East,1804,4960,212,176,123,182,5653,2023,5086,223,189,126,186,5810
E02003334,Chatham South West,Medway,South East,1391,4021,209,195,147,216,4788,1439,4425,228,207,157,222,5239
E02003335,Chatham South East,Medway,South East,2162,4861,174,169,91,135,5430,2333,5165,194,172,120,117,5768
E02003336,Rainham North West,Medway,South East,1074,3479,387,354,321,461,5002,1143,3831,407,407,313,470,5428
E02003337,Rochester South West,Medway,South East,1323,4715,316,291,220,366,5908,1435,5353,328,323,215,367,6586
E02003338,Rainham North East,Medway,South East,1452,4431,366,389,248,312,5746,1430,4613,381,402,287,325,6008
E02003339,Rochester South East,Medway,South East,1253,3891,325,358,243,421,5238,1202,4149,332,331,277,407,5496
E02003340,Wayfield,Medway,South East,1738,4931,390,325,245,374,6265,1716,5198,402,375,249,381,6605
E02003341,Cuxton & Halling,Medway,South East,1266,4056,342,388,286,258,5330,1316,4342,348,404,271,296,5661
E02003342,Rainham South East,Medway,South East,1218,3634,392,436,272,401,5135,1151,3864,366,435,315,400,5380
E02003343,Rainham South West,Medway,South East,910,3363,406,493,347,395,5004,924,3632,412,509,368,451,5372
E02003344,Capstone,Medway,South East,1503,4510,411,297,184,213,5615,1396,4514,387,359,191,216,5667
E02003345,Parkwood East,Medway,South East,1287,3734,362,328,163,178,4765,1328,3968,341,353,193,191,5046
E02003346,Horsted,Medway,South East,1377,4074,383,436,277,403,5573,1318,4281,381,431,305,420,5818
E02003347,Settington,Medway,South East,1353,4116,224,220,99,114,4773,1325,4109,240,228,134,149,4860
E02003348,Hempstead & Wigmore,Medway,South East,1274,4399,528,631,382,567,6507,1313,4808,585,630,422,578,7023
E02003349,Parkwood West,Medway,South East,1452,4158,409,541,314,414,5836,1386,4434,425,530,383,440,6212
E02003350,Walderslade,Medway,South East,1291,3784,322,343,218,317,4984,1340,4205,343,369,254,347,5518
E02003351,Lordswood,Medway,South East,1645,4764,386,462,280,269,6161,1642,4958,412,446,336,288,6440
E02003352,Winkfield & Cranbourne,Bracknell Forest,South East,967,3443,350,425,302,374,4894,929,3579,357,426,351,452,5165
E02003353,Binfield & Popeswood,Bracknell Forest,South East,1965,6849,468,382,250,392,8341,2310,7973,567,453,318,399,9710
E02003354,Wick Hill,Bracknell Forest,South East,1974,6626,440,354,207,361,7988,1978,7208,443,387,256,386,8680
E02003355,Priestwood,Bracknell Forest,South East,1530,4378,239,174,157,271,5219,1541,4738,288,181,144,252,5603
E02003356,Chavey Down & North Ascot West,Bracknell Forest,South East,1454,4546,363,303,209,404,5825,1474,4764,391,320,239,392,6106
E02003357,Bullbrook,Bracknell Forest,South East,2255,6662,335,291,216,445,7949,2247,7426,369,322,219,441,8777
E02003358,Central Bracknell & Wildridings,Bracknell Forest,South East,2423,7593,348,354,211,412,8918,2403,8159,388,333,264,428,9572
E02003359,Crown Wood,Bracknell Forest,South East,1293,4581,253,160,102,124,5220,1193,4692,288,197,117,128,5422
E02003360,Great Hollands,Bracknell Forest,South East,2968,7452,455,452,262,228,8849,2800,7977,500,482,330,278,9567
E02003361,Birch Hill & Hanworth East,Bracknell Forest,South East,1501,4797,342,320,167,258,5884,1518,5342,360,329,219,249,6499
E02003362,Hanworth West,Bracknell Forest,South East,1523,4304,329,338,163,169,5303,1404,4583,360,339,212,215,5709
E02003363,Crowthorne South,Bracknell Forest,South East,1448,4304,354,376,286,495,5815,1412,4370,344,365,311,528,5918
E02003364,Owlsmoor & Broadmoor,Bracknell Forest,South East,1359,4432,299,298,211,159,5399,1342,4676,356,311,226,186,5755
E02003365,Sandhurst,Bracknell Forest,South East,1386,4043,398,384,219,345,5389,1336,4441,410,392,262,337,5842
E02003366,College Town,Bracknell Forest,South East,1296,5186,321,279,170,258,6214,1216,5573,367,336,179,288,6743
E02003367,"Chieveley, East Isley & Compton",West Berkshire,South East,1455,3785,358,357,254,242,4996,1289,4127,367,353,261,276,5384
E02003368,Lambourn & Great Shefford,West Berkshire,South East,1025,3392,355,365,273,279,4664,1001,3991,364,385,309,329,5378
E02003369,Streatley & Pangbourne,West Berkshire,South East,1302,3828,350,341,275,406,5200,1202,4179,377,366,292,421,5635
E02003370,Purley on Thames,West Berkshire,South East,1189,3969,419,440,274,370,5472,1201,4406,413,443,329,394,5985
E02003371,Westwood,West Berkshire,South East,1020,3436,331,284,279,352,4682,1057,3888,344,334,271,398,5235
E02003372,Calcot North & Little Heath,West Berkshire,South East,1499,4498,458,433,314,426,6129,1531,5054,462,440,321,457,6734
E02003373,Hermitage & Cold Ash,West Berkshire,South East,2025,5153,422,424,289,348,6636,1949,5308,411,450,304,390,6863
E02003374,Calcot South,West Berkshire,South East,1030,3609,366,253,128,171,4527,1105,3929,344,297,182,214,4966
E02003375,Theale & Beenham,West Berkshire,South East,1168,3616,331,293,192,290,4722,1145,4036,328,306,230,277,5177
E02003376,Hungerford,West Berkshire,South East,1060,3393,356,372,302,364,4787,1033,3573,370,378,318,406,5045
E02003377,Thatcham South East & Bradfield,West Berkshire,South East,2184,6128,616,629,322,457,8152,2224,6748,658,625,426,486,8943
E02003378,Newbury North West,West Berkshire,South East,1368,4551,436,502,342,628,6459,1386,5125,439,487,387,595,7033
E02003379,Newbury Clay Hill,West Berkshire,South East,1418,4442,276,280,190,306,5494,1373,4833,260,296,196,326,5911
E02003380,Thatcham West,West Berkshire,South East,1471,4978,455,393,235,284,6345,1465,5535,466,424,265,261,6951
E02003381,Burghfield Common,West Berkshire,South East,1294,3578,288,324,185,260,4635,1312,3785,327,305,191,306,4914
E02003382,Thatcham Town,West Berkshire,South East,1598,4972,352,346,301,403,6374,1564,5151,342,378,299,416,6586
E02003383,Thatcham North East,West Berkshire,South East,1504,4330,310,282,152,211,5285,1458,4802,339,326,187,228,5882
E02003384,Kintbury & Boxford,West Berkshire,South East,1197,3801,398,419,310,387,5315,1097,4063,427,422,329,430,5671
E02003385,Newbury Central & Greenham,West Berkshire,South East,1863,6974,395,373,268,390,8400,2021,7927,435,382,302,447,9493
E02003386,Newbury South West,West Berkshire,South East,1685,5131,361,439,279,343,6553,1653,5821,392,444,328,381,7366
E02003387,Newbury Wash Common,West Berkshire,South East,2043,5353,520,631,373,532,7409,1963,5854,509,594,430,573,7960
E02003388,Mortimer & Aldermaston Wharf,West Berkshire,South East,1172,3395,319,360,250,320,4644,1146,3823,328,343,286,338,5118
E02003389,Caversham Emmer Green,Reading,South East,1565,4163,412,465,333,466,5839,1538,5130,424,510,376,504,6944
E02003390,Caversham Heights,Reading,South East,1567,4056,421,390,292,421,5580,1638,5011,448,413,322,450,6644
E02003391,Caversham Balmore Park,Reading,South East,1874,4518,385,371,315,538,6127,1963,5830,381,418,334,548,7511
E02003392,Lower Caversham,Reading,South East,1645,5193,276,245,178,302,6194,1817,6696,308,261,217,307,7789
E02003393,Tilehurst North,Reading,South East,1542,4463,360,396,294,425,5938,1544,5379,408,400,330,479,6996
E02003394,Norcot North,Reading,South East,2207,4783,287,245,154,297,5766,2193,6344,328,295,181,307,7455
E02003395,Battle & Caversham Bridge,Reading,South East,2404,7144,197,171,115,155,7782,2418,9912,301,213,152,213,10791
E02003396,Norcot South,Reading,South East,2019,6094,247,245,209,310,7105,2077,8050,343,311,218,312,9234
E02003397,Tilehurst South,Reading,South East,1744,4201,329,392,269,452,5643,1856,5503,365,378,277,445,6968
E02003398,Palmer Park,Reading,South East,2153,7576,264,247,163,168,8418,2369,9928,326,264,178,214,10910
E02003399,Reading Central,Reading,South East,2433,11498,243,235,156,118,12250,2659,15634,325,228,171,178,16536
E02003400,Wokingham Road,Reading,South East,1298,6083,202,166,129,285,6865,1239,7114,238,218,164,309,8043
E02003401,Coley Park,Reading,South East,1857,5659,283,231,211,456,6840,1902,6869,339,247,200,468,8123
E02003402,Southampton Street & Redlands Road,Reading,South East,1683,7970,255,203,136,203,8767,1868,10739,286,269,184,203,11681
E02003403,Southcote,Reading,South East,1986,5052,391,396,320,496,6655,2021,6373,438,398,319,460,7988
E02003404,Leighton Park,Reading,South East,1359,7343,214,207,162,265,8191,1542,9473,255,213,177,274,10392
E02003405,Kennet Island & Green Park,Reading,South East,2870,7458,345,275,170,244,8492,3154,10253,381,333,232,264,11463
E02003406,Whitley Wood,Reading,South East,1608,4442,366,282,178,246,5514,1771,5920,414,316,200,282,7132
E02003407,Britwell,Slough,South East,3049,6121,293,197,117,293,7021,3136,7844,348,255,128,261,8836
E02003408,Manor Park,Slough,South East,3057,6796,394,242,214,279,7925,3139,8869,441,323,188,324,10145
E02003409,Haymill & Lynch Hill,Slough,South East,2404,6484,351,272,186,260,7553,2408,7362,403,312,216,304,8597
E02003410,Baylis & Stoke,Slough,South East,3230,7175,365,254,220,301,8315,3468,9885,448,287,202,321,11143
E02003411,Wexham Lea,Slough,South East,2923,7139,358,264,234,411,8406,3212,9221,436,300,216,424,10597
E02003412,Cippenham Green,Slough,South East,2435,6111,404,321,255,294,7385,2563,7127,411,360,211,302,8411
E02003413,Stoke Road & Wexham Road,Slough,South East,3501,8655,462,288,190,305,9900,3788,11991,523,352,210,364,13440
E02003414,Cippenham Meadows,Slough,South East,3775,8312,388,317,197,207,9421,3841,9640,432,332,207,226,10837
E02003415,Chalvey,Slough,South East,3558,8330,364,234,175,301,9404,3859,10535,359,259,176,340,11669
E02003416,Langley St Mary's,Slough,South East,2331,5829,341,265,209,295,6939,2416,6621,368,275,207,306,7777
E02003417,Central Slough & Upton Court,Slough,South East,2771,7551,394,268,204,312,8729,3152,9470,431,343,216,333,10793
E02003418,Langley Kederminster,Slough,South East,2634,6383,402,236,153,308,7482,2547,7459,407,295,171,297,8629
E02003419,Langley Foxborough,Slough,South East,2208,5566,283,274,226,286,6635,2271,6233,320,256,193,327,7329
E02003420,Colnbrook & Poyle,Slough,South East,1581,4426,169,138,102,132,4967,1597,4675,234,168,107,125,5309
E02003421,Pinkney's Green & Furze Platt Road,Windsor and Maidenhead,South East,1081,3318,293,313,229,372,4525,1108,3706,295,350,255,368,4974
E02003422,Cookham & Waltham,Windsor and Maidenhead,South East,2194,6497,684,751,527,799,9258,2144,7494,690,783,573,787,10327
E02003423,Furze Platt,Windsor and Maidenhead,South East,1506,3915,298,293,201,257,4964,1507,4543,300,256,198,251,5548
E02003424,Maidenhead East,Windsor and Maidenhead,South East,1587,5370,442,512,414,635,7373,1590,6180,522,501,433,669,8305
E02003425,Maidenhead Central,Windsor and Maidenhead,South East,2837,8632,397,361,318,558,10266,2837,9858,449,396,362,541,11606
E02003426,Maidenhead Highway,Windsor and Maidenhead,South East,1957,5991,474,419,328,617,7829,1889,6571,465,464,340,610,8450
E02003427,Boyn Hill & Norreys Drive,Windsor and Maidenhead,South East,1970,5154,279,279,214,324,6250,1939,5914,305,276,193,326,7014
E02003428,Cox Green,Windsor and Maidenhead,South East,1999,5436,505,502,331,355,7129,1909,5991,527,506,361,412,7797
E02003429,Bray Wick & Holyport,Windsor and Maidenhead,South East,1495,4511,435,465,315,451,6177,1449,5130,455,485,363,448,6881
E02003430,Windsor Town & Eton,Windsor and Maidenhead,South East,1332,4728,297,270,139,299,5733,1602,5681,311,275,164,298,6729
E02003431,Datchet,Windsor and Maidenhead,South East,1327,4247,306,328,215,344,5440,1377,4796,364,340,252,319,6071
E02003432,Clewer Village,Windsor and Maidenhead,South East,1403,4786,247,248,186,359,5826,1412,5814,295,273,176,369,6927
E02003433,Dedworth,Windsor and Maidenhead,South East,1377,3772,300,371,309,495,5247,1305,3849,345,335,309,452,5290
E02003434,Clewer New Town,Windsor and Maidenhead,South East,1935,5575,372,389,261,581,7178,1904,6388,408,400,294,559,8049
E02003435,Spital & Cranbourne Park,Windsor and Maidenhead,South East,1538,4476,273,329,273,323,5674,1516,5211,343,356,284,340,6534
E02003436,Old Windsor & Wraysbury,Windsor and Maidenhead,South East,1451,5036,525,535,382,622,7100,1490,5718,553,548,393,638,7850
E02003437,Ascot & North Ascot East,Windsor and Maidenhead,South East,1522,4534,386,409,292,411,6032,1520,5132,381,416,322,395,6646
E02003438,South Ascot & Sunningdale,Windsor and Maidenhead,South East,2215,6264,527,631,416,857,8695,2212,7455,553,623,485,853,9969
E02003439,Twyford East & Wargrave,Wokingham,South East,945,3275,321,363,287,408,4654,1011,3846,299,372,312,444,5273
E02003440,Twyford West & Charvil,Wokingham,South East,1978,5512,428,462,356,532,7290,1984,6060,433,489,397,532,7911
E02003441,Sonning & Woodley North,Wokingham,South East,1434,4459,407,434,357,590,6247,1425,4960,433,419,369,587,6768
E02003442,Woodley East,Wokingham,South East,1771,4999,328,302,197,254,6080,1815,5673,365,323,217,288,6866
E02003443,Woodley South,Wokingham,South East,1654,4041,308,358,287,595,5589,1556,4387,270,328,269,534,5788
E02003444,Earley,Wokingham,South East,2157,6138,357,362,308,492,7657,2068,6790,407,341,310,510,8358
E02003445,Southlake,Wokingham,South East,1814,5201,428,451,375,453,6908,1823,5715,445,473,391,492,7516
E02003446,Lower Earley North,Wokingham,South East,1772,6779,409,491,291,403,8373,1681,7686,425,491,337,418,9357
E02003447,Winnersh,Wokingham,South East,2323,6591,398,380,221,424,8014,2367,7260,399,409,300,429,8797
E02003448,Wokingham North & Hurst,Wokingham,South East,1572,4432,427,404,268,362,5893,1660,5079,395,427,292,377,6570
E02003449,Lower Earley South,Wokingham,South East,1691,5306,253,237,124,198,6118,1598,5614,313,227,150,184,6488
E02003450,Shinfield,Wokingham,South East,2836,7977,447,405,285,388,9502,3012,9101,522,453,285,472,10833
E02003451,Wokingham Town,Wokingham,South East,1696,5358,405,446,379,802,7390,1733,6144,420,466,402,760,8192
E02003452,Wokingham East,Wokingham,South East,2053,5184,324,355,292,365,6520,2173,5937,362,353,297,353,7302
E02003453,Barkham & Woose Hill,Wokingham,South East,1470,4054,381,354,210,246,5245,1433,4570,403,383,255,265,5876
E02003454,Wokingham West & South,Wokingham,South East,1921,5148,431,422,335,544,6880,1836,5562,436,449,345,541,7333
E02003455,Spencers Wood & Swallowfield,Wokingham,South East,1965,5259,396,407,250,342,6654,2290,6593,420,434,280,367,8094
E02003456,Arborfield & Garrison,Wokingham,South East,1674,4258,287,277,191,297,5310,1940,5017,305,313,215,316,6166
E02003457,Finchampstead,Wokingham,South East,1906,6059,622,604,393,421,8099,1792,6508,588,646,438,492,8672
E02003458,Crowthorne North,Wokingham,South East,1667,4643,456,503,349,446,6397,1753,5512,490,513,399,513,7427
E02003459,Olney & Lavendon,Milton Keynes,South East,1621,4691,564,546,368,582,6751,1571,5433,569,600,419,598,7619
E02003460,"Hanslope, Castlethorpe & Sherington",Milton Keynes,South East,2264,6284,669,612,431,504,8500,2329,7316,679,694,468,563,9720
E02003461,Newport Pagnell North,Milton Keynes,South East,1434,3970,482,474,350,509,5785,1456,4775,482,538,337,496,6628
E02003462,Newport Pagnell South,Milton Keynes,South East,1449,4700,426,370,233,358,6087,1561,5684,488,404,284,354,7214
E02003463,Great Linford & Giffard Park,Milton Keynes,South East,1225,3949,473,426,221,272,5341,1193,4864,480,456,269,294,6363
E02003464,Stantonbury & Bradville,Milton Keynes,South East,1689,4187,302,245,141,131,5006,1620,5110,325,285,169,143,6032
E02003465,Willen & Downhead Park,Milton Keynes,South East,968,3707,430,339,232,404,5112,927,4335,507,397,276,390,5905
E02003466,Wolverton & New Bradwell,Milton Keynes,South East,1867,5025,277,207,122,219,5850,1740,5553,294,265,144,193,6449
E02003467,Linford Wood,Milton Keynes,South East,1415,3956,328,261,157,325,5027,1351,4910,356,305,211,325,6107
E02003468,Stony Stratford & Old Wolverton,Milton Keynes,South East,1778,4827,500,422,342,441,6532,1715,5673,494,477,350,437,7431
E02003469,Bradwell Village,Milton Keynes,South East,1043,3459,386,318,159,187,4509,1067,3931,435,354,199,228,5147
E02003470,Stacey Bushes & Fullers Slade,Milton Keynes,South East,1837,3536,235,173,98,86,4128,1758,4457,236,188,124,92,5097
E02003471,Bradwell Common,Milton Keynes,South East,1366,4204,356,278,177,185,5200,1335,5113,394,290,167,194,6158
E02003472,Central Milton Keynes & Newlands,Milton Keynes,South East,1856,7375,243,133,93,127,7971,1953,8749,247,190,92,112,9390
E02003473,Two Mile Ash,Milton Keynes,South East,1110,3475,278,241,181,163,4338,1093,3936,325,268,181,179,4889
E02003474,Woughton & Woolstone,Milton Keynes,South East,2063,5731,398,314,186,190,6819,2081,6449,423,371,190,199,7632
E02003475,"Broughton, Middleton & Kents Hill",Milton Keynes,South East,6470,14901,541,342,166,307,16257,7194,17791,603,436,242,331,19403
E02003476,Eaglestone & Fishermead,Milton Keynes,South East,2299,5850,336,244,150,207,6787,2116,6719,324,277,142,184,7646
E02003477,Shenley Wood & Grange Farm,Milton Keynes,South East,3972,9777,458,439,313,439,11426,4420,11912,459,478,349,440,13638
E02003478,Loughton,Milton Keynes,South East,1464,4384,289,277,144,214,5308,1436,5008,340,285,167,217,6017
E02003479,Oldbrook & Coffee Hall,Milton Keynes,South East,1828,4967,250,205,101,88,5611,1833,5948,274,246,115,122,6705
E02003480,Walnut Tree & Tilbrook,Milton Keynes,South East,1772,5548,289,219,136,113,6305,1696,6235,359,244,142,150,7130
E02003481,Denbigh,Milton Keynes,South East,2170,4936,330,238,157,183,5844,2025,5819,349,242,163,200,6773
E02003482,Bow Brickhill & Woburn Sands,Milton Keynes,South East,1337,4075,388,325,232,367,5387,1506,5206,418,396,267,382,6669
E02003483,Westcroft & Shenley Brook End,Milton Keynes,South East,2811,7538,265,175,111,146,8235,2849,8658,315,247,109,158,9487
E02003484,Furzton,Milton Keynes,South East,1549,4497,372,307,158,178,5512,1479,5232,375,360,219,196,6382
E02003485,Bletchley North West,Milton Keynes,South East,1867,4628,380,383,385,397,6173,1768,5680,438,403,347,425,7293
E02003486,Tattenhoe & Emerson Valley,Milton Keynes,South East,2287,6307,296,195,151,165,7114,2452,7235,336,264,162,164,8161
E02003487,Far Bletchley,Milton Keynes,South East,1542,4041,451,469,334,421,5716,1485,4878,431,462,357,404,6532
E02003488,Bletchley East,Milton Keynes,South East,1717,4632,421,377,314,413,6157,1799,5980,434,393,330,400,7537
E02003489,Bletchley West,Milton Keynes,South East,1488,4238,414,393,250,546,5841,1466,4924,384,441,265,475,6489
E02003490,Bletchley South,Milton Keynes,South East,2933,5389,280,310,127,231,6337,3160,7163,292,321,207,225,8208
E02003491,Patcham East,Brighton and Hove,South East,1633,4877,336,352,278,378,6221,1564,5517,375,387,251,414,6944
E02003492,Coldean & Moulsecoomb North,Brighton and Hove,South East,1068,9863,223,188,139,227,10640,1096,14807,237,205,148,223,15620
E02003493,Patcham West & Westdene,Brighton and Hove,South East,1508,4820,387,443,354,711,6715,1525,5302,423,455,347,712,7239
E02003494,Hollingbury,Brighton and Hove,South East,1270,4120,343,304,203,308,5278,1297,4669,355,370,222,333,5949
E02003495,Mile Oak,Brighton and Hove,South East,1391,4495,312,347,253,285,5692,1396,4864,323,351,269,321,6128
E02003496,Hangleton North,Brighton and Hove,South East,1481,4540,326,371,305,494,6036,1575,5024,364,395,265,514,6562
E02003497,West Blatchington,Brighton and Hove,South East,1566,4522,398,416,265,479,6080,1575,5276,430,415,315,473,6909
E02003498,Hollingdean & Moulsecoomb West,Brighton and Hove,South East,1563,6478,283,263,200,291,7515,1504,6525,325,254,196,282,7582
E02003499,Bevendean & Moulsecoomb East,Brighton and Hove,South East,1332,5747,232,259,182,292,6712,1323,6314,273,248,215,284,7334
E02003500,Fiveways,Brighton and Hove,South East,1668,5787,283,220,103,166,6559,1669,6638,339,283,140,171,7571
E02003501,Withdean Woods,Brighton and Hove,South East,1586,5937,336,326,213,399,7211,1546,6282,378,354,235,349,7598
E02003502,Portslade Village,Brighton and Hove,South East,1608,4930,317,320,190,320,6077,1564,5481,337,355,219,338,6730
E02003503,Hangleton South,Brighton and Hove,South East,1864,5593,372,402,257,462,7086,1853,6414,448,420,262,445,7989
E02003504,Preston Park,Brighton and Hove,South East,1293,6512,305,276,120,263,7476,1326,7604,357,292,189,233,8675
E02003505,Round Hill,Brighton and Hove,South East,1042,8719,233,149,78,144,9323,920,8228,225,177,91,119,8840
E02003506,Aldrington,Brighton and Hove,South East,1692,4813,236,161,131,179,5520,1665,5552,256,193,125,169,6295
E02003507,Woodingdean,Brighton and Hove,South East,1898,5844,519,515,404,671,7953,1824,6265,559,543,448,652,8467
E02003508,Elm Grove & Bear Road,Brighton and Hove,South East,1335,7832,209,190,114,157,8502,1263,7281,263,222,116,159,8041
E02003509,Goldsmid West,Brighton and Hove,South East,1311,6963,292,269,208,311,8043,1369,7746,321,312,241,307,8927
E02003510,Goldsmid East,Brighton and Hove,South East,1376,6347,288,296,196,445,7572,1457,7754,356,355,255,474,9194
E02003511,Portslade by Sea,Brighton and Hove,South East,1838,5517,310,283,223,327,6660,1850,6381,347,317,229,356,7630
E02003512,Hanover,Brighton and Hove,South East,1298,7965,249,173,111,132,8630,1187,7773,278,197,105,122,8475
E02003513,Aldrington South,Brighton and Hove,South East,1183,4119,322,331,203,437,5412,1165,4513,333,312,228,447,5833
E02003514,Seven Dials,Brighton and Hove,South East,869,7934,250,185,127,195,8691,862,8542,286,234,125,163,9350
E02003515,Whitehawk,Brighton and Hove,South East,2075,5949,323,306,205,312,7095,2015,6986,368,343,202,290,8189
E02003516,Hove Central,Brighton and Hove,South East,808,7344,273,246,168,257,8288,927,7973,303,261,181,262,8980
E02003517,North Laine & the Lanes,Brighton and Hove,South East,1077,10713,288,252,146,196,11595,1034,13022,347,285,188,216,14058
E02003518,King Alfred,Brighton and Hove,South East,962,5741,310,352,254,495,7152,917,6267,391,354,290,479,7781
E02003519,Brunswick,Brighton and Hove,South East,692,8487,248,195,122,138,9190,753,9466,305,241,131,156,10299
E02003520,St James's Street & Queen's Park,Brighton and Hove,South East,1056,7374,310,265,180,236,8365,1087,9303,382,293,191,259,10428
E02003521,Kemptown,Brighton and Hove,South East,911,6127,360,321,270,413,7491,917,6669,365,369,251,428,8082
E02003522,Roedean & Marina,Brighton and Hove,South East,1087,5377,346,373,218,316,6630,1168,5850,396,403,251,304,7204
E02003523,Rottingdean & Saltdean,Brighton and Hove,South East,1477,5842,668,745,551,851,8657,1436,6198,747,756,633,910,9244
E02003524,Paulsgrove East,Portsmouth,South East,1844,4997,366,306,184,268,6121,1915,5611,368,352,217,244,6792
E02003525,Wymering,Portsmouth,South East,1520,4115,245,229,139,201,4929,1504,4692,267,250,157,196,5562
E02003526,Cosham North,Portsmouth,South East,1136,3628,430,479,347,697,5581,1093,3843,458,474,375,706,5856
E02003527,Paulsgrove West & Port Solent,Portsmouth,South East,1299,3877,282,345,226,299,5029,1252,4090,319,366,247,286,5308
E02003529,Cosham South,Portsmouth,South East,1803,5187,335,375,219,385,6501,1719,5385,363,351,271,414,6784
E02003530,Hilsea,Portsmouth,South East,1638,4729,359,387,247,390,6112,1630,4929,402,378,261,350,6320
E02003531,Anchorage Park & Copnor,Portsmouth,South East,1241,5045,366,394,284,382,6471,1276,5281,419,409,300,397,6806
E02003532,Alexandra Park,Portsmouth,South East,1545,5058,297,301,195,221,6072,1574,5651,376,291,237,236,6791
E02003533,North End West & Whale Island,Portsmouth,South East,1212,3768,218,192,134,208,4520,1244,5215,225,215,172,205,6032
E02003534,North End East,Portsmouth,South East,1972,5923,329,321,205,249,7027,1848,6289,376,345,238,260,7508
E02003535,Fratton North,Portsmouth,South East,2311,6622,279,276,148,228,7553,2216,7103,323,288,182,237,8133
E02003536,Landport,Portsmouth,South East,2022,5069,348,305,202,265,6189,2058,5900,346,326,220,261,7053
E02003537,Baffins,Portsmouth,South East,2064,6590,465,473,289,454,8271,1987,7069,503,452,309,447,8780
E02003538,Fratton Kingston,Portsmouth,South East,2129,7438,288,283,184,240,8433,2275,8131,326,282,198,282,9219
E02003539,Fratton West & Portsea,Portsmouth,South East,2326,12803,384,331,260,318,14096,2414,18560,442,354,261,333,19950
E02003540,Milton,Portsmouth,South East,1805,5995,383,523,401,586,7888,1833,6463,456,472,443,598,8432
E02003541,Somers Town,Portsmouth,South East,2145,9291,323,308,230,391,10543,2030,9306,339,319,229,384,10577
E02003542,Southsea Haslemere Road,Portsmouth,South East,1491,6975,258,258,162,258,7911,1444,6869,266,278,183,267,7863
E02003543,Southsea Fawcett Road,Portsmouth,South East,963,7085,263,206,122,215,7891,1044,7009,280,261,143,208,7901
E02003544,Southsea Prince Albert Road,Portsmouth,South East,1260,4412,193,191,138,171,5105,1217,4770,209,202,137,191,5509
E02003545,Southsea West,Portsmouth,South East,885,5444,293,297,194,350,6578,743,5847,322,307,204,358,7038
E02003546,Eastney,Portsmouth,South East,1587,5482,382,426,278,442,7010,1276,5598,449,420,332,452,7251
E02003547,Old Portsmouth & Southsea Common,Portsmouth,South East,1072,6617,401,489,338,610,8455,871,6833,409,512,350,619,8723
E02003548,Southsea Waverley Road,Portsmouth,South East,993,4818,230,264,150,319,5781,819,5003,286,236,178,331,6034
E02006821,Drayton & Farlington,Portsmouth,South East,1348,3893,290,360,281,403,5227,1316,4015,285,341,274,448,5363
E02003549,Bassett Green,Southampton,South East,1083,6691,334,309,238,344,7916,1177,8344,359,320,222,345,9590
E02003550,Aldermoor & Lordswood,Southampton,South East,1672,4597,492,471,238,267,6065,1617,5356,477,474,293,279,6879
E02003551,Stoneham,Southampton,South East,1011,5074,243,252,169,215,5953,952,6668,251,269,180,207,7575
E02003552,Coxford & Lords Hill,Southampton,South East,1169,3647,372,351,219,227,4816,1195,4325,368,385,239,254,5571
E02003553,Swaythling,Southampton,South East,1226,6054,227,163,99,143,6686,1307,7114,213,182,98,155,7762
E02003554,Hollybrook,Southampton,South East,1004,3918,322,324,229,439,5232,969,4224,316,355,262,429,5586
E02003555,Maybush,Southampton,South East,1860,5064,403,310,229,309,6315,1908,5997,450,373,233,309,7362
E02003556,Townhill Park,Southampton,South East,1226,3531,262,281,212,322,4608,1179,3739,264,264,249,308,4824
E02003557,Highfield & University,Southampton,South East,889,5156,230,292,213,345,6236,891,5535,252,289,227,362,6665
E02003558,Shirley Warren,Southampton,South East,1613,4505,239,243,181,271,5439,1671,5505,254,250,198,255,6462
E02003559,Upper Shirley,Southampton,South East,1630,4776,402,363,227,436,6204,1587,5441,410,400,269,401,6921
E02003560,Redbridge & Millbrook West,Southampton,South East,1971,4541,306,197,158,263,5465,1937,5164,314,245,170,251,6144
E02003561,St Denys,Southampton,South East,1072,6622,223,232,153,281,7511,1008,6857,260,229,173,277,7796
E02003562,Bitterne West,Southampton,South East,1757,5502,300,338,241,353,6734,1568,5707,359,322,253,352,6993
E02003563,Shirley South,Southampton,South East,1665,4906,299,285,240,425,6155,1735,5768,321,297,238,386,7010
E02003564,Bitterne East,Southampton,South East,1688,4553,345,364,273,447,5982,1697,5148,368,367,279,460,6622
E02003565,Bevois Town,Southampton,South East,679,6345,115,130,76,173,6839,818,6344,155,139,97,165,6900
E02003566,Harefield,Southampton,South East,1263,3560,312,344,225,385,4826,1304,4104,360,331,257,372,5424
E02003567,Regents Park & Millbrook East,Southampton,South East,1902,4803,310,261,160,239,5773,1886,5747,361,283,215,215,6821
E02003568,Banister Park & Howard Road,Southampton,South East,1283,6896,271,195,124,228,7714,1235,7431,300,212,200,230,8373
E02003569,Freemantle,Southampton,South East,1433,5802,280,225,109,162,6578,1372,6201,283,209,157,181,7031
E02003570,Newtown & Nicholstown,Southampton,South East,2536,9216,167,122,90,86,9681,2695,12257,255,163,85,129,12889
E02003571,Central Southampton West,Southampton,South East,670,9765,148,120,117,289,10439,778,8738,170,152,123,266,9449
E02003572,Bitterne South,Southampton,South East,1309,3700,287,297,204,303,4791,1192,4152,326,293,220,326,5317
E02003573,Thornhill,Southampton,South East,1711,4406,359,355,263,442,5825,1781,5142,374,354,290,426,6586
E02003574,Sholing East,Southampton,South East,1307,4435,395,483,310,407,6030,1278,4863,407,464,376,401,6511
E02003575,Hightown,Southampton,South East,1754,3879,255,269,192,236,4831,1706,4366,252,236,211,232,5297
E02003576,Itchen,Southampton,South East,1805,5259,312,279,232,244,6326,1716,5779,339,318,221,292,6949
E02003577,Central Southampton East,Southampton,South East,2002,11380,276,221,143,179,12199,2116,14021,367,246,164,178,14976
E02003578,Sholing West,Southampton,South East,1143,3878,291,267,217,270,4923,1134,4252,329,288,229,275,5373
E02003579,Woolston,Southampton,South East,1835,5865,361,343,241,447,7257,1797,6689,406,359,264,429,8147
E02003580,Weston,Southampton,South East,1573,3580,270,249,146,185,4430,1597,4130,275,250,166,179,5000
E02003581,Cowes Central,Isle of Wight,South East,1388,4878,412,454,292,461,6497,1334,5039,445,451,369,462,6766
E02003582,"Cowes West, Gurnard & Northwood",Isle of Wight,South East,1492,4795,577,654,463,627,7116,1439,5135,536,644,509,630,7454
E02003583,East Cowes & Osborne,Isle of Wight,South East,1255,4134,546,649,412,438,6179,1309,4320,546,641,518,452,6477
E02003584,Ryde Central,Isle of Wight,South East,816,4212,418,451,252,319,5652,761,4262,426,430,280,362,5760
E02003585,Binstead & Wootton,Isle of Wight,South East,893,3464,592,664,516,653,5889,868,3596,549,648,563,677,6033
E02003586,Ryde West & Havenstreet,Isle of Wight,South East,1467,4419,503,544,429,506,6401,1340,4786,526,566,436,569,6883
E02003587,Ryde South,Isle of Wight,South East,1802,5275,490,484,318,400,6967,1740,5535,476,505,361,425,7302
E02003588,Newport East & Parkhurst East,Isle of Wight,South East,1533,5090,512,459,361,482,6904,1655,5718,526,492,399,520,7655
E02003589,Newport Central & Parkhurst West,Isle of Wight,South East,1463,5368,373,318,261,350,6670,1467,4990,356,372,270,342,6330
E02003590,Bembridge & Nettlestone,Isle of Wight,South East,866,3494,665,899,579,957,6594,897,3625,707,822,664,980,6798
E02003591,Newport South & West,Isle of Wight,South East,1822,5555,543,641,454,603,7796,1657,5832,559,624,494,649,8158
E02003592,Yarmouth & Freshwater,Isle of Wight,South East,1064,4554,972,1044,773,1080,8423,1082,4968,949,1080,853,1167,9017
E02003593,Brighstone & Shalfleet,Isle of Wight,South East,647,2811,502,523,327,459,4622,619,2930,527,503,420,476,4856
E02003594,Sandown & Brading,Isle of Wight,South East,1467,5381,687,693,473,729,7963,1390,5650,749,705,538,715,8357
E02003595,Shanklin West & Newchurch,Isle of Wight,South East,999,4127,713,789,579,699,6907,1031,4443,782,805,655,761,7446
E02003596,Shanklin Central & Lake,Isle of Wight,South East,1248,4901,773,737,508,782,7701,1214,5170,787,773,588,732,8050
E02003597,"Niton, Shorwell & Godshill",Isle of Wight,South East,802,3082,509,574,327,445,4937,795,3300,499,590,376,462,5227
E02003598,Ventnor & Wroxall,Isle of Wight,South East,997,4024,680,765,480,583,6532,1009,4277,640,755,535,606,6813
E02003652,"Buckingham South, Maids Moreton & Akeley",Buckinghamshire,South East,2524,7069,478,445,301,415,8708,2334,7346,527,464,349,461,9147
E02003653,Buckingham North,Buckinghamshire,South East,1241,4355,316,354,248,361,5634,1278,5607,364,369,261,394,6995
E02003654,Newton Longville & Great Horwood,Buckinghamshire,South East,1034,3420,425,408,230,293,4776,966,3565,397,405,292,270,4929
E02003655,"Marsh Gibbon, Steeple Claydon & Tingewick",Buckinghamshire,South East,2021,6140,583,611,382,400,8116,1989,6712,602,646,400,457,8817
E02003656,Winslow & Padbury,Buckinghamshire,South East,1050,3741,384,423,288,456,5292,1071,3902,401,406,320,442,5471
E02003657,"Granborough, Stewkley & Great Brickhill",Buckinghamshire,South East,1321,4059,421,435,250,342,5507,1407,4524,472,466,295,385,6142
E02003658,"Wing, Wingrave & Bierton",Buckinghamshire,South East,1923,5149,541,502,331,468,6991,1934,5907,484,579,384,479,7833
E02003659,Waddesdon & Whitchurch,Buckinghamshire,South East,2210,6285,445,453,309,343,7835,2119,6177,439,482,340,393,7831
E02003660,"Cheddington, Pitstone & Edlesborough",Buckinghamshire,South East,1978,6334,586,600,372,478,8370,2000,6741,604,623,439,514,8921
E02003661,"Oakley, Brill & Edgcott",Buckinghamshire,South East,1126,3794,354,309,207,295,4959,1005,3974,372,310,216,273,5145
E02003662,Watermead & Elmhurst,Buckinghamshire,South East,1301,4545,256,205,189,209,5404,1179,4489,259,219,173,241,5381
E02003663,Berryfields & Haydon Hill,Buckinghamshire,South East,3720,8074,283,202,165,192,8916,3933,9113,343,255,154,204,10069
E02003664,Gatehouse,Buckinghamshire,South East,2235,5636,233,234,133,337,6573,1978,5503,248,243,143,297,6434
E02003665,Victoria Park,Buckinghamshire,South East,1262,4033,228,260,153,248,4922,1214,4155,210,253,168,241,5027
E02003666,Aylesbury Central,Buckinghamshire,South East,1648,5727,263,229,164,359,6742,1512,5482,290,238,185,325,6520
E02003667,Fairford Leys,Buckinghamshire,South East,2009,6773,377,302,164,209,7825,1889,6123,366,317,197,199,7202
E02003668,Bedgrove & Walton,Buckinghamshire,South East,1714,5210,471,497,402,713,7293,1636,5352,466,516,429,721,7484
E02003669,California & Southcourt,Buckinghamshire,South East,1941,5201,281,211,160,168,6021,1842,5225,280,219,150,202,6076
E02003670,Mandeville & Elm Farm,Buckinghamshire,South East,1967,6543,451,399,258,368,8019,1786,6226,449,403,274,373,7725
E02003671,Walton Court & Hawkslade,Buckinghamshire,South East,1402,4164,273,182,104,98,4821,1329,4134,251,224,125,116,4850
E02003672,Stoke Mandeville & Aston Clinton,Buckinghamshire,South East,2055,6348,629,674,456,659,8766,2240,7174,702,724,533,632,9765
E02003673,"Haddenham, Dinton & Stone",Buckinghamshire,South East,1616,5046,537,637,472,664,7356,1730,5585,523,665,500,686,7959
E02003674,"Worminghall, Long Crendon & Cuddington",Buckinghamshire,South East,1082,3105,348,379,283,290,4405,1030,3303,367,396,297,324,4687
E02003675,Wendover,Buckinghamshire,South East,2030,5704,428,432,369,625,7558,1833,6066,419,444,386,553,7868
E02003676,"Hyde Heath, Bellingdon & Latimer",Buckinghamshire,South East,1387,4585,503,528,398,531,6545,1421,5113,529,576,448,556,7222
E02003677,Chesham West,Buckinghamshire,South East,2296,6178,456,449,323,490,7896,2279,6907,457,467,344,488,8663
E02003678,Chesham East,Buckinghamshire,South East,1226,3470,286,261,197,366,4580,1146,3922,302,290,202,362,5078
E02003679,Chesham South,Buckinghamshire,South East,1467,4390,270,297,245,397,5599,1296,4824,286,289,233,398,6030
E02003680,Great Missenden & Prestwood,Buckinghamshire,South East,1817,5398,544,632,491,722,7787,1792,5996,563,648,537,766,8510
E02003681,Amersham-on-the-Hill & Chesham Bois,Buckinghamshire,South East,2456,5912,484,548,399,835,8178,2248,6563,514,507,482,786,8852
E02003682,Old Amersham,Buckinghamshire,South East,1638,4558,345,426,288,357,5974,1567,4917,386,419,315,437,6474
E02003683,Little Chalfont,Buckinghamshire,South East,1594,4198,358,350,267,484,5657,1531,4523,326,362,283,425,5919
E02003685,"Chalfont St Giles, Seer Green & Jordans",Buckinghamshire,South East,1646,4533,420,480,350,556,6339,1629,5109,458,503,362,540,6972
E02003686,Chalfont Common & St Peter East,Buckinghamshire,South East,1377,4159,380,435,335,687,5996,1350,4779,408,454,399,666,6706
E02003687,Chalfont St Peter West,Buckinghamshire,South East,1278,3303,288,281,209,467,4548,1245,3756,317,306,221,378,4978
E02003688,Beaconsfield Town,Buckinghamshire,South East,2739,7376,580,590,476,991,10013,2617,8072,572,578,480,970,10672
E02003689,Gerrards Cross,Buckinghamshire,South East,1846,5263,450,502,358,703,7276,1895,6184,517,517,362,702,8282
E02003690,Denham,Buckinghamshire,South East,1121,4040,357,366,328,675,5766,1200,4773,401,401,336,630,6541
E02003691,Farnham & Hedgerley,Buckinghamshire,South East,1369,3988,336,418,278,519,5539,1351,4448,394,417,316,549,6124
E02003692,Stoke Poges & George Green,Buckinghamshire,South East,1659,5433,483,503,352,557,7328,1598,5839,518,485,369,585,7796
E02003693,"Burham North, Taplow & Dorney",Buckinghamshire,South East,1078,3938,439,401,346,517,5641,1190,4410,462,453,370,522,6217
E02003694,Burnham South,Buckinghamshire,South East,1689,4895,406,338,257,385,6281,1642,5411,392,372,251,434,6860
E02003695,Iver & Richings Park,Buckinghamshire,South East,2134,6972,569,492,371,557,8961,2013,7126,598,530,355,510,9119
E02003696,Princes Risborough,Buckinghamshire,South East,1331,4200,527,613,429,851,6620,1377,4933,502,606,500,839,7380
E02003697,"Longwick, Kimble & Lacey Green",Buckinghamshire,South East,1044,3224,375,402,310,414,4725,1087,3646,398,415,329,441,5229
E02003698,Walter's Ash & Hughenden Valley,Buckinghamshire,South East,1420,4509,492,614,471,575,6661,1381,4908,508,616,466,581,7079
E02003699,Stokenchurch,Buckinghamshire,South East,1086,3228,366,327,243,333,4497,1100,3590,353,341,249,336,4869
E02003701,Downley,Buckinghamshire,South East,2504,7050,450,518,393,548,8959,2461,7923,485,510,455,641,10014
E02003702,"Bledlow, Cadmore End & Hambleden Valley",Buckinghamshire,South East,1371,4908,460,503,364,418,6653,1282,6028,474,468,372,445,7787
E02003703,Terriers & Amersham Hill,Buckinghamshire,South East,1853,5486,339,248,209,259,6541,1860,6253,386,263,233,295,7430
E02003704,Tylers Green,Buckinghamshire,South East,1135,3321,355,332,227,274,4509,1116,3742,364,349,264,299,5018
E02003705,Bowerdean,Buckinghamshire,South East,1591,4572,235,168,145,188,5308,1694,5334,285,192,124,223,6158
E02003706,Totteridge,Buckinghamshire,South East,1560,4374,255,225,201,272,5327,1446,4544,265,243,167,286,5505
E02003707,Sands,Buckinghamshire,South East,1604,4628,208,192,110,213,5351,1477,4741,232,226,113,173,5485
E02003708,Oakridge & Castlefield,Buckinghamshire,South East,2593,6422,282,136,123,202,7165,2576,7883,316,163,120,236,8718
E02003709,Micklefield,Buckinghamshire,South East,1456,3558,180,143,130,200,4211,1385,3889,231,158,129,195,4602
E02003710,Town Centre & Marlow Hill,Buckinghamshire,South East,2817,7640,386,311,255,386,8978,2943,9226,402,341,260,414,10643
E02003711,Ryemead & Wycombe Marsh,Buckinghamshire,South East,2112,6310,333,354,228,334,7559,2047,6326,358,328,216,321,7549
E02003712,Lane End & Booker,Buckinghamshire,South East,1524,4470,445,469,307,604,6295,1510,5190,429,479,345,558,7001
E02003713,Flackwell Heath,Buckinghamshire,South East,1145,3143,366,346,284,518,4657,1094,3484,372,343,292,506,4997
E02003714,Loudwater & Wooburn Green,Buckinghamshire,South East,1373,3979,347,298,243,280,5147,1350,4354,395,328,270,285,5632
E02003715,"Marlow Bottom, Danesfield & Well End",Buckinghamshire,South East,1298,3489,417,474,330,373,5083,1312,3961,446,454,357,367,5585
E02003716,Bourne End,Buckinghamshire,South East,914,3063,354,362,298,480,4557,890,3310,353,373,304,455,4795
E02003717,Marlow West & North,Buckinghamshire,South East,1851,4734,480,532,457,776,6979,1836,5518,523,570,475,729,7815
E02003718,Marlow East,Buckinghamshire,South East,1237,3177,283,309,206,387,4362,1192,3677,305,293,241,367,4883
E02006823,Knotty Green & Holmer Green,Buckinghamshire,South East,1700,4782,544,577,417,745,7065,1688,5352,575,599,493,742,7761
E02006824,Hazlemere,Buckinghamshire,South East,1894,5162,523,606,491,629,7411,1797,5867,541,570,497,687,8162
E02004356,Langney West,Eastbourne,South East,1559,4523,373,383,256,369,5904,1528,4991,394,366,294,371,6416
E02004357,Hampden Park North,Eastbourne,South East,1837,4663,411,429,225,295,6023,1755,5116,404,428,255,298,6501
E02004358,Langney East,Eastbourne,South East,1557,4223,497,618,409,695,6442,1605,4655,505,580,429,675,6844
E02004359,Hampden Park South,Eastbourne,South East,1342,4435,491,585,403,843,6757,1315,4751,479,553,443,757,6983
E02004361,Ratton,Eastbourne,South East,1622,4482,488,521,386,669,6546,1587,4891,473,517,398,644,6923
E02004362,Roselands,Eastbourne,South East,1842,5513,440,406,290,470,7119,1780,6020,420,457,302,432,7631
E02004363,Upperton,Eastbourne,South East,872,4059,431,440,357,820,6107,980,4290,390,466,368,741,6255
E02004364,Old Town & Motcombe,Eastbourne,South East,1426,4547,539,576,369,797,6828,1371,4951,528,604,415,716,7214
E02004365,Pier,Eastbourne,South East,1453,6035,307,231,149,217,6939,1532,7137,336,263,127,222,8085
E02004366,King Edward's Parade,Eastbourne,South East,931,4719,452,508,347,950,6976,979,5085,410,512,388,892,7287
E02004367,Meads,Eastbourne,South East,773,3365,548,742,578,1326,6559,735,3452,557,687,621,1183,6500
E02006857,St Anthony's Hill,Eastbourne,South East,1607,5003,540,722,431,655,7351,1705,5436,543,664,493,666,7802
E02006858,Sovereign Harbour,Eastbourne,South East,1112,4224,595,676,386,380,6261,1065,4221,555,628,449,417,6270
E02004368,Ashdown,Hastings,South East,1614,5246,467,562,290,350,6915,1611,5423,511,481,321,368,7104
E02004369,Conquest & St Helens,Hastings,South East,1397,5016,716,935,637,989,8293,1433,5577,724,910,691,1002,8904
E02004370,Hollington,Hastings,South East,1867,4813,414,385,226,304,6142,1987,5495,434,407,271,263,6870
E02004371,Ore,Hastings,South East,1511,4326,411,381,223,326,5667,1620,4601,422,389,277,289,5978
E02004372,Broomgrove,Hastings,South East,1971,4438,295,288,149,231,5401,1963,4934,328,279,166,244,5951
E02004373,Silverhill,Hastings,South East,1721,5375,478,526,292,452,7123,1694,5672,496,518,364,419,7469
E02004374,Old Hastings,Hastings,South East,1329,4732,431,440,295,431,6329,1201,4970,443,435,305,390,6543
E02004375,Braybrooke & Bohemia,Hastings,South East,1480,5555,515,433,243,354,7100,1408,5697,533,466,254,419,7369
E02004376,Central Hastings,Hastings,South East,1126,4911,328,318,153,253,5963,1083,5310,355,326,197,254,6442
E02004377,West St Leonards,Hastings,South East,1909,6265,672,705,484,909,9035,1825,6632,695,657,484,757,9225
E02004378,Central St Leonards,Hastings,South East,1235,5981,496,425,248,383,7533,1279,6142,479,433,299,303,7656
E02004379,"Chailey, Newick & Barcombe",Lewes,South East,1508,4606,554,569,338,439,6506,1365,4716,505,536,395,435,6587
E02004380,"Wivelsfield Green, Ditchling & Rodmell",Lewes,South East,1544,5382,627,605,434,972,8020,1554,5655,613,656,506,888,8318
E02004381,Lewes Central & East,Lewes,South East,1792,6281,555,553,363,592,8344,1685,6511,558,553,427,589,8638
E02004382,"Ringmer, Glynde & South Heighton",Lewes,South East,1130,3559,452,509,362,630,5512,1139,3821,436,502,373,612,5744
E02004383,Lewes West,Lewes,South East,1486,4789,391,429,293,419,6321,1343,5334,449,441,293,473,6990
E02004384,East Saltdean & Telscombe Cliffs,Lewes,South East,1358,4633,506,463,345,570,6517,1208,4613,471,478,341,515,6418
E02004385,Peacehaven West,Lewes,South East,1279,4468,492,528,367,531,6386,1319,4806,528,557,426,608,6925
E02004386,Newhaven Town,Lewes,South East,1185,3928,407,465,333,411,5544,1201,4073,415,441,356,410,5695
E02004387,Newhaven West,Lewes,South East,1521,4001,287,213,167,177,4845,1482,4188,272,246,168,198,5072
E02004388,Peacehaven East,Lewes,South East,1423,4545,417,488,380,578,6408,1440,4839,465,471,392,523,6690
E02004389,East Blatchington,Lewes,South East,1243,4889,790,969,680,1207,8535,1195,4916,778,925,750,1166,8535
E02004390,Seaford Eastbourne Road,Lewes,South East,1337,4129,643,731,530,809,6842,1291,4361,611,777,582,797,7128
E02004391,Seaford Town,Lewes,South East,884,3683,500,516,365,734,5798,854,3741,470,550,363,723,5847
E02004392,"Robertsbridge, Hurst Green & Ticehurst",Rother,South East,1860,5378,593,649,427,545,7592,1724,5698,624,654,483,598,8057
E02004393,"Northiam, Peasmarsh & Camber",Rother,South East,892,3416,582,620,439,546,5603,906,3735,578,648,474,603,6038
E02004394,"Burwash, Sedlescombe & Staplecross",Rother,South East,1214,4554,601,704,417,588,6864,1203,4804,621,677,475,588,7165
E02004395,Rye & Winchelsea,Rother,South East,1221,4515,668,764,479,685,7111,1139,4403,575,703,518,673,6872
E02004396,"Westfield, Fairlight & Broad Oak",Rother,South East,1145,4633,889,990,692,809,8013,1286,5265,845,997,737,873,8717
E02004397,Battle & Catsfield,Rother,South East,1696,4805,571,572,408,683,7039,1533,5017,538,589,471,632,7247
E02004398,Bexhill North & Sidley,Rother,South East,2114,5532,489,551,377,606,7555,2027,5866,422,512,385,545,7730
E02004399,Bexhill East & Pebsham,Rother,South East,1117,4301,677,732,542,887,7139,1110,4376,608,736,588,900,7208
E02004400,"Collington, Cooden & Little Common",Rother,South East,938,4471,1030,1337,891,1463,9192,1055,4933,976,1318,988,1486,9701
E02004401,Kewhurst,Rother,South East,934,3652,725,865,687,1271,7200,824,3577,647,883,705,1200,7012
E02004402,Bexhill Central,Rother,South East,1328,5478,651,722,525,937,8313,1224,5335,619,735,553,930,8172
E02004403,Forest Row & Coleman's Hatch,Wealden,South East,1226,4083,461,467,303,374,5688,1218,4382,480,453,355,407,6077
E02004404,Frant & Groombridge,Wealden,South East,1207,3845,438,411,276,397,5367,1078,3958,414,438,306,381,5497
E02004405,Crowborough North East,Wealden,South East,1241,3655,384,437,309,433,5218,1115,3471,379,443,345,466,5104
E02004406,Crowborough Whitehill & Warren,Wealden,South East,1066,4046,527,699,435,820,6527,1044,4190,509,671,511,826,6707
E02004407,Mayfield & Wadhurst,Wealden,South East,1362,4528,519,569,459,657,6732,1361,4836,547,565,469,666,7083
E02004408,Crowborough South East,Wealden,South East,1449,5172,470,461,259,349,6711,1512,5435,488,493,291,367,7074
E02004409,Chelwood & Nutley,Wealden,South East,812,3193,407,384,307,348,4639,790,3337,415,420,332,410,4914
E02004410,"Buxted, Framfield & Rotherfield",Wealden,South East,1307,4818,610,677,428,565,7098,1256,4814,620,661,492,554,7141
E02004411,Uckfield Town & North,Wealden,South East,1585,5045,538,608,372,494,7057,1508,5286,497,594,460,519,7356
E02004412,Heathfield,Wealden,South East,1315,4764,478,621,417,565,6845,1303,4809,485,582,450,575,6901
E02004413,Broad Oak & Horam,Wealden,South East,1133,3965,494,530,398,585,5972,1127,4245,491,525,432,577,6270
E02004414,Uckfield South,Wealden,South East,1113,4207,299,379,193,275,5353,1159,4279,316,345,235,297,5472
E02004415,"Five Ash Down, Horsted & Chiddingly",Wealden,South East,1196,4102,529,466,297,426,5820,1132,4215,562,470,347,423,6017
E02004416,Herstmonceux & Ninfield,Wealden,South East,1005,3643,518,558,335,431,5485,957,3895,530,564,406,438,5833
E02004417,Hailsham Central & East,Wealden,South East,1007,3379,383,425,402,648,5237,1057,3689,373,444,390,663,5559
E02004418,Hailsham South & West,Wealden,South East,1089,3199,342,420,288,462,4711,1026,3342,341,376,333,501,4893
E02004419,Hailsham East,Wealden,South East,1285,3503,314,375,271,402,4865,1212,3760,321,407,294,436,5218
E02004420,"Hailsham North, Alfriston & East Dean",Wealden,South East,2637,7417,950,1057,735,1075,11234,2501,7968,926,1071,819,1086,11870
E02004421,Polegate,Wealden,South East,1657,5161,553,658,503,839,7714,1587,5248,584,625,518,847,7822
E02004422,"Stone Cross, Westham & Pevensey Bay",Wealden,South East,1880,6149,744,815,561,829,9098,1848,6531,718,847,636,819,9551
E02004423,Willingdon,Wealden,South East,962,3910,570,744,550,796,6570,963,4100,544,707,592,813,6756
E02004675,Tadley West,Basingstoke and Deane,South East,1448,4440,374,422,286,368,5890,1459,4982,409,441,335,388,6555
E02004676,"Tadley East, Pamber & Silchester",Basingstoke and Deane,South East,1284,4475,539,554,350,506,6424,1272,4990,500,586,395,517,6988
E02004677,"Woolton Hill, Burghclere & Bishops Green",Basingstoke and Deane,South East,1651,4347,454,457,288,387,5933,1491,4747,472,459,339,401,6418
E02004678,Kingsclere & Heath End,Basingstoke and Deane,South East,1252,4323,436,478,344,426,6007,1253,4803,456,504,361,472,6596
E02004679,"Bramley, Sherfield & the Sherbornes",Basingstoke and Deane,South East,1885,5895,453,468,314,430,7560,2129,6715,491,476,341,489,8512
E02004680,Chineham,Basingstoke and Deane,South East,1681,5121,330,257,136,140,5984,1633,5517,336,282,205,170,6510
E02004681,Popley,Basingstoke and Deane,South East,3439,9022,412,438,311,291,10474,3666,10135,414,470,339,365,11723
E02004682,Daneshill & Little Basing,Basingstoke and Deane,South East,1711,5513,369,313,196,212,6603,1671,5872,366,338,234,253,7063
E02004683,Houndmills & Oakridge,Basingstoke and Deane,South East,1454,4890,249,262,213,391,6005,1509,5729,278,287,234,397,6925
E02004684,Winklebury & Rooksdown,Basingstoke and Deane,South East,2314,6915,324,364,282,314,8199,2356,7708,329,386,282,372,9077
E02004685,"Basingstoke Central, Black Dam & Eastrop",Basingstoke and Deane,South East,1256,5381,287,257,202,322,6449,1275,6164,286,310,200,364,7324
E02004686,Kings Furlong,Basingstoke and Deane,South East,1581,5714,347,289,204,341,6895,1681,6634,323,323,226,323,7829
E02004687,Buckskin & Worting,Basingstoke and Deane,South East,1865,4707,290,269,203,193,5662,1876,5222,270,289,217,221,6219
E02004688,South Ham & West Ham,Basingstoke and Deane,South East,1508,4899,324,354,277,435,6289,1551,5469,362,380,261,443,6915
E02004689,East Oakley,Basingstoke and Deane,South East,860,2827,415,555,315,463,4575,851,3156,407,514,369,433,4879
E02004690,Viables,Basingstoke and Deane,South East,1457,5057,387,373,225,334,6376,1442,5554,415,415,272,361,7017
E02004691,Old Basing & the Candovers,Basingstoke and Deane,South East,1273,4408,529,542,375,609,6463,1237,4868,566,551,395,666,7046
E02004692,Kempshott,Basingstoke and Deane,South East,1103,3792,547,662,430,545,5976,1052,4237,566,625,482,547,6457
E02004693,Brighton Hill,Basingstoke and Deane,South East,1637,4532,364,306,171,215,5588,1544,5130,350,339,203,232,6254
E02004694,Whitchurch & Ashmansworth,Basingstoke and Deane,South East,1365,4207,372,435,321,434,5769,1415,4633,428,446,331,444,6282
E02004695,Hatch Warren,Basingstoke and Deane,South East,2052,5821,259,242,131,104,6557,1892,6387,334,249,157,115,7242
E02004696,Overton & North Waltham,Basingstoke and Deane,South East,1292,3961,418,442,304,411,5536,1414,4490,432,470,342,420,6154
E02004697,Bentley & Holybourne,East Hampshire,South East,1289,3887,405,466,263,459,5480,1239,4370,418,428,294,476,5986
E02004698,Alton Westbrooke & Eastbrooke,East Hampshire,South East,1279,3741,265,334,213,468,5021,1311,4157,281,306,225,471,5440
E02004699,"Alton Ashdell, Whitedown & Amery",East Hampshire,South East,1777,6416,606,695,513,839,9069,1646,6684,623,728,553,783,9371
E02004700,Bordon Camp,East Hampshire,South East,1290,3737,179,205,95,136,4352,1454,4347,223,203,120,139,5032
E02004702,Bordon & Lindford,East Hampshire,South East,1523,5227,380,371,307,349,6634,1473,5497,419,394,293,330,6933
E02004703,Four Marks & Tisted,East Hampshire,South East,2153,6974,807,949,618,786,10134,2124,7708,841,975,660,775,10959
E02004704,Whitehill & Selborne,East Hampshire,South East,992,3341,369,358,242,287,4597,1017,3794,373,373,285,316,5141
E02004705,Liphook,East Hampshire,South East,1863,5400,487,564,385,642,7478,1832,5948,537,567,421,748,8221
E02004706,Liss & Hawkley,East Hampshire,South East,1407,4418,461,542,349,609,6379,1254,4614,453,533,412,610,6622
E02004707,Petersfield North & East Meon,East Hampshire,South East,2088,6561,735,735,550,854,9435,1934,6930,804,736,616,840,9926
E02004708,Petersfield South,East Hampshire,South East,1725,5394,482,534,443,641,7494,1760,5962,502,548,404,668,8084
E02004709,Clanfield & Finchdean,East Hampshire,South East,1554,4948,534,561,351,461,6855,1587,5387,551,569,417,477,7401
E02004710,Horndean North,East Hampshire,South East,1163,3812,415,461,290,317,5295,1101,4207,394,456,345,367,5769
E02006829,Horndean South & Rowlands Castle,East Hampshire,South East,1082,3889,500,503,420,702,6014,1118,4303,499,493,442,653,6390
E02006838,Headley Down & Grayshott,East Hampshire,South East,956,3817,486,554,429,644,5930,986,4083,498,553,466,626,6226
E02004712,Hiltingbury,Eastleigh,South East,1862,4769,480,594,512,790,7145,1767,5053,441,553,533,802,7382
E02004713,Chandler's Ford East,Eastleigh,South East,1513,4580,522,589,321,517,6529,1563,4857,541,598,360,530,6886
E02004714,Chandler's Ford West,Eastleigh,South East,1245,4529,515,579,340,515,6478,1181,4610,543,574,372,574,6673
E02004715,Boyatt Wood,Eastleigh,South East,1837,5885,438,400,307,447,7477,1733,5689,438,449,299,471,7346
E02004716,Bishopstoke,Eastleigh,South East,1763,5429,473,468,340,430,7140,1734,5587,523,475,353,449,7387
E02004717,Eastleigh West,Eastleigh,South East,2599,7711,440,395,283,540,9369,2905,8296,448,411,298,506,9959
E02004718,Central Eastleigh,Eastleigh,South East,1795,6465,329,258,169,276,7497,1701,6321,376,292,195,301,7485
E02004719,Fair Oak,Eastleigh,South East,2014,6559,563,594,421,538,8675,2053,7150,604,625,453,605,9437
E02004720,West End & Chartwell Green,Eastleigh,South East,1715,6630,719,726,487,786,9348,1775,7055,720,725,557,821,9878
E02004721,Hedge End North & Botley North,Eastleigh,South East,2762,6983,365,295,184,230,8057,2876,7519,347,322,203,255,8646
E02004722,Hedge End Wildern & Botley South,Eastleigh,South East,1345,4147,446,437,314,493,5837,1296,4343,438,421,328,509,6039
E02004723,Hedge End South,Eastleigh,South East,1780,5830,593,601,463,652,8139,1726,6034,575,592,454,671,8326
E02004724,Lowford,Eastleigh,South East,1613,5362,410,388,272,363,6795,1759,5894,446,415,305,354,7414
E02004725,Netley,Eastleigh,South East,906,3187,336,324,238,448,4533,902,3343,329,364,247,439,4722
E02004726,Hamble-le-Rice,Eastleigh,South East,1005,3537,336,380,242,316,4811,1015,3792,358,377,273,331,5131
E02004727,Swanwick & Sarisbury Green,Fareham,South East,2200,6309,413,424,260,352,7758,2171,6625,436,441,300,399,8201
E02004728,Park Gate & Segensworth,Fareham,South East,1731,5759,490,451,337,507,7544,1658,5696,461,506,382,559,7604
E02004729,Fareham North West,Fareham,South East,1300,4596,367,440,348,405,6156,1233,4628,403,425,344,447,6247
E02004730,Fareham Common,Fareham,South East,1296,5063,559,674,456,880,7632,1299,5155,561,615,518,813,7662
E02004731,Locks Heath,Fareham,South East,1297,4858,500,464,367,521,6710,1221,4786,489,483,365,531,6654
E02004732,Warsash,Fareham,South East,1574,5108,505,482,391,557,7043,1569,5553,523,559,421,642,7698
E02004733,Titchfield & Titchfield Common,Fareham,South East,1440,4966,478,479,296,424,6643,1369,4968,492,496,334,460,6750
E02004734,Fareham Town & Cams Hill,Fareham,South East,1635,6825,500,584,448,677,9034,1524,6474,570,606,480,743,8873
E02004735,Fareham West,Fareham,South East,1137,4198,492,610,463,692,6455,1090,4044,479,581,517,722,6343
E02004736,Portchester North West,Fareham,South East,1192,4409,558,682,487,620,6756,1251,4768,513,675,537,653,7146
E02004737,Fareham Fort,Fareham,South East,1528,5040,310,389,245,464,6448,1471,4810,313,352,277,447,6199
E02004738,Portchester South East,Fareham,South East,1148,4394,501,529,343,540,6307,1130,4501,483,515,382,553,6434
E02004739,Stubbington,Fareham,South East,949,3791,466,594,453,732,6036,918,5727,500,593,498,721,8039
E02004740,Hill Head,Fareham,South East,1094,3859,527,672,422,710,6190,1077,3796,506,622,490,721,6135
E02004741,Bridgemary North,Gosport,South East,1409,4690,467,536,332,457,6482,1325,4800,467,549,367,491,6674
E02004742,Bridgemary South,Gosport,South East,1320,4485,489,456,340,431,6201,1206,4427,490,465,343,448,6173
E02004743,Elson,Gosport,South East,1324,4759,390,427,246,310,6132,1276,4596,397,436,310,343,6082
E02004744,Rowner,Gosport,South East,2756,6305,269,249,88,171,7082,2721,6062,296,253,152,206,6969
E02004745,Priddy's Hard & Brockhurst East,Gosport,South East,1674,6031,394,434,236,274,7369,1613,5605,411,425,270,306,7017
E02004746,Lee-on-the-Solent,Gosport,South East,1971,6226,722,895,581,844,9268,1881,6218,733,897,644,898,9390
E02004747,Brockhurst,Gosport,South East,1165,4400,341,358,229,345,5673,1049,5084,382,349,253,370,6438
E02004748,Gosport Town,Gosport,South East,1761,6554,476,494,315,454,8293,1598,6060,471,489,367,465,7852
E02004749,Alverstoke & Privett,Gosport,South East,1110,3782,525,591,395,844,6137,1120,3774,494,572,445,784,6069
E02004750,Clayhall & Anglesey,Gosport,South East,1135,4661,503,497,315,600,6576,1115,4413,526,495,373,571,6378
E02004751,Yateley East,Hart,South East,1380,4730,459,542,408,532,6671,1369,5209,505,532,479,596,7321
E02004752,Yateley West & Eversley,Hart,South East,1541,4845,509,542,310,315,6521,1444,5083,528,551,352,362,6876
E02004753,"Blackwater, Frogmore & Minley",Hart,South East,1894,6541,563,603,483,535,8725,1954,7837,537,613,503,585,10075
E02004754,Hartley Wintney & Heckfield,Hart,South East,1481,4026,388,493,338,457,5702,1388,4426,418,499,371,470,6184
E02004755,"Fleet North, Elvetham Heath & Ancells Farm",Hart,South East,2687,7928,401,403,332,647,9711,2568,8292,390,385,363,663,10093
E02004756,Hook & Rotherwick,Hart,South East,1721,5362,459,467,242,359,6889,1913,6289,441,482,306,344,7862
E02004757,Fleet South & Pondtail,Hart,South East,1457,4434,452,583,420,592,6481,1431,4972,467,575,465,659,7138
E02004758,Fleet West & Winchfield,Hart,South East,1753,5263,436,487,403,611,7200,1763,5906,464,504,401,568,7843
E02004759,Crookham East,Hart,South East,1740,4922,411,491,388,559,6771,1539,5094,404,465,378,580,6921
E02004760,"Crookham West, Ewshot & Crondall",Hart,South East,2483,6068,348,373,268,446,7503,2538,6708,379,381,305,497,8270
E02004761,Odiham & Warnborough,Hart,South East,1258,4284,304,303,266,347,5504,1229,4721,294,338,267,381,6001
E02004764,Waterlooville North West,Havant,South East,1105,4578,558,681,524,814,7155,1084,4811,518,681,530,836,7376
E02004765,Waterlooville North East,Havant,South East,933,3738,370,408,293,353,5162,913,3633,405,403,314,403,5158
E02004766,Waterlooville Central,Havant,South East,1369,4301,306,317,293,470,5687,1291,4532,359,337,284,491,6003
E02004767,Barncroft & Warren Park,Havant,South East,1662,3866,236,206,182,210,4700,1451,3898,257,221,170,216,4762
E02004768,Waterlooville East,Havant,South East,1098,3491,348,278,160,235,4512,1092,3603,359,303,188,210,4663
E02004769,Leigh Park,Havant,South East,1611,3986,231,211,134,198,4760,1656,4412,266,228,156,188,5250
E02004770,West Leigh,Havant,South East,1639,4415,295,267,176,285,5438,1572,4598,297,274,201,310,5680
E02004771,Stockheath Common,Havant,South East,2185,5850,378,372,238,376,7214,2108,5947,407,374,238,368,7334
E02004772,Purbrook & Widley,Havant,South East,1514,5899,563,607,391,606,8066,1448,5959,583,596,458,628,8224
E02004774,Emsworth,Havant,South East,1498,5220,750,833,595,1142,8540,1529,5521,779,803,685,1146,8934
E02004775,Central Havant & Langstone,Havant,South East,1632,6031,634,677,398,726,8466,1617,6323,658,674,462,701,8818
E02004776,Hayling West & North,Havant,South East,745,3181,526,617,420,579,5323,707,3334,518,581,504,608,5545
E02004777,South Hayling,Havant,South East,766,2829,419,540,420,625,4833,686,2816,401,513,447,655,4832
E02004778,Hayling Eastoke,Havant,South East,733,3319,497,643,438,611,5508,728,3403,523,642,485,668,5721
E02006822,Bedhampton,Havant,South East,1487,5627,502,545,341,679,7694,1553,5848,537,598,390,655,8028
E02006830,Cowplain West,Havant,South East,1505,4216,345,343,205,259,5368,1442,4238,314,340,259,282,5433
E02006831,Cowplain East,Havant,South East,898,3585,443,491,322,573,5414,933,3656,442,471,374,570,5513
E02004779,"Fordingbridge, Rockbourne & Woodgreen",New Forest,South East,1647,5868,835,857,568,988,9116,1555,6266,836,868,656,976,9602
E02004780,Totton Calmore,New Forest,South East,1096,3530,361,388,245,388,4912,1090,3782,362,385,257,362,5148
E02004781,West Totton,New Forest,South East,1564,5367,453,380,233,409,6842,1508,5473,437,422,257,338,6927
E02004782,Totton Town,New Forest,South East,1457,4709,444,466,328,593,6540,1362,4996,438,439,336,584,6793
E02004783,Totton Rushington,New Forest,South East,1387,4606,342,325,260,402,5935,1307,4757,359,335,245,398,6094
E02004784,Ashurst & Cadnam,New Forest,South East,746,3108,437,478,335,639,4997,732,3223,405,476,361,652,5117
E02004785,Lyndhurst & Minstead,New Forest,South East,754,3075,450,512,329,546,4912,684,3280,460,488,363,545,5136
E02004786,Marchwood & Dibden,New Forest,South East,1664,5446,497,435,283,311,6972,1543,5176,534,444,320,326,6800
E02004787,Hythe,New Forest,South East,1037,3839,562,717,467,821,6406,980,4099,525,692,528,854,6698
E02004788,Ringwood North & Ibsley,New Forest,South East,1245,3993,515,549,372,497,5926,1201,4429,514,530,414,504,6391
E02004789,Langdown & Dibden Purlieu,New Forest,South East,1999,6097,613,628,505,851,8694,1949,6445,624,614,505,846,9034
E02004790,Ringwood South,New Forest,South East,1468,4534,478,472,408,739,6631,1375,4903,427,521,421,728,7000
E02004791,Holbury South,New Forest,South East,1241,3269,339,292,218,249,4367,1181,3483,336,318,228,260,4625
E02004792,"Holbury North, Blackfield & Fawley",New Forest,South East,1282,4616,709,695,486,651,7157,1298,4965,706,727,503,677,7578
E02004793,Brockenhurst & Sway,New Forest,South East,1029,3941,610,673,509,805,6538,1061,4293,587,659,523,826,6888
E02004794,Bransgore & Burley,New Forest,South East,1145,3778,542,615,351,532,5818,1127,3998,578,608,397,570,6151
E02004795,Lymington Town & Boldre,New Forest,South East,1226,5217,701,736,550,981,8185,1202,5502,680,761,587,946,8476
E02004796,Hordle & Bashley,New Forest,South East,1269,4915,845,1029,750,1019,8558,1220,5192,805,1026,777,988,8788
E02004797,Lymington North & West,New Forest,South East,1455,4804,562,507,362,523,6758,1406,5160,541,529,400,545,7175
E02004798,New Milton West,New Forest,South East,1204,3625,327,425,285,464,5126,1106,3975,339,397,320,450,5481
E02004799,New Milton East,New Forest,South East,1104,4032,558,745,589,1115,7039,1063,4353,524,688,596,1072,7233
E02004800,Barton on Sea,New Forest,South East,574,3181,789,994,786,1340,7090,564,3353,744,950,822,1267,7136
E02004801,Milford & Lymington South,New Forest,South East,848,3388,739,986,711,1302,7126,846,3566,665,954,775,1221,7181
E02004802,Hawley Lane & Fox Lane,Rushmoor,South East,1317,4088,325,338,206,347,5304,1251,4702,317,341,258,380,5998
E02004803,Mayfield,Rushmoor,South East,1537,4756,291,297,210,219,5773,1561,5567,330,354,235,247,6733
E02004804,Pinewood,Rushmoor,South East,1315,4324,374,389,258,267,5612,1263,4717,369,432,271,279,6068
E02004805,Farnborough Hill,Rushmoor,South East,1450,5215,421,385,293,400,6714,1470,5792,415,467,364,444,7482
E02004806,Cove & Southwood,Rushmoor,South East,1670,5117,377,284,212,240,6230,1643,5458,385,357,223,275,6698
E02004807,Farnborough Town,Rushmoor,South East,1833,5803,369,418,295,471,7356,1838,6344,425,410,351,504,8034
E02004808,South Farnborough & North Camp,Rushmoor,South East,2540,7545,333,332,216,391,8817,2352,7608,409,364,273,401,9055
E02004809,Aldershot Town,Rushmoor,South East,2230,6496,204,213,136,168,7217,2546,8948,255,330,251,196,9980
E02004810,Aldershot North Town,Rushmoor,South East,1549,5215,226,236,161,198,6036,1608,5757,302,260,200,233,6752
E02004811,Aldershot Rowhill,Rushmoor,South East,1192,4842,365,388,277,468,6340,1241,5661,444,438,338,477,7358
E02004812,Aldershot Manor Park,Rushmoor,South East,1196,4259,303,300,215,221,5298,1164,4774,357,342,237,258,5968
E02004813,Aldershot Park,Rushmoor,South East,1187,3836,262,279,186,323,4886,1244,4423,303,275,218,330,5549
E02004814,Andover Charlton & Bourne Valley,Test Valley,South East,1187,4445,403,440,252,326,5866,1177,4643,387,427,305,337,6099
E02004815,Andover Newbury Road,Test Valley,South East,1897,4948,257,253,166,147,5771,1832,5386,267,228,181,163,6225
E02004816,Andover London Road & East Anton,Test Valley,South East,4147,10628,592,601,400,597,12818,4655,12398,597,638,499,583,14715
E02004817,Andover Central,Test Valley,South East,1431,5071,378,398,289,442,6578,1331,5205,377,407,264,428,6681
E02004818,Andover West,Test Valley,South East,1795,5940,566,647,497,658,8308,1641,5939,558,679,505,690,8371
E02004819,Andover South,Test Valley,South East,1322,4969,393,426,325,624,6737,1218,5111,425,395,362,604,6897
E02004820,Over Wallop & Shipton Bellinger,Test Valley,South East,1312,4418,425,431,287,381,5942,1271,4496,398,464,305,400,6063
E02004821,"Chilbolton, Clatford & Barton Stacey",Test Valley,South East,853,2939,348,474,293,358,4412,851,2985,354,416,341,345,4441
E02004822,"Nether Wallop, Kings Somborne & Dunbridge",Test Valley,South East,1274,4425,533,576,402,564,6500,1269,4820,572,581,414,560,6947
E02004823,Romsey Cupernham & Halterworth,Test Valley,South East,1467,4785,637,688,445,632,7187,1410,5284,573,694,510,631,7692
E02004824,Romsey Town,Test Valley,South East,790,3071,385,496,395,831,5178,692,3191,341,504,411,846,5293
E02004825,North Baddesley & Braishfield,Test Valley,South East,1894,5972,699,792,629,762,8854,1848,6447,668,820,660,822,9417
E02004826,Abbotswood & West Wellow,Test Valley,South East,1659,4726,520,617,390,580,6833,1824,5815,581,605,456,558,8015
E02004827,Valley Park,Test Valley,South East,1570,4854,357,306,170,239,5926,1558,5141,380,341,221,252,6335
E02004828,"Chilworth, Nursling & Rownhams",Test Valley,South East,1096,3866,504,415,300,471,5556,1172,4437,519,493,312,463,6224
E02004829,"South Wonston, Sutton Scotney & Micheldever",Winchester,South East,1189,3444,340,361,231,313,4689,1175,3421,337,359,254,331,4702
E02004830,Springvale & Itchen Abbas,Winchester,South East,1346,4066,416,429,297,322,5530,1264,6039,389,395,308,356,7487
E02004831,Winchester North & Sparsholt,Winchester,South East,1963,5294,470,570,423,985,7742,1980,6136,472,538,439,934,8519
E02004832,New Alresford,Winchester,South East,1375,4602,592,654,512,726,7086,1274,4972,557,645,570,813,7557
E02004833,Winchester West,Winchester,South East,1952,6228,404,449,322,612,8015,1951,7563,425,450,370,608,9416
E02004834,Winchester East,Winchester,South East,1428,5322,320,376,254,446,6718,1298,5882,364,301,272,411,7230
E02004835,Winchester Central & South,Winchester,South East,1865,7203,409,523,341,655,9131,1730,8214,445,479,393,661,10192
E02004836,Winchester Stanmore,Winchester,South East,1038,4990,191,180,156,227,5744,1023,4992,205,195,154,204,5750
E02004837,Oliver's Battery and Hursley,Winchester,South East,1576,4819,472,506,321,482,6600,1526,5299,423,522,354,501,7099
E02004838,Colden Common & Twyford,Winchester,South East,1957,5396,563,632,401,577,7569,1909,5854,551,651,438,609,8103
E02004839,"Swanmore, Hambledon & West Meon",Winchester,South East,1563,4907,626,623,430,558,7144,1605,5495,687,611,450,583,7826
E02004840,Bishop's Waltham & Waltham Chase,Winchester,South East,1699,5496,639,669,476,696,7976,1725,6137,633,707,543,721,8741
E02004841,"Whiteley, Knowle & Wickham",Winchester,South East,2274,7213,611,572,391,647,9434,2117,7482,581,611,428,600,9702
E02004842,Denmead & Southwick,Winchester,South East,1918,6041,603,588,432,674,8338,2126,6597,633,610,446,714,9000
E02004996,"Wye, Chilham & Kennington",Ashford,South East,1704,4893,442,500,340,517,6692,1809,5512,489,515,412,515,7443
E02004997,"Charing, Pluckley & Challock",Ashford,South East,1282,4485,570,630,440,564,6689,1330,5087,578,673,464,583,7385
E02004998,Kennington & Little Burton Farm,Ashford,South East,1286,3956,357,410,311,411,5445,1240,4342,375,418,352,441,5928
E02004999,"Bybrook, Orchard Park & Godinton",Ashford,South East,3472,9359,690,679,503,638,11869,3508,10475,684,720,517,676,13072
E02005000,Ashford Central,Ashford,South East,2782,7624,417,393,284,344,9062,2544,8470,408,423,327,340,9968
E02005001,Highfield & Willesborough,Ashford,South East,1711,5486,505,548,340,440,7319,1827,6203,538,569,368,486,8164
E02005002,Beaver & Singtleton,Ashford,South East,2211,5874,423,377,289,361,7324,2236,6485,402,412,314,376,7989
E02005003,Washford & Stanhope,Ashford,South East,2549,6204,316,318,180,214,7232,2403,6857,331,344,234,239,8005
E02005004,Park Farm,Ashford,South East,2902,8240,391,350,253,289,9523,2693,8549,444,417,276,363,10049
E02005005,Brabourne Lees & North Romney,Ashford,South East,2056,5610,534,654,364,454,7616,2126,6278,581,631,430,479,8399
E02005006,"Biddenden, Smarden & High Halden",Ashford,South East,1005,3273,395,482,292,413,4855,1063,3720,386,492,371,446,5415
E02005007,"Great Chart, Bethersden & Woodchurch",Ashford,South East,1695,5488,541,632,376,527,7564,1729,5836,590,576,462,573,8037
E02005008,Tenterden & Rolvenden,Ashford,South East,1156,4206,616,780,614,960,7176,1181,4579,614,780,682,995,7650
E02005009,Hamstreet & Isle of Oxney,Ashford,South East,1051,3194,418,513,323,356,4804,1017,3598,442,499,361,399,5299
E02005010,Herne Bay Parade,Canterbury,South East,1462,4803,481,441,299,581,6605,1321,5021,463,449,341,558,6832
E02005011,Beltinge & Bishopstone,Canterbury,South East,1055,3919,621,794,485,784,6603,1027,4136,640,778,588,791,6933
E02005012,Herne Bay South & Greenhill,Canterbury,South East,1621,5049,583,648,439,602,7321,1535,5406,603,649,486,596,7740
E02005013,"Hampton, West End & Swalecliffe",Canterbury,South East,1374,4702,563,668,451,663,7047,1305,5014,570,694,499,671,7448
E02005014,Chestfield & South Tankerton,Canterbury,South East,1171,4544,786,842,598,843,7613,1167,4777,736,845,624,861,7843
E02005015,Herne & Broomfield,Canterbury,South East,1992,5707,528,596,384,464,7679,1938,5935,560,615,418,494,8022
E02005016,Whitstable Central & Tankerton,Canterbury,South East,1371,4483,566,533,394,592,6568,1369,4966,540,550,423,546,7025
E02005017,Whitstable West,Canterbury,South East,1148,4166,418,423,299,462,5768,1049,4470,419,481,336,459,6165
E02005018,Seasalter,Canterbury,South East,1559,4958,607,710,520,617,7412,1484,5418,630,696,545,624,7913
E02005019,"Hoath, Hersden & Littlebourne",Canterbury,South East,1189,3820,418,400,244,439,5321,1168,4461,441,435,288,442,6067
E02005020,Sturry and Fordwich,Canterbury,South East,1409,4414,447,438,343,465,6107,1453,4877,456,443,369,435,6580
E02005021,"Blean Forest, Chartham Hatch & University",Canterbury,South East,1181,9084,379,538,379,430,10810,1147,11898,380,507,391,511,13687
E02005022,Canterbury St Stephen's,Canterbury,South East,1073,7065,263,298,158,281,8065,1104,5808,260,287,198,268,6821
E02005023,Canterbury Barracks,Canterbury,South East,1801,7649,246,227,142,298,8562,1883,7789,272,273,162,286,8782
E02005025,South Canterbury,Canterbury,South East,1284,8120,396,444,315,513,9788,1237,8602,440,485,316,522,10365
E02005026,Thanington & Chartham,Canterbury,South East,1666,4882,431,401,300,401,6415,1617,5361,476,451,322,377,6987
E02005027,"Bridge, Bishopsbourne & Barham",Canterbury,South East,860,3164,371,381,282,495,4693,849,3416,374,398,298,457,4943
E02006855,Canterbury Wincheap,Canterbury,South East,1220,5210,182,191,85,182,5850,1248,5105,226,189,123,178,5821
E02006856,Canterbury Central & Westgate,Canterbury,South East,1804,9275,401,371,289,591,10927,1821,9058,400,395,315,544,10712
E02005028,Temple Hill & Marshes,Dartford,South East,3919,7936,270,201,170,333,8910,4256,8939,309,255,159,329,9991
E02005029,Ebbsfleet & Greenhithe,Dartford,South East,3171,8943,334,230,139,202,9848,3622,9170,328,290,167,204,10159
E02005030,Central Dartford & West Hill,Dartford,South East,2670,7601,357,273,233,328,8792,2776,8272,384,336,281,338,9611
E02005031,Swanscombe,Dartford,South East,1937,5763,286,225,150,247,6671,1952,5537,318,242,177,243,6517
E02005032,Newtown,Dartford,South East,2202,6932,294,254,188,255,7923,2218,6801,303,297,188,258,7847
E02005033,Stone & Crossways,Dartford,South East,1683,4944,265,261,187,185,5842,1750,5021,277,296,178,201,5973
E02005034,Heath,Dartford,South East,1478,4692,395,397,244,353,6081,1472,5127,377,431,275,388,6598
E02005035,Brent & Fleet Estate,Dartford,South East,1813,5256,344,390,245,457,6692,1901,5638,383,399,266,464,7150
E02005036,Tree Estate,Dartford,South East,1621,4079,244,250,178,238,4989,1590,4503,274,255,183,234,5449
E02005037,Joydens Wood,Dartford,South East,1368,4154,332,435,298,568,5787,1331,4465,378,440,327,581,6191
E02005038,Wilmington & Hawley,Dartford,South East,1020,3343,379,342,272,480,4816,1043,3570,358,380,260,461,5029
E02005039,"Bean, Darenth & Sutton at Hone",Dartford,South East,1387,4062,352,350,273,358,5395,1429,4556,401,350,281,344,5932
E02005040,"Longfield, New Barn & Southfleet",Dartford,South East,1102,3656,439,450,353,591,5489,1117,4074,476,473,365,627,6015
E02005041,Ash & Wingham,Dover,South East,1179,4182,519,526,371,434,6032,1149,4380,480,546,415,471,6292
E02005042,Sandwich & Eastry,Dover,South East,1402,5089,668,788,495,752,7792,1240,5237,701,761,556,743,7998
E02005043,Deal North & West,Dover,South East,1099,4282,549,607,378,598,6414,1057,4327,545,577,447,611,6507
E02005044,Deal East,Dover,South East,756,3860,537,594,372,488,5851,678,3571,510,569,434,514,5598
E02005045,"Mill Hill, Upper Deal & Northbourne",Dover,South East,1862,5650,554,553,347,474,7578,1918,5631,572,505,394,475,7577
E02005046,Aylesham & Elvington,Dover,South East,1820,4755,351,420,294,288,6108,2040,5442,373,408,303,320,6846
E02005047,Walmer,Dover,South East,1314,4306,523,549,413,662,6453,1330,4546,557,525,468,621,6717
E02005048,Eythorne & Shepherdswell,Dover,South East,997,3842,530,567,350,497,5786,931,3820,537,547,366,484,5754
E02005049,Kingsdown & St Margaret's-at-Cliffe,Dover,South East,855,3513,700,769,527,691,6200,814,3497,666,724,598,698,6183
E02005050,"Kearsney, River & Whitfield",Dover,South East,1614,5626,615,677,453,762,8133,1538,5472,607,679,511,769,8038
E02005051,Buckland & St Radigunds,Dover,South East,3383,8987,537,553,302,419,10798,3234,9032,561,540,322,391,10846
E02005052,Dover East,Dover,South East,1361,5188,432,420,290,432,6762,1684,5514,441,402,310,433,7100
E02005053,Dover West,Dover,South East,2132,6447,416,370,180,294,7707,2087,6499,454,359,210,295,7817
E02005054,Elms Vale & Capel-le-Ferne,Dover,South East,942,3899,547,575,358,422,5801,982,3904,527,595,401,454,5881
E02005055,Northfleet North,Gravesham,South East,2450,5539,248,258,138,183,6366,2467,5938,277,239,157,195,6806
E02005056,Gravesend Town,Gravesham,South East,2156,7303,404,277,264,443,8691,2228,8296,428,364,253,464,9805
E02005057,Milton & Chalk,Gravesham,South East,2729,7526,365,392,244,432,8959,2886,8360,414,428,261,452,9915
E02005058,Perry Street,Gravesham,South East,1982,5048,334,266,205,297,6150,2000,5582,345,316,191,289,6723
E02005059,Windmill Hill,Gravesham,South East,1812,6178,480,443,315,521,7937,1806,6515,520,441,344,554,8374
E02005060,Northfleet South,Gravesham,South East,1749,4812,367,365,273,518,6335,1854,5386,384,362,289,486,6907
E02005061,Westcourt,Gravesham,South East,1692,4356,316,346,240,320,5578,1795,4989,333,341,268,381,6312
E02005062,Riverview Park,Gravesham,South East,1503,4032,386,370,278,417,5483,1518,4505,357,368,293,425,5948
E02005063,Gravesend South & Coldharbour,Gravesham,South East,1421,4168,320,339,239,374,5440,1513,4662,348,345,255,369,5979
E02005064,Higham & Shorne,Gravesham,South East,1072,3873,446,485,350,461,5615,1088,4115,458,491,386,492,5942
E02005065,Singlewell,Gravesham,South East,2052,5058,321,297,208,369,6253,2079,5509,306,300,233,338,6686
E02005066,Istead Rise & Meopham,Gravesham,South East,1236,4243,505,626,464,618,6456,1281,4644,518,601,512,665,6940
E02005067,Sole Street & Vigo,Gravesham,South East,1029,3365,363,436,300,329,4793,1040,3748,396,446,301,354,5245
E02005068,Boxley & Detling,Maidstone,South East,1272,4601,369,394,202,268,5834,1294,4696,383,399,221,243,5942
E02005069,Penenden Heath,Maidstone,South East,1827,5477,458,536,287,519,7277,1731,5641,458,545,343,496,7483
E02005070,Allington,Maidstone,South East,1554,5043,562,706,550,891,7752,1606,5374,532,707,543,913,8069
E02005071,Ringlestone & Central Maidstone,Maidstone,South East,2299,8522,330,302,150,378,9682,2068,8742,386,322,203,370,10023
E02005072,Grove Green,Maidstone,South East,1507,4331,514,573,341,376,6135,1509,4706,521,596,387,438,6648
E02005073,Maidstone West,Maidstone,South East,2332,8745,407,332,233,441,10158,2250,8772,411,410,233,452,10278
E02005074,Bearsted & Downswood,Maidstone,South East,1508,4526,513,611,410,608,6668,1463,4804,475,604,439,640,6962
E02005075,Barming,Maidstone,South East,2489,6853,390,382,272,401,8298,2403,7390,434,364,286,371,8845
E02005076,Tovil,Maidstone,South East,2346,6646,289,265,186,344,7730,2203,6802,305,286,190,343,7926
E02005077,Mote Park,Maidstone,South East,1774,4858,416,435,288,422,6419,1687,5250,400,456,322,400,6828
E02005078,"Harrietsham, Hollingbourne & Lenham",Maidstone,South East,1559,5218,615,679,442,652,7606,1668,5922,652,720,494,623,8411
E02005079,Loose Valley & Boughton Monchelsea,Maidstone,South East,1798,4948,499,593,439,601,7080,1743,5190,480,599,473,587,7329
E02005080,Parkwood & Senacre,Maidstone,South East,3395,7240,406,527,384,557,9114,3145,7682,445,511,404,531,9573
E02005081,Yalding & Farleigh,Maidstone,South East,1076,3583,487,530,416,520,5536,1121,4135,521,552,429,561,6198
E02005082,"Kingswood, Langley Heath & Chart Sutton",Maidstone,South East,2270,7151,536,609,368,507,9171,2542,7778,583,612,430,538,9941
E02005083,Loose & Coxheath,Maidstone,South East,1266,4257,458,509,379,485,6088,1432,4564,445,477,403,502,6391
E02005084,Headcorn & Sutton Valence,Maidstone,South East,1404,4409,393,470,312,431,6015,1445,4720,412,451,372,458,6413
E02005085,Marden,Maidstone,South East,1413,4528,417,344,282,364,5935,1646,5378,431,398,282,367,6856
E02005086,Staplehurst,Maidstone,South East,1196,3597,422,404,255,365,5043,1187,3987,410,415,320,375,5507
E02005087,Swanley East & Hextable,Sevenoaks,South East,1298,4268,423,511,275,417,5894,1340,4540,429,498,323,483,6273
E02005088,Swanley West,Sevenoaks,South East,2089,5845,479,431,297,530,7582,2252,6389,443,475,295,526,8128
E02005089,Swanley South & Crockenhill,Sevenoaks,South East,1200,3960,305,388,295,429,5377,1317,4291,343,362,310,408,5714
E02005090,Hartley & Hodsoll Street,Sevenoaks,South East,892,3160,377,556,398,559,5050,904,3375,375,467,435,631,5283
E02005091,Darenth Valley,Sevenoaks,South East,1222,4125,408,421,316,491,5761,1179,4172,443,424,327,488,5854
E02005093,West Kingsdown,Sevenoaks,South East,893,3218,481,521,382,481,5083,918,3541,437,517,395,471,5361
E02005094,"Knockholt, Shoreham & Dunton Green",Sevenoaks,South East,1995,5725,479,459,347,476,7486,1998,6029,503,494,369,532,7927
E02005095,Kemsing & Otford,Sevenoaks,South East,1588,4118,427,477,347,545,5914,1578,4547,413,435,371,544,6310
E02005096,Sevenoaks North,Sevenoaks,South East,2373,5961,480,443,294,581,7759,2319,6414,412,471,315,536,8148
E02005097,Sevenoaks West & Chevening,Sevenoaks,South East,2546,5669,466,485,316,585,7521,2426,6032,442,472,367,575,7888
E02005098,Sevenoaks Town & Weald,Sevenoaks,South East,2150,6101,483,486,368,863,8301,2092,6663,455,508,416,846,8888
E02005099,Westerham & Brasted,Sevenoaks,South East,1503,4648,496,495,335,411,6385,1470,4819,513,488,378,458,6656
E02005100,Edenbridge,Sevenoaks,South East,2028,5778,492,530,368,569,7737,2009,6059,471,531,426,578,8065
E02005101,"Hever, Leigh & Penshurst",Sevenoaks,South East,1388,4176,466,420,283,346,5691,1391,4491,447,460,301,360,6059
E02006832,New Ash Green,Sevenoaks,South East,1254,3481,447,440,217,205,4790,1244,3580,421,450,293,225,4969
E02005102,"Lyminge, Densole & Elham",Folkestone and Hythe,South East,790,3533,548,663,331,529,5604,789,3631,538,620,414,520,5723
E02005103,Hawkinge,Folkestone and Hythe,South East,2190,6431,415,577,316,393,8132,2122,6495,421,571,398,453,8338
E02005104,Folkestone North East,Folkestone and Hythe,South East,1654,4855,484,482,308,372,6501,1595,5154,454,506,303,414,6831
E02005105,Folkestone Foord,Folkestone and Hythe,South East,1904,5063,349,261,159,226,6058,1908,5207,342,286,180,198,6213
E02005106,Cheriton & Horn Street,Folkestone and Hythe,South East,2026,5998,527,503,317,376,7721,2063,6418,490,528,326,402,8164
E02005107,Folkestone Morehall & Sandgate,Folkestone and Hythe,South East,2353,7693,831,934,561,764,10783,2258,9066,801,908,608,830,12213
E02005109,"Saltwood, Seabrook & Etchinghill",Folkestone and Hythe,South East,842,3366,587,705,503,818,5979,847,3520,553,676,541,836,6126
E02005110,Lympne & Palmarsh,Folkestone and Hythe,South East,1008,3945,534,608,426,506,6019,1074,4146,530,571,450,504,6201
E02005111,Hythe,Folkestone and Hythe,South East,955,3806,657,708,506,858,6535,914,3933,592,684,530,775,6514
E02005112,"Dymchurch, St Mary's Bay & Brookland",Folkestone and Hythe,South East,935,3827,641,746,457,570,6241,936,4031,623,694,501,578,6427
E02005113,New Romney,Folkestone and Hythe,South East,1084,3903,583,679,466,667,6298,1053,3996,569,676,513,678,6432
E02005114,Lydd & Dungeness,Folkestone and Hythe,South East,1173,3737,465,513,343,399,5457,1075,3696,443,510,370,419,5438
E02006879,Folkestone Harbour,Folkestone and Hythe,South East,1316,5175,305,288,181,324,6273,1313,4699,304,266,196,274,5739
E02006880,Folkestone Central,Folkestone and Hythe,South East,886,4517,432,395,314,621,6279,875,4303,399,413,317,531,5963
E02005115,Sheerness East,Swale,South East,1824,4153,239,200,111,150,4853,1800,4383,251,200,136,159,5129
E02005116,Sheerness West,Swale,South East,1783,3913,269,294,215,267,4958,1613,4285,315,281,216,257,5354
E02005117,Minster North,Swale,South East,932,3592,483,611,382,388,5456,1020,4006,489,574,410,425,5904
E02005118,Minster South,Swale,South East,2379,6600,497,531,357,433,8418,2273,6935,470,531,359,491,8786
E02005119,Queenborough,Swale,South East,1287,3611,382,435,261,329,5018,1322,4008,400,422,305,304,5439
E02005120,Sheppey East,Swale,South East,1239,5409,631,617,385,375,7417,1326,6614,612,674,404,380,8684
E02005121,Iwade & Kemsley,Swale,South East,3477,9131,522,479,285,319,10736,3269,9569,567,559,299,298,11292
E02005122,"Newington, Halstow & Upchurch",Swale,South East,1211,4396,482,498,310,451,6137,1383,4769,437,522,352,426,6506
E02005123,Borden & The Meads,Swale,South East,2728,7905,595,606,378,496,9980,2762,8197,564,613,427,522,10323
E02005124,Sittingbourne Central & Milton Regis,Swale,South East,2031,5486,355,413,246,430,6930,1960,5704,369,389,258,406,7126
E02005125,Sittingbourne East,Swale,South East,1882,5245,428,390,250,305,6618,1918,5322,402,394,250,326,6694
E02005126,Sittingbourne West,Swale,South East,1573,4624,473,573,391,571,6632,1530,4707,375,555,436,604,6677
E02005127,"Sittingbourne South, Bapchild & Bredgar",Swale,South East,1616,5219,529,574,414,569,7305,1576,5479,501,559,471,549,7559
E02005128,Faversham West,Swale,South East,1685,5089,461,558,393,465,6966,1631,5589,470,552,387,507,7505
E02005129,Faversham East,Swale,South East,2143,6798,672,690,485,666,9311,2069,7250,667,694,496,723,9830
E02005130,Teynham & Badlesmere,Swale,South East,1678,5392,516,507,378,467,7260,1721,5895,557,531,399,509,7891
E02005131,Boughton & Selling,Swale,South East,1023,4184,387,440,272,313,5596,997,6092,384,436,313,332,7557
E02005132,Cliftonville West,Thanet,South East,2803,6980,470,384,294,513,8641,2700,7957,460,422,287,484,9610
E02005133,Cliftonville East & Kingsgate,Thanet,South East,1235,4354,737,841,598,839,7369,1232,4806,676,873,638,833,7826
E02005134,Margate Town,Thanet,South East,1873,5149,312,331,161,225,6178,1773,5558,326,315,186,188,6573
E02005135,Salmestone,Thanet,South East,1718,4969,382,380,251,366,6348,1722,5118,398,352,276,346,6490
E02005136,Westbrook & Garlinge,Thanet,South East,1407,4608,523,505,359,458,6453,1441,4807,533,520,385,484,6729
E02005137,Dane Valley & Northdown Hill,Thanet,South East,2032,4619,429,402,297,315,6062,1989,5170,430,404,261,329,6594
E02005138,Westgate,Thanet,South East,1531,5248,604,729,449,703,7733,1524,5374,606,663,516,736,7895
E02005139,Birchington,Thanet,South East,1068,4052,862,961,727,1055,7657,1094,4234,769,967,775,1111,7856
E02005140,Broadstairs North,Thanet,South East,1156,3875,555,762,501,763,6456,1095,4114,513,706,540,751,6624
E02005141,Broadstairs South,Thanet,South East,1139,4083,554,639,370,582,6228,1146,4138,530,615,401,536,6220
E02005142,"Westwood, Northwood & Bromstone",Thanet,South East,1183,4119,545,545,429,575,6213,1177,4364,519,585,436,595,6499
E02005143,Dumpton,Thanet,South East,1761,4908,445,450,325,464,6592,1684,5317,470,473,343,438,7041
E02005144,Newington,Thanet,South East,2121,5325,444,393,263,355,6780,2193,5967,414,420,275,320,7396
E02005145,Minster & St-Nicholas-at-Wade,Thanet,South East,1248,4354,547,613,373,456,6343,1315,4716,572,583,461,447,6779
E02005146,Ramsgate Ellington,Thanet,South East,1918,5132,404,335,212,226,6309,1828,5384,378,353,205,241,6561
E02005147,Ramsgate Harbour,Thanet,South East,1549,5431,563,501,324,402,7221,1551,5781,516,532,353,434,7616
E02005148,"Nethercourt, Pegwell & Cliffsend",Thanet,South East,1088,4066,639,699,483,622,6509,1130,4457,622,670,557,669,6975
E02005149,"Aylesford, Wouldham & Blue Bell Hill",Tonbridge and Malling,South East,2092,6961,517,575,418,481,8952,2166,7281,556,569,463,496,9365
E02005150,Snodland,Tonbridge and Malling,South East,2459,7609,541,487,333,444,9414,2480,7413,554,515,360,453,9295
E02005151,Larkfield & New Hythe,Tonbridge and Malling,South East,2635,7754,657,705,530,544,10190,2618,8155,697,689,557,633,10731
E02005153,Ditton,Tonbridge and Malling,South East,1955,5610,500,565,406,566,7647,1962,5674,466,550,405,624,7719
E02005154,"Borough Green, Wrotham & Shipbourne",Tonbridge and Malling,South East,2469,6993,659,683,452,705,9492,2440,7520,637,700,535,741,10133
E02005155,Kings Hill & Wateringbury,Tonbridge and Malling,South East,3284,7854,460,529,346,353,9542,3053,8087,498,568,383,392,9928
E02005156,Hadlow & East Peckham,Tonbridge and Malling,South East,1237,4335,439,460,355,446,6035,1185,4393,461,494,375,476,6199
E02005157,Tonbridge Trench Wood,Tonbridge and Malling,South East,1435,3905,392,395,333,478,5503,1339,4021,349,410,342,508,5630
E02005158,Hildenborough,Tonbridge and Malling,South East,1363,3910,386,397,293,459,5445,1279,4112,387,430,308,460,5697
E02005159,Tonbridge Higham Wood,Tonbridge and Malling,South East,1561,4270,421,486,450,639,6266,1507,4653,403,497,422,681,6656
E02005160,Tonbridge Town,Tonbridge and Malling,South East,2602,8124,374,475,347,638,9958,2654,8386,427,485,372,660,10330
E02005161,Tonbridge South & Haysden,Tonbridge and Malling,South East,1742,5726,326,337,170,330,6889,1746,5864,341,343,208,352,7108
E02006833,"East Malling, West Malling & Trottiscliffe",Tonbridge and Malling,South East,2228,7137,742,689,500,690,9758,2430,7776,723,750,525,671,10445
E02005162,Paddock Wood & Five Oak Green,Tunbridge Wells,South East,1949,6229,628,660,434,586,8537,1886,6701,603,653,476,604,9037
E02005163,Southborough West,Tunbridge Wells,South East,1802,5085,332,423,247,366,6453,1764,5300,346,397,270,370,6683
E02005164,Southborough East & Longfield Road,Tunbridge Wells,South East,1820,5311,354,349,298,398,6710,1885,5716,336,370,290,424,7136
E02005165,Pembury & Matfield,Tunbridge Wells,South East,1374,4406,477,545,353,557,6338,1334,4692,450,516,400,512,6570
E02005166,High Brooms & Sherwood,Tunbridge Wells,South East,1762,4529,287,256,191,257,5520,1572,4704,273,257,183,249,5666
E02005167,"Langton Green, Speldhurst & Bidborough",Tunbridge Wells,South East,1639,4343,492,501,329,558,6223,1615,4636,459,514,348,536,6493
E02005168,Tunbridge Wells West,Tunbridge Wells,South East,1702,4840,316,313,221,515,6205,1612,5089,320,314,248,534,6505
E02005169,Tunbridge Wells Central,Tunbridge Wells,South East,1640,7145,343,283,210,318,8299,1585,7124,324,346,209,308,8311
E02005170,Ferndale & Hawkenbury,Tunbridge Wells,South East,2120,6200,431,412,318,713,8074,2051,6407,394,414,345,700,8260
E02005171,Ramslye & Rusthall,Tunbridge Wells,South East,1406,3903,275,293,223,376,5070,1331,4159,269,295,225,345,5293
E02005172,"Goudhurst, Horsmonden & Lamberhurst",Tunbridge Wells,South East,1788,5223,447,529,325,421,6945,1669,5530,497,493,412,424,7356
E02005173,Tunbridge Wells South,Tunbridge Wells,South East,1586,5213,446,473,385,591,7108,1597,5497,461,475,395,588,7416
E02005174,"Cranbrook, Sissinghurst & Frittenden",Tunbridge Wells,South East,1480,4304,463,490,339,603,6199,1583,4938,442,494,392,587,6853
E02005175,"Hawkhurst, Benenden & Sandhurst",Tunbridge Wells,South East,1881,4988,491,579,413,623,7094,1819,5366,534,575,426,567,7468
E02005921,"Cropredy, Wroxton & Shennington",Cherwell,South East,901,3378,406,389,278,400,4851,1103,4180,443,399,323,403,5748
E02005922,Banbury Hardwick,Cherwell,South East,1804,5439,311,292,204,191,6437,1794,6131,333,319,223,211,7217
E02005923,Banbury Neithrop,Cherwell,South East,1386,3582,240,230,154,289,4495,1367,4352,251,231,175,247,5256
E02005924,Banbury Grimsbury,Cherwell,South East,2360,8124,352,291,248,488,9503,2397,9623,404,347,264,496,11134
E02005925,Banbury Ruscote,Cherwell,South East,2213,5051,344,341,248,255,6239,2264,6193,363,383,244,311,7494
E02005926,Banbury Easington,Cherwell,South East,1392,4802,480,568,462,696,7008,1433,5641,509,596,469,752,7967
E02005927,Banbury Calthorpe,Cherwell,South East,909,3035,294,335,225,282,4171,964,3692,276,374,250,245,4837
E02005928,"Bodicote, Adderbury & Bloxham",Cherwell,South East,2108,5466,510,601,434,608,7619,2359,6736,528,640,485,594,8983
E02005929,"Sibford, Hook Norton & Milcombe",Cherwell,South East,1293,3916,489,544,318,408,5675,1328,4652,514,551,355,429,6501
E02005930,"Deddington, Steeple Aston & Heyfords",Cherwell,South East,1705,4920,499,561,334,458,6772,1784,5720,539,553,354,510,7676
E02005931,"Caversfield, Ambrosden & Fringford",Cherwell,South East,2194,6412,444,433,243,432,7964,2259,6932,482,455,282,423,8574
E02005932,Bicester North,Cherwell,South East,1381,4491,272,187,130,93,5173,1369,4996,259,209,134,108,5706
E02005933,Bicester East,Cherwell,South East,1427,4743,347,336,212,291,5929,1417,5516,394,354,247,295,6806
E02005934,Bicester West,Cherwell,South East,1693,5429,444,454,339,451,7117,1621,6138,508,462,339,500,7947
E02005935,Bicester South,Cherwell,South East,1536,5343,258,232,178,354,6365,1627,6282,305,244,208,394,7433
E02005936,"Islip, Arncott & Chesterton",Cherwell,South East,2568,7273,558,540,409,499,9279,2560,9987,626,572,430,531,12146
E02005937,Kidlington North,Cherwell,South East,1148,3905,395,404,345,621,5670,1058,4591,405,443,330,607,6376
E02005938,Kidlington South,Cherwell,South East,1080,3387,299,230,176,376,4468,1063,4033,328,286,186,356,5189
E02005939,"Begbroke, Yarnton & Water Eaton",Cherwell,South East,1120,4096,392,328,252,482,5550,1205,5015,411,399,258,474,6557
E02005940,Wolvercote & Cutteslowe,Oxford,South East,1189,3079,344,344,232,417,4416,1258,4347,341,365,265,435,5753
E02005941,Summertown,Oxford,South East,1722,3950,367,340,217,419,5293,1811,6038,356,386,267,384,7431
E02005942,North Central Oxford,Oxford,South East,1124,4339,261,320,223,313,5456,1268,6881,314,330,276,341,8142
E02005943,Marston,Oxford,South East,1337,3609,270,300,217,409,4805,1416,5212,286,305,234,411,6448
E02005944,Barton,Oxford,South East,1856,4139,261,244,187,244,5075,1944,6537,285,258,180,243,7503
E02005945,Headington,Oxford,South East,1767,11673,391,325,292,525,13206,1923,18151,396,393,312,468,19720
E02005946,Risinghurst & Sandhills,Oxford,South East,1650,4539,343,333,252,334,5801,1708,6596,395,374,292,364,8021
E02005947,Oxford Central,Oxford,South East,1193,16259,227,165,151,194,16996,919,33474,302,213,183,189,34361
E02005948,"Osney, Jericho & Port Meadow",Oxford,South East,946,5266,229,234,161,159,6049,909,6322,258,209,162,188,7139
E02005949,Churchill,Oxford,South East,1280,5090,234,167,132,243,5866,1308,7170,212,181,120,212,7895
E02005950,East Central Oxford,Oxford,South East,971,8677,300,293,178,184,9632,1052,9999,338,336,175,220,11068
E02005951,Grandpont & New Hinksey,Oxford,South East,974,3729,214,201,144,262,4550,948,4740,245,222,149,240,5596
E02005952,Cowley North,Oxford,South East,2647,9390,417,356,224,397,10784,2777,14008,493,368,254,407,15530
E02005953,Iffley Fields,Oxford,South East,929,3469,196,158,96,142,4061,951,4840,235,201,112,129,5517
E02005954,Cowley South & Iffley,Oxford,South East,1845,5704,403,352,275,582,7316,1865,8366,432,392,307,534,10031
E02005955,Littlemore & Rose Hill,Oxford,South East,2488,6041,380,303,210,361,7295,2473,8290,396,358,243,357,9644
E02005956,Blackbird Leys,Oxford,South East,1474,3458,201,184,154,251,4248,1446,5021,244,206,166,257,5894
E02005957,Greater Leys,Oxford,South East,1779,3833,183,131,108,182,4437,1709,5197,222,140,119,196,5874
E02005958,Thame North,South Oxfordshire,South East,952,3302,355,274,185,260,4376,900,3571,345,306,223,258,4703
E02005959,Beckley & Horspath,South Oxfordshire,South East,892,3426,381,391,253,324,4775,943,3923,391,381,283,340,5318
E02005960,Thame South,South Oxfordshire,South East,1546,4047,355,414,337,528,5681,1657,4723,360,463,339,576,6461
E02005961,Wheatley & Great Haseley,South Oxfordshire,South East,1131,3946,414,427,302,452,5541,1142,4598,437,450,345,495,6325
E02005962,Chinnor & Tetsworth,South Oxfordshire,South East,1703,5298,592,617,384,484,7375,1877,6178,613,629,470,510,8400
E02005963,Berinsfield & Wittenham,South Oxfordshire,South East,1437,4818,506,473,371,473,6641,1401,5286,560,463,393,508,7210
E02005964,"Chalgrove, Stadhampton & Dorchester",South Oxfordshire,South East,1201,4116,427,484,349,484,5860,1146,4543,448,483,378,512,6364
E02005965,Watlington & Nettlebed,South Oxfordshire,South East,1001,3112,321,362,304,356,4455,996,3547,320,346,296,365,4874
E02005966,Didcot Ladygrove,South Oxfordshire,South East,1637,5641,206,194,70,105,6216,1604,5911,243,191,101,119,6565
E02005967,Didcot West,South Oxfordshire,South East,2119,5399,275,303,239,350,6566,2052,6067,304,307,257,354,7289
E02005968,Benson & Crowmarsh Gifford,South Oxfordshire,South East,1509,5058,292,400,288,390,6428,1483,5278,339,372,313,393,6695
E02005969,Wallingford & Brightwell,South Oxfordshire,South East,1824,5521,482,516,404,685,7608,1788,6134,522,514,443,689,8302
E02005970,Didcot South East,South Oxfordshire,South East,1056,3711,217,165,96,146,4335,957,4122,244,176,130,135,4807
E02005971,Didcot South West,South Oxfordshire,South East,1206,3763,286,282,243,396,4970,1170,4105,308,279,247,363,5302
E02005972,"Hagbourne, Moreton & Cholsey",South Oxfordshire,South East,2215,5666,512,517,432,578,7705,2476,7057,542,543,428,603,9173
E02005973,Henley North,South Oxfordshire,South East,923,3146,277,377,353,568,4721,945,3912,308,392,364,591,5567
E02005974,Henley South,South Oxfordshire,South East,1177,3622,303,365,296,456,5042,1147,4318,313,343,341,497,5812
E02005975,"Goring, Woodcote & Whitchurch",South Oxfordshire,South East,1603,4464,512,579,427,559,6541,1573,5133,497,596,438,596,7260
E02005976,Shiplake & Binfield Heath,South Oxfordshire,South East,1129,3487,362,473,295,457,5074,1121,4212,397,425,340,413,5787
E02005977,Sonning Common & Kidmore End,South Oxfordshire,South East,1047,3220,346,393,292,588,4839,1106,3670,364,390,324,565,5313
E02005978,"Dean Court, Cumnor & Appleton",Vale of White Horse,South East,1324,4459,435,475,293,651,6313,1353,5063,471,490,358,610,6992
E02005979,Botley & Kennington,Vale of White Horse,South East,1827,6228,493,491,389,695,8296,1809,7142,496,487,382,693,9200
E02005980,"Radley, Wootton & Marcham",Vale of White Horse,South East,2534,7093,605,658,482,655,9493,2519,7257,610,640,512,706,9725
E02005981,Abingdon Northcourt & Peachcroft,Vale of White Horse,South East,1608,5619,542,514,296,322,7293,1534,5915,560,541,342,351,7709
E02005982,Abingdon Audlett Drive & Farm Road,Vale of White Horse,South East,1165,3635,297,331,251,316,4830,1110,3922,314,322,262,330,5150
E02005983,Abingdon Town & West,Vale of White Horse,South East,2079,7523,475,465,396,706,9565,1936,8116,476,519,385,734,10230
E02005984,Kingston Bagpuize & East Hanney,Vale of White Horse,South East,1569,5048,525,482,369,429,6853,1594,5530,514,529,388,430,7391
E02005985,Abingdon South,Vale of White Horse,South East,1480,4812,442,482,350,445,6531,1514,5370,442,459,361,478,7110
E02005986,Faringdon & Stanford,Vale of White Horse,South East,1956,6016,499,533,359,546,7953,1825,6045,489,572,389,576,8071
E02005987,"Sutton Courtenay, Drayton & Steventon",Vale of White Horse,South East,1944,5740,500,517,307,496,7560,2139,6498,524,483,346,490,8341
E02005988,Grove,Vale of White Horse,South East,1610,4714,415,421,322,381,6253,1803,5459,460,443,333,419,7114
E02005991,Wantage Town,Vale of White Horse,South East,1653,5954,554,583,420,741,8252,1655,6279,521,587,413,747,8547
E02005992,"South Wantage, Harwell & Blewbury",Vale of White Horse,South East,2783,7590,591,670,453,736,10040,3113,8783,637,651,503,718,11292
E02006886,"Shrivenham, Watchfield & Uffington",Vale of White Horse,South East,2712,7878,683,719,531,720,10531,3082,9380,717,745,599,752,12193
E02005993,Chipping Norton,West Oxfordshire,South East,1216,4039,431,457,348,427,5702,1270,4492,412,493,391,580,6368
E02005994,"Kingham, Enstone & Middle Barton",West Oxfordshire,South East,1198,3763,406,384,279,479,5311,1156,4044,386,410,289,347,5476
E02005995,Chadlington & Wychwoods,West Oxfordshire,South East,1005,3352,452,476,284,452,5016,1061,3942,487,504,369,520,5822
E02005996,"Woodstock, Stonesfield & Tackley",West Oxfordshire,South East,1640,4739,532,520,411,651,6853,1595,5433,522,510,443,629,7537
E02005997,Charlbury & North Leigh,West Oxfordshire,South East,927,3128,447,425,252,394,4646,934,3573,451,448,303,418,5193
E02005998,Hanborough & Cassington,West Oxfordshire,South East,1130,3468,416,465,346,466,5161,1235,4078,431,473,370,530,5882
E02005999,"Leafield, Minster Lovell & Duckington",West Oxfordshire,South East,1072,3611,441,405,335,431,5223,1042,4023,407,458,336,453,5677
E02006000,Witney East,West Oxfordshire,South East,2387,7388,540,631,397,635,9591,2201,7747,595,618,485,644,10089
E02006001,Witney West,West Oxfordshire,South East,1364,3798,259,261,166,378,4862,1450,4461,279,275,176,399,5590
E02006002,Witney Central,West Oxfordshire,South East,1810,6537,548,594,444,840,8963,1725,7156,552,586,481,813,9588
E02006003,Eynsham & Stanton Harcourt,West Oxfordshire,South East,956,3205,300,349,310,369,4533,1020,3686,356,332,334,384,5092
E02006004,Burford & Brize Norton,West Oxfordshire,South East,969,3523,447,441,313,408,5132,1112,6613,397,447,319,404,8180
E02006005,Carterton North,West Oxfordshire,South East,2445,6476,233,248,183,236,7376,2360,5870,283,262,207,252,6874
E02006006,Carterton South,West Oxfordshire,South East,1026,4980,295,263,237,316,6091,992,3309,338,259,233,321,4460
E02006007,"Bampton, Clanfield & Standlake",West Oxfordshire,South East,1287,4053,438,477,304,479,5751,1297,4451,453,502,353,498,6257
E02006317,West Molesey North,Elmbridge,South East,1250,3350,350,328,237,331,4596,1303,4167,364,360,248,385,5524
E02006318,East Molesey,Elmbridge,South East,1225,3893,361,356,260,370,5240,1373,4846,418,391,300,377,6332
E02006319,West Molesey South,Elmbridge,South East,1514,4076,325,325,189,356,5271,1668,5031,330,326,223,333,6243
E02006320,Walton North & Molesey Heath,Elmbridge,South East,1575,4232,262,259,171,230,5154,1683,4895,292,259,187,249,5882
E02006321,Thames Ditton,Elmbridge,South East,1574,3699,290,304,189,403,4885,1640,4547,321,294,225,386,5773
E02006322,Long Ditton,Elmbridge,South East,1522,4028,297,252,176,280,5033,1555,4710,314,283,196,284,5787
E02006323,Walton Central,Elmbridge,South East,1551,4387,313,365,235,493,5793,1548,4942,357,366,267,533,6465
E02006324,Walton East,Elmbridge,South East,1875,4742,333,260,189,348,5872,1984,5497,326,263,221,314,6621
E02006325,Hinchley Wood & Weston Green,Elmbridge,South East,2356,5576,367,425,275,505,7148,2395,6683,418,421,307,472,8301
E02006326,Walton Hersham Road,Elmbridge,South East,1563,4101,321,345,208,366,5341,1718,4996,331,350,239,373,6289
E02006327,Oatlands,Elmbridge,South East,1519,3743,316,357,274,441,5131,1576,4413,294,354,312,513,5886
E02006328,Weybridge Riverside,Elmbridge,South East,1968,5727,420,429,266,534,7376,2114,6982,434,424,331,511,8682
E02006329,Esher,Elmbridge,South East,1604,4394,331,372,298,492,5887,1671,5572,358,423,301,472,7126
E02006330,Hersham,Elmbridge,South East,2148,5548,440,534,382,672,7576,2171,6545,454,477,414,674,8564
E02006331,Claygate,Elmbridge,South East,1547,4008,396,370,286,444,5504,1623,4938,406,411,294,470,6519
E02006332,Weybridge St George's Hill,Elmbridge,South East,1328,3874,273,311,190,450,5098,1377,4834,326,337,227,461,6185
E02006333,Cobham,Elmbridge,South East,2396,6179,506,493,370,665,8213,2332,7485,514,484,376,615,9474
E02006334,Oxshott & Stoke D'Abernon,Elmbridge,South East,2111,5252,498,393,320,588,7051,2024,6144,503,456,341,537,7981
E02006335,Worcester Park West,Epsom and Ewell,South East,1372,4883,451,461,354,490,6639,1460,5293,447,473,385,507,7105
E02006336,Ruxley Lane,Epsom and Ewell,South East,1684,4421,282,272,160,296,5431,1602,4986,300,341,185,273,6085
E02006337,Stoneleigh & Auriol,Epsom and Ewell,South East,1738,5301,504,506,373,532,7216,1740,5806,497,539,378,561,7781
E02006338,West Ewell,Epsom and Ewell,South East,1436,4193,377,404,263,350,5587,1360,4544,379,417,290,354,5984
E02006339,Horton & Manor Park,Epsom and Ewell,South East,2780,6872,421,359,252,252,8156,2708,7588,412,402,266,289,8957
E02006341,Epsom North,Epsom and Ewell,South East,2119,6286,410,442,316,506,7960,2064,7155,442,449,342,557,8945
E02006342,Epsom Town,Epsom and Ewell,South East,1587,5451,315,358,276,576,6976,1503,5988,313,388,291,600,7580
E02006343,Epsom Downs & Common,Epsom and Ewell,South East,1982,5146,446,448,325,460,6825,1998,6051,466,461,334,495,7807
E02006837,Ewell East,Epsom and Ewell,South East,2147,6499,577,658,484,774,8992,2181,7647,567,664,524,725,10127
E02006344,West Clandon & Send,Guildford,South East,1579,5018,511,621,398,577,7125,1402,5316,534,547,444,592,7433
E02006345,Pirbright & Normandy,Guildford,South East,1368,4662,306,355,215,326,5864,1274,5630,339,350,275,352,6946
E02006346,Horsley & Effingham,Guildford,South East,2043,5828,567,669,440,726,8230,1908,6557,559,691,503,777,9087
E02006347,Ash Vale,Guildford,South East,1406,4723,408,365,274,359,6129,1291,4653,367,409,278,410,6117
E02006348,"Worplesdon, Jacobs Well & Wood Street",Guildford,South East,1577,5427,443,464,347,568,7249,1573,5673,438,491,394,623,7619
E02006349,Stoughton,Guildford,South East,1594,6133,308,272,199,337,7249,1600,5782,345,331,193,321,6972
E02006350,"Bellfields, Slyfield & Weyfield",Guildford,South East,1314,4428,246,219,149,236,5278,1278,4845,248,264,152,222,5731
E02006351,Burpham North & Merrow East,Guildford,South East,1989,5466,347,379,215,348,6755,1860,5773,368,397,209,400,7147
E02006352,Woodbridge Hill,Guildford,South East,1093,5106,230,274,153,214,5977,1030,4328,264,251,186,226,5255
E02006353,Ash Wharf,Guildford,South East,1207,3974,286,332,237,333,5162,1161,4037,289,317,249,337,5229
E02006354,"Burpham, Boxgrove & Merrow West",Guildford,South East,2092,5769,465,454,352,649,7689,1988,6360,460,471,392,695,8378
E02006355,Park Barn & Royal Surrey,Guildford,South East,1234,8461,192,185,114,238,9190,1163,6929,226,174,122,221,7672
E02006356,Guildford Town Centre,Guildford,South East,1737,9467,349,268,184,367,10635,1760,9733,368,296,255,411,11063
E02006357,Tongham,Guildford,South East,1105,3967,358,363,271,275,5234,1228,4465,434,381,266,322,5868
E02006358,Onslow Village and University,Guildford,South East,1151,7483,229,248,152,265,8377,1128,8393,257,247,165,243,9305
E02006359,Pewley Down & The Mount,Guildford,South East,1176,4008,331,325,229,326,5219,1061,4238,333,354,218,341,5484
E02006360,Shalford & Wanborough,Guildford,South East,1559,4750,434,426,367,730,6707,1506,5213,456,427,384,715,7195
E02006361,"Gomshall, Shere & Albury",Guildford,South East,1005,3318,354,400,264,364,4700,933,3702,417,431,306,376,5232
E02006362,Ashtead East,Mole Valley,South East,1309,3768,371,424,306,513,5382,1359,4452,394,427,339,551,6163
E02006363,Ashtead West,Mole Valley,South East,1266,3513,317,351,278,496,4955,1230,3869,365,353,287,440,5314
E02006364,Leatherhead North,Mole Valley,South East,1579,4946,313,281,193,315,6048,1521,5408,313,319,209,352,6601
E02006365,Leatherhead South & Ashtead South,Mole Valley,South East,1001,3583,370,397,334,547,5231,976,4067,399,373,325,595,5759
E02006366,Fetcham,Mole Valley,South East,1430,4552,509,534,356,605,6556,1412,5034,537,541,411,595,7118
E02006367,Bookham North,Mole Valley,South East,972,3163,341,445,337,579,4865,977,3525,360,400,376,576,5237
E02006368,Bookham South,Mole Valley,South East,982,2920,369,422,285,559,4555,956,3410,399,386,324,551,5070
E02006369,Box Hill & Brockham,Mole Valley,South East,834,3447,455,522,371,590,5385,852,3859,512,495,422,596,5884
E02006370,Dorking North & Westhumble,Mole Valley,South East,1043,3915,365,336,242,372,5230,1068,4425,353,377,287,400,5842
E02006371,Dorking South,Mole Valley,South East,1290,4432,355,383,280,589,6039,1284,4967,449,403,328,565,6712
E02006372,Holmwoods,Mole Valley,South East,1298,3928,333,304,249,396,5210,1285,4359,331,295,240,367,5592
E02006373,"Westcott, Ockley & Capel",Mole Valley,South East,1409,4583,424,487,303,456,6253,1267,5134,457,470,351,490,6902
E02006374,"Charlwood, Newdigate & Beare Green",Mole Valley,South East,1115,4326,505,486,330,361,6008,1115,4772,484,498,363,444,6561
E02006375,Nork,Reigate and Banstead,South East,1281,3984,397,401,277,380,5439,1340,4324,375,404,291,431,5825
E02006376,Banstead,Reigate and Banstead,South East,1381,5455,463,556,390,919,7783,1397,5845,479,537,413,854,8128
E02006377,Tattenham North,Reigate and Banstead,South East,1069,3488,405,400,288,462,5043,1070,3912,386,444,318,472,5532
E02006378,Chipstead & Netherne,Reigate and Banstead,South East,1746,5627,436,444,279,490,7276,1702,5758,455,449,321,449,7432
E02006379,Tattenham South,Reigate and Banstead,South East,1646,4082,261,265,148,229,4985,1758,4558,270,251,165,233,5477
E02006380,Tadworth & Walton,Reigate and Banstead,South East,1180,3959,461,466,371,640,5897,1217,4462,476,512,415,607,6472
E02006381,Kingswood,Reigate and Banstead,South East,1221,4259,383,468,352,521,5983,1227,4616,419,476,354,499,6364
E02006382,Merstham,Reigate and Banstead,South East,1522,4160,276,283,146,259,5124,1630,4836,278,292,175,258,5839
E02006383,Reigate Hill & Gatton,Reigate and Banstead,South East,2234,6057,413,447,387,803,8107,2192,6557,465,465,409,785,8681
E02006384,Redhill West,Reigate and Banstead,South East,2355,7108,443,447,288,506,8792,2431,7946,420,444,334,524,9668
E02006385,Redhill East,Reigate and Banstead,South East,2584,8055,292,280,202,325,9154,2544,8561,343,316,223,334,9777
E02006386,Reigate Central & Redhill Common,Reigate and Banstead,South East,2083,5023,341,345,258,399,6366,1937,5497,359,367,265,396,6884
E02006387,Reigate South Park,Reigate and Banstead,South East,1598,3859,271,359,215,321,5025,1525,4410,286,334,214,274,5518
E02006388,Earlswood & Whitebushes,Reigate and Banstead,South East,1908,5832,424,382,260,305,7203,1886,6691,391,431,261,347,8121
E02006389,Salfords & Woodhatch,Reigate and Banstead,South East,1484,4101,394,375,253,386,5509,1504,4643,373,395,268,380,6059
E02006390,Horley West,Reigate and Banstead,South East,1947,5232,481,426,278,436,6853,2245,6490,455,459,313,429,8146
E02006391,Horley East,Reigate and Banstead,South East,1810,4864,366,318,182,252,5982,1781,5286,387,343,217,280,6513
E02006392,Horley Central,Reigate and Banstead,South East,1689,5797,457,436,292,507,7489,1727,6379,473,438,299,573,8162
E02006393,Egham Town,Runnymede,South East,955,4984,199,187,184,304,5858,927,4917,230,189,165,370,5871
E02006394,Englefield Green & University,Runnymede,South East,1469,10321,360,359,251,431,11722,1529,10295,358,367,266,470,11756
E02006395,Egham Hythe & Pooley Green,Runnymede,South East,1849,6471,426,342,224,421,7884,1943,6997,459,415,229,423,8523
E02006396,Thorpe,Runnymede,South East,917,3726,389,452,256,399,5222,1006,4182,403,427,324,413,5749
E02006397,Virginia Water,Runnymede,South East,1350,4079,295,315,221,468,5378,1339,4758,360,321,285,468,6192
E02006398,Chertsey,Runnymede,South East,1688,5437,329,351,240,408,6765,1716,6048,352,361,280,387,7428
E02006399,Addlestone North,Runnymede,South East,2354,7499,523,519,407,629,9577,2512,8352,574,537,452,681,10596
E02006400,Ottershaw & Lyne,Runnymede,South East,972,3665,305,335,246,392,4943,1079,4113,356,367,269,415,5520
E02006401,Addlestone South,Runnymede,South East,2194,6488,444,464,378,616,8390,2113,6948,471,470,412,609,8910
E02006402,New Haw & Woodham,Runnymede,South East,1813,6062,489,571,397,605,8124,1900,6733,508,576,417,608,8842
E02006403,Stanwell North & Stanwell Moor,Spelthorne,South East,1301,4248,266,270,163,219,5166,1355,4813,277,269,180,258,5797
E02006404,Stanwell South,Spelthorne,South East,1891,4909,242,223,203,308,5885,1916,5698,290,228,192,316,6724
E02006405,Ashford West,Spelthorne,South East,2023,6939,492,588,329,533,8881,2205,8239,506,571,367,572,10255
E02006406,Staines Town,Spelthorne,South East,1672,5967,309,281,185,347,7089,1684,7067,329,315,231,350,8292
E02006407,Ashford East,Spelthorne,South East,1689,5332,437,422,378,544,7113,1800,6283,441,458,397,578,8157
E02006408,Ashford Common,Spelthorne,South East,1748,5292,365,353,304,489,6803,1733,5855,391,338,321,475,7380
E02006409,Staines South East,Spelthorne,South East,1423,4223,319,316,220,323,5401,1391,4702,338,335,240,320,5935
E02006410,Sunbury Common,Spelthorne,South East,1880,5275,338,304,232,357,6506,1886,5809,352,331,206,347,7045
E02006411,Staines South West,Spelthorne,South East,1244,4257,381,387,337,494,5856,1265,4813,407,394,339,577,6530
E02006412,Sunbury East,Spelthorne,South East,1513,4268,408,423,349,470,5918,1514,4833,410,451,337,512,6543
E02006413,Halliford & Sunbury West,Spelthorne,South East,1132,3489,383,371,254,457,4954,1183,4154,373,370,267,513,5677
E02006414,Littleton & Shepperton Green,Spelthorne,South East,1143,3720,336,349,244,405,5054,1171,4008,363,354,264,403,5392
E02006415,Shepperton Town,Spelthorne,South East,1060,3661,373,477,385,603,5499,1036,4109,424,475,433,705,6146
E02006416,Chobham & Windlesham,Surrey Heath,South East,1562,4877,527,482,396,535,6817,1500,5544,521,518,397,558,7538
E02006417,Bagshot,Surrey Heath,South East,1234,3675,283,357,185,331,4831,1249,4237,319,347,231,338,5472
E02006418,Lightwater,Surrey Heath,South East,1072,4015,400,407,315,511,5648,1018,4286,399,399,339,501,5924
E02006419,Camberley North,Surrey Heath,South East,1695,5272,316,261,217,379,6445,1643,5761,349,269,203,448,7030
E02006420,Camberley Town,Surrey Heath,South East,1344,4614,401,436,358,622,6431,1266,5324,433,473,382,629,7241
E02006421,West End & Bisley,Surrey Heath,South East,1857,5600,386,380,347,459,7172,2099,6570,416,459,326,552,8323
E02006422,Camberley Heatherside,Surrey Heath,South East,1318,3635,306,358,237,277,4813,1287,4109,334,367,277,302,5389
E02006423,Camberley West,Surrey Heath,South East,2045,7189,443,482,365,672,9151,2039,8291,514,485,405,638,10333
E02006424,Camberley Parkside,Surrey Heath,South East,1237,3629,371,362,320,429,5111,1243,4170,378,418,314,444,5724
E02006425,Frimley,Surrey Heath,South East,1316,4082,254,315,243,351,5245,1232,4529,312,322,266,346,5775
E02006426,Frimley Green,Surrey Heath,South East,1076,3449,301,312,198,209,4469,1080,3723,335,334,265,347,5004
E02006427,Mytchett & Frith Hill,Surrey Heath,South East,1401,4539,285,381,263,547,6015,1321,4321,336,323,267,346,5593
E02006429,Warlingham West & Whyteleafe,Tandridge,South East,1434,5059,345,426,248,367,6445,1539,5376,385,385,320,365,6831
E02006430,Caterham North,Tandridge,South East,2180,6082,389,414,286,407,7578,2126,6390,430,409,300,443,7972
E02006431,Caterham Valley,Tandridge,South East,2413,7026,564,531,352,584,9057,2369,7585,591,553,400,610,9739
E02006432,Caterham West,Tandridge,South East,1082,3403,306,370,246,443,4768,1044,3676,335,356,283,407,5057
E02006433,Oxted North,Tandridge,South East,1834,5355,508,551,437,830,7681,1834,5855,521,571,468,776,8191
E02006434,Oxted South,Tandridge,South East,1445,3811,330,328,224,383,5076,1433,4171,328,328,238,386,5451
E02006435,Nutfield & Bletchingley,Tandridge,South East,1170,3775,386,356,246,305,5068,1181,3977,385,365,249,322,5298
E02006436,Godstone,Tandridge,South East,1253,3576,311,338,251,369,4845,1273,4059,333,315,256,383,5346
E02006437,Lingfield & Dormansland,Tandridge,South East,1478,5105,495,580,449,649,7278,1482,5249,529,530,440,662,7410
E02006438,Smallfield & Felbridge,Tandridge,South East,1374,4854,531,563,387,477,6812,1411,5547,560,582,445,526,7660
E02006790,Warlingham East & Tatsfield,Tandridge,South East,1452,4517,437,498,345,609,6406,1435,4820,453,499,378,630,6780
E02006439,Farnham Weybourne & Badshot Lea,Waverley,South East,1122,3471,347,345,282,368,4813,1111,3972,328,366,277,384,5327
E02006440,Farnham Upper Hale,Waverley,South East,1394,4111,394,442,277,370,5594,1343,4690,402,426,317,402,6237
E02006441,Farnham Town,Waverley,South East,1375,5385,331,413,283,665,7077,1360,5948,372,374,351,667,7712
E02006442,Farnham Moor Park & Bourne,Waverley,South East,1387,3388,354,370,269,511,4892,1384,3944,340,382,280,491,5437
E02006443,Farncombe,Waverley,South East,1420,4324,393,370,303,528,5918,1457,4842,396,350,318,468,6374
E02006444,Farnham Shortheath,Waverley,South East,1717,4103,300,358,244,399,5404,1650,4510,326,367,258,394,5855
E02006445,Godalming North,Waverley,South East,1786,4954,376,343,271,381,6325,1735,5675,328,368,297,439,7107
E02006446,"Blackheath, Wonersh & Shamley Green",Waverley,South East,1416,3915,378,420,293,492,5498,1376,4467,389,401,351,500,6108
E02006447,Farnham Wrecclesham,Waverley,South East,1388,3619,339,343,291,413,5005,1411,4144,374,376,310,400,5604
E02006448,Godalming South,Waverley,South East,1644,4358,350,384,245,399,5736,1563,4757,349,380,266,393,6145
E02006449,Elstead & Milford,Waverley,South East,1312,3906,373,415,322,657,5673,1315,4444,362,426,340,626,6198
E02006450,"Wheelerstreet, Wormley & Hambledon",Waverley,South East,1528,4288,355,348,327,417,5735,1440,5020,426,406,322,428,6602
E02006451,Cranleigh,Waverley,South East,2168,6226,687,838,636,848,9235,2212,7309,730,848,707,910,10504
E02006453,Ewhurst & Chiddingfold,Waverley,South East,1345,4553,469,569,474,706,6771,1511,5719,522,591,501,765,8098
E02006454,Haslemere East,Waverley,South East,1370,3725,351,368,279,613,5336,1367,4128,370,374,267,614,5753
E02006455,Haslemere West,Waverley,South East,1257,3736,288,279,192,430,4925,1213,3989,301,277,238,395,5200
E02006839,"Hindhead, Beacon Hill & Frensham",Waverley,South East,1543,4959,515,572,391,782,7219,1462,5278,529,531,431,774,7543
E02006456,Byfleet,Woking,South East,1652,4519,346,359,279,440,5943,1638,5363,368,366,287,476,6860
E02006457,West Byfleet & Pyrford North,Woking,South East,1739,5008,502,539,462,754,7265,1811,6184,506,555,451,770,8466
E02006458,Horsell,Woking,South East,1833,5202,474,495,345,650,7166,1901,6055,496,505,383,624,8063
E02006459,Sheerwater,Woking,South East,2475,6976,359,212,161,252,7960,2639,8964,391,262,158,336,10111
E02006460,Goldsworth Park,Woking,South East,1999,5546,485,406,220,337,6994,1990,6293,506,461,268,327,7855
E02006461,Maybury Hill & Pyrford South,Woking,South East,1315,3961,367,344,259,572,5503,1333,4817,410,353,295,448,6323
E02006462,Knaphill,Woking,South East,1751,4997,355,341,244,323,6260,1773,5825,360,380,258,342,7165
E02006463,Woking Central,Woking,South East,2209,7260,350,340,236,455,8641,2136,8556,353,347,260,444,9960
E02006464,St John's,Woking,South East,1312,3930,339,356,246,406,5277,1325,4522,337,344,260,407,5870
E02006465,Hook Heath,Woking,South East,1153,3548,352,327,208,357,4792,1224,4175,341,347,226,371,5460
E02006466,Old Woking & Westfield,Woking,South East,2798,6506,363,348,243,410,7870,2760,7705,380,375,263,391,9114
E02006467,Mayford & Brookwood,Woking,South East,1500,4122,350,353,239,322,5386,1626,4996,345,344,272,338,6295
E02006534,Hillside,Adur,South East,1719,5244,478,491,365,576,7154,1684,5801,503,494,402,601,7801
E02006535,Buckingham,Adur,South East,1454,4009,445,553,340,508,5855,1433,4403,427,567,407,536,6340
E02006536,North Lancing,Adur,South East,1408,4341,435,446,303,475,6000,1440,4640,450,459,340,470,6359
E02006537,Kingston & Southwick,Adur,South East,2228,6435,494,460,420,644,8453,2157,6871,497,533,381,673,8955
E02006538,Shoreham Central & Beach,Adur,South East,1637,5399,557,587,385,608,7536,1546,5580,571,623,436,611,7821
E02006539,Cokeham & Sompting,Adur,South East,1278,4168,421,503,415,463,5970,1217,4464,422,468,409,531,6294
E02006540,Marsh Barn & Widewater,Adur,South East,982,3206,376,458,309,425,4774,943,3512,356,407,349,449,5073
E02006541,South Lancing,Adur,South East,1188,4469,483,581,425,707,6665,1195,4555,447,568,416,737,6723
E02006542,Arundel,Arun,South East,784,3070,452,506,365,472,4865,724,3397,457,493,409,518,5274
E02006543,"Angmering North, Patching & Findon",Arun,South East,840,3092,403,460,311,431,4697,793,3326,424,444,383,448,5025
E02006544,"Westergate, Eastergate & Walberton",Arun,South East,1901,5996,744,810,545,760,8855,1923,6849,771,834,576,877,9907
E02006545,Wick & Toddington,Arun,South East,2629,6376,479,478,311,371,8015,2796,7344,533,509,355,388,9129
E02006546,Angmering South,Arun,South East,1870,5629,649,799,604,880,8561,1854,6389,629,826,644,960,9448
E02006547,Yapton & Climping,Arun,South East,1187,3853,451,421,268,368,5361,1199,4355,492,461,323,382,6013
E02006548,Rustington North,Arun,South East,1738,5445,541,587,482,716,7771,1744,6026,558,612,507,764,8467
E02006549,Ferring & Kingston Gorse,Arun,South East,539,2617,586,748,606,870,5427,563,2752,543,759,645,930,5629
E02006550,Littlehampton East,Arun,South East,1384,4779,711,830,609,938,7867,1348,5382,726,845,647,982,8582
E02006551,East Preston & Rustington East,Arun,South East,641,3148,834,1198,781,1460,7421,563,3247,779,1090,893,1370,7379
E02006552,Littlehampton West and River,Arun,South East,1158,4552,427,414,289,460,6142,1182,5095,446,442,298,503,6784
E02006553,North Bersted,Arun,South East,1658,5351,520,552,366,528,7317,1812,6084,568,593,378,550,8173
E02006554,Middleton-on-Sea,Arun,South East,946,3293,562,698,441,690,5684,853,3732,552,653,501,663,6101
E02006555,South Bersted,Arun,South East,1410,5034,399,354,265,459,6511,1423,5331,419,353,284,460,6847
E02006556,Felpham,Arun,South East,1824,5031,686,925,613,917,8172,1838,5915,690,908,718,962,9193
E02006557,Hawthorn Road,Arun,South East,1677,5090,310,346,239,419,6404,1529,5686,321,354,245,333,6939
E02006558,Bognor Regis Central,Arun,South East,1540,7844,579,621,454,815,10313,1486,7779,587,603,491,908,10368
E02006559,Aldwick,Arun,South East,883,3615,814,1033,771,1201,7434,865,3926,717,1032,793,1185,7653
E02006560,Nyetimber & Pagham,Arun,South East,1337,4613,786,938,672,986,7995,1316,5089,713,930,769,1015,8516
E02006561,Fernhurst & Northchapel,Chichester,South East,1499,3829,380,442,305,359,5315,1302,4088,376,454,349,386,5653
E02006562,Ifold & Wisborough Green,Chichester,South East,1107,3356,425,434,347,374,4936,1029,3820,444,446,354,401,5465
E02006563,Millland & South Harting,Chichester,South East,956,3228,427,416,313,470,4854,910,3677,446,418,341,434,5316
E02006564,Midhurst & Cocking,Chichester,South East,1366,4161,602,597,463,729,6552,1263,4651,592,651,475,753,7122
E02006565,Easebourne & Petworth,Chichester,South East,1258,4275,583,663,484,728,6733,1174,4716,578,664,520,726,7204
E02006566,"Dean, Lavant & Summersdale",Chichester,South East,1265,4217,571,613,489,784,6674,1204,4603,556,641,500,854,7154
E02006567,Westbourne & Funtington,Chichester,South East,1308,3997,519,547,375,567,6005,1310,4670,526,561,436,609,6802
E02006568,College Lane & Oaklands,Chichester,South East,1967,7561,546,586,439,805,9937,1948,8262,623,577,443,779,10684
E02006569,"Southbourne, Bosham & Thorney",Chichester,South East,1493,4649,570,663,501,710,7093,1562,5436,599,652,531,742,7960
E02006570,Central Chichester,Chichester,South East,1089,5970,456,502,440,810,8178,1047,6202,469,567,459,827,8524
E02006571,Stockbridge & Fishbourne,Chichester,South East,1546,5158,522,541,459,666,7346,1449,5806,554,589,455,714,8118
E02006572,"Tangmere, Mundham & Hunston",Chichester,South East,2101,6502,592,575,403,511,8583,2116,7671,606,621,453,557,9908
E02006573,Wittering & Birdham,Chichester,South East,1660,5642,830,1038,799,1238,9547,1803,6396,889,1017,882,1189,10373
E02006574,Selsey,Chichester,South East,1425,5343,960,1152,702,1179,9336,1463,6173,966,1100,872,1218,10329
E02006575,Langley Green & Gatwick Airport,Crawley,South East,2047,5640,294,248,170,266,6618,2100,6770,340,279,185,283,7857
E02006576,Pound Hill,Crawley,South East,1976,5531,420,410,229,367,6957,2198,6574,434,427,264,383,8082
E02006577,Ewhurst & West Green,Crawley,South East,1836,5288,308,335,208,527,6666,1971,5997,372,319,236,457,7381
E02006578,Manor Royal & Northgate,Crawley,South East,2390,7574,358,341,215,487,8975,2591,9022,405,356,234,435,10452
E02006579,Three Bridges,Crawley,South East,1723,5125,348,295,223,368,6359,1666,6036,349,338,217,378,7318
E02006580,Ifield & Gossops Green,Crawley,South East,1709,5117,350,308,242,505,6522,1662,5600,413,359,232,512,7116
E02006581,Southgate,Crawley,South East,1937,5986,337,344,219,414,7300,2101,6887,417,360,224,458,8346
E02006582,Maidenbower East & Worth,Crawley,South East,1697,5156,292,279,145,180,6052,1620,5400,335,340,184,204,6463
E02006583,Maidenbower West & Furnace Green,Crawley,South East,1843,5842,398,419,246,455,7360,1813,6403,454,437,323,466,8083
E02006584,Bewbush,Crawley,South East,1834,5064,310,216,133,130,5853,1805,5755,321,246,133,146,6601
E02006585,Tilgate,Crawley,South East,1772,4684,304,253,229,466,5936,1800,5666,319,285,224,437,6931
E02006586,Broadfield West,Crawley,South East,1950,5464,320,199,67,67,6117,1913,6236,336,251,107,93,7023
E02006587,Broadfield East,Crawley,South East,2035,5914,414,295,164,158,6945,1849,6339,384,316,178,148,7365
E02006588,"Rusper, Faygate & Leechpool",Horsham,South East,1686,5880,432,485,286,350,7433,1910,6758,430,513,356,443,8500
E02006589,Littlehaven,Horsham,South East,2045,6985,646,700,379,605,9315,2062,7620,671,710,498,600,10099
E02006590,Broadbridge Heath & Warnham,Horsham,South East,1730,5575,454,498,324,523,7374,1587,5803,449,509,357,543,7661
E02006591,Horsham East & Roffey,Horsham,South East,1539,5260,418,361,293,544,6876,1496,5451,410,379,320,540,7100
E02006592,"Rudgwick, Slinfold & Barns Green",Horsham,South East,1180,3991,420,413,279,415,5518,1244,4567,410,452,316,418,6163
E02006593,Horsham Central,Horsham,South East,2093,7086,511,455,381,935,9368,2036,7629,511,469,416,926,9951
E02006594,Horsham West,Horsham,South East,2346,6380,528,422,307,445,8082,2344,6778,515,500,325,488,8606
E02006595,"Horsham South, Mannings Heath & Nuthurst",Horsham,South East,1721,5112,494,545,412,517,7080,1818,5507,520,581,415,583,7606
E02006596,Southwater,Horsham,South East,1884,5990,470,386,254,329,7429,1816,6339,495,441,291,364,7930
E02006597,Billingshurst,Horsham,South East,2226,6431,576,604,446,628,8685,2384,7511,605,648,475,648,9887
E02006598,Cowfold & Partridge Green,Horsham,South East,890,3333,354,362,258,331,4638,849,3548,392,390,269,364,4963
E02006599,West Chiltington Common,Horsham,South East,795,3329,691,778,523,754,6075,795,3618,663,763,592,725,6361
E02006600,"Amberley, Pulborough & Storrington",Horsham,South East,1578,5264,713,789,641,910,8317,1493,5547,717,800,626,968,8658
E02006601,Henfield & Small Dole,Horsham,South East,1548,4828,563,594,508,797,7290,1478,5247,577,623,536,777,7760
E02006602,Ashington & Washington,Horsham,South East,1640,4734,570,576,418,495,6793,1630,5302,556,615,448,490,7411
E02006603,Steyning & Upper Beeding,Horsham,South East,1298,4632,641,743,549,754,7319,1363,5156,632,719,597,831,7935
E02006604,East Grinstead Central & North,Mid Sussex,South East,2433,8021,679,627,476,811,10614,2381,8410,673,655,539,781,11058
E02006605,Copthorne & Turners Hill,Mid Sussex,South East,1219,3977,322,393,250,358,5300,1171,4258,362,377,256,378,5631
E02006606,East Grinstead East,Mid Sussex,South East,1709,5165,473,544,304,394,6880,1604,5231,490,510,394,405,7030
E02006607,East Grinstead West & South,Mid Sussex,South East,1469,4699,466,547,360,561,6633,1436,4773,477,550,420,577,6797
E02006608,Crawley Down,Mid Sussex,South East,1197,3526,461,495,304,368,5154,1164,3751,464,482,340,390,5427
E02006609,"Horsted Keynes, Ardingly & Sharpthorne",Mid Sussex,South East,1285,4173,419,426,315,364,5697,1215,4420,453,416,333,413,6035
E02006610,Balcombe & Handcross,Mid Sussex,South East,1546,4483,378,354,303,462,5980,1577,5023,395,381,324,442,6565
E02006611,Haywards Heath North East,Mid Sussex,South East,2457,6108,647,760,565,804,8884,2456,6779,652,709,640,847,9627
E02006612,Haywards Heath West,Mid Sussex,South East,2301,7607,484,532,391,738,9752,2226,7829,479,559,443,829,10139
E02006613,Haywards Heath East,Mid Sussex,South East,1765,4871,369,346,224,351,6161,1623,5172,352,366,253,333,6476
E02006614,Haywards Heath South & Cuckfield,Mid Sussex,South East,2546,7279,584,585,412,566,9426,2684,8152,558,615,452,576,10353
E02006615,Burgess Hill West,Mid Sussex,South East,1461,4602,315,277,166,235,5595,1413,4797,331,293,204,205,5830
E02006616,Burgess Hill East,Mid Sussex,South East,1810,5437,452,523,330,498,7240,1974,6192,473,524,358,505,8052
E02006617,Burgess Hill Central,Mid Sussex,South East,1686,5823,461,484,316,552,7636,1705,6389,462,457,398,596,8302
E02006618,Burgess Hill South,Mid Sussex,South East,1049,3630,417,376,294,533,5250,1026,3844,404,385,331,569,5533
E02006619,Hurstpierpoint & Bolney,Mid Sussex,South East,1919,5370,490,460,264,427,7011,1914,5690,510,471,323,427,7421
E02006620,"Hassocks, Keymer & East Hurstpierpoint",Mid Sussex,South East,1836,5522,545,612,496,946,8121,1871,5731,565,627,518,922,8363
E02006621,High Salvington & Findon Valley,Worthing,South East,953,3924,669,769,550,783,6695,931,4255,654,784,595,792,7080
E02006622,Salvington,Worthing,South East,1405,4466,514,549,389,652,6570,1357,4826,500,574,388,598,6886
E02006623,Durrington North,Worthing,South East,1722,4676,475,480,337,425,6393,1626,5030,462,506,386,474,6858
E02006624,Broadwater West,Worthing,South East,1506,4480,390,399,260,446,5975,1358,4840,375,436,311,463,6425
E02006625,Broadwater East,Worthing,South East,1680,5198,326,306,219,321,6370,1601,5423,329,344,208,335,6639
E02006626,Northbrook,Worthing,South East,2352,5728,429,351,210,298,7016,2520,6671,411,372,241,291,7986
E02006627,Durrington South,Worthing,South East,1710,5443,486,596,383,611,7519,1760,6107,501,558,437,622,8225
E02006628,Broadwater South,Worthing,South East,1990,6077,327,315,222,356,7297,1859,6366,358,304,216,349,7593
E02006629,East Worthing,Worthing,South East,1583,4911,380,388,271,453,6403,1484,5271,372,418,273,452,6786
E02006630,Heene,Worthing,South East,1060,5249,450,562,420,1012,7693,1097,5344,467,558,466,1024,7859
E02006631,Worthing Central,Worthing,South East,1433,7015,383,465,314,678,8855,1393,7285,408,441,361,696,9191
E02006632,West Worthing,Worthing,South East,1265,4713,492,629,407,802,7043,1188,4912,521,614,466,797,7310
E02006633,Goring-by-Sea,Worthing,South East,1013,4054,614,864,592,945,7069,1110,4425,626,798,621,953,7423
E02002985,Keynsham North,Bath and North East Somerset,South West,1134,3861,282,383,252,497,5275,1255,4052,313,365,272,531,5533
E02002986,Keynsham South,Bath and North East Somerset,South West,1294,3710,280,349,254,418,5011,1391,4278,300,342,288,435,5643
E02002987,Keynsham East,Bath and North East Somerset,South West,940,3147,343,450,249,518,4707,907,3388,325,458,328,482,4981
E02002988,Lambridge & Fairfield Park,Bath and North East Somerset,South West,1074,3397,290,321,215,400,4623,1024,3657,302,328,224,402,4913
E02002989,Weston,Bath and North East Somerset,South West,1134,3364,252,282,206,503,4607,1125,3698,262,263,234,484,4941
E02002990,Walcot,Bath and North East Somerset,South West,863,4327,287,281,166,174,5235,905,4785,290,257,179,200,5711
E02002991,Central Bath & Lansdown,Bath and North East Somerset,South West,1228,8079,500,529,345,637,10090,1379,8927,569,596,403,675,11170
E02002992,Newbridge,Bath and North East Somerset,South West,1087,3762,294,284,197,356,4893,1000,3989,290,316,219,362,5176
E02002993,Kingsmead,Bath and North East Somerset,South West,572,5359,243,195,110,218,6125,568,5636,242,209,149,229,6465
E02002994,Bathavon North & South,Bath and North East Somerset,South West,1955,5996,642,663,506,783,8590,1930,6756,692,706,507,821,9482
E02002995,Twerton,Bath and North East Somerset,South West,1201,3926,165,180,143,167,4581,1145,4272,202,193,148,202,5017
E02002996,"Widcombe, Bathwick Hill & Claverton Down",Bath and North East Somerset,South West,1208,10516,456,417,326,446,12161,1234,12406,467,480,339,540,14232
E02002997,Oldfield Park West,Bath and North East Somerset,South West,726,6239,217,221,165,239,7081,769,6086,242,224,186,239,6977
E02002998,Oldfield Park East,Bath and North East Somerset,South West,826,4285,188,192,155,273,5093,753,4150,199,203,138,277,4967
E02002999,Southdown,Bath and North East Somerset,South West,1004,3456,277,310,197,333,4573,1022,3898,288,315,214,298,5013
E02003000,"Saltford, Farmborough & Timsbury",Bath and North East Somerset,South West,1612,5367,722,690,550,718,8047,1547,5601,735,759,613,752,8460
E02003001,Bloomfield,Bath and North East Somerset,South West,1002,3365,308,287,204,395,4559,1006,3688,346,305,209,374,4922
E02003002,Combe Down,Bath and North East Somerset,South West,1265,3547,318,273,207,327,4672,1399,4113,318,308,244,340,5323
E02003003,Odd Down,Bath and North East Somerset,South West,1136,3885,243,260,186,330,4904,1084,4258,259,261,207,308,5293
E02003004,"Pensford, Clutton & Temple Cloud",Bath and North East Somerset,South West,1210,4101,413,447,242,368,5571,1333,4565,423,439,309,422,6158
E02003005,"Chew, Bishop Sutton & East Harptree",Bath and North East Somerset,South West,1205,3713,421,465,331,367,5297,1248,4023,410,483,374,434,5724
E02003006,Peasedown & Bathavon West,Bath and North East Somerset,South West,1733,6352,457,443,345,435,8032,1617,6734,496,465,380,434,8509
E02003007,High Littleton & Paulton,Bath and North East Somerset,South West,1895,5529,519,526,333,488,7395,1880,5714,551,568,393,576,7802
E02003008,Radstock,Bath and North East Somerset,South West,1333,3829,287,250,179,273,4818,1318,3919,294,258,188,258,4917
E02003009,Midsomer Norton North,Bath and North East Somerset,South West,1142,3773,328,322,252,421,5096,1110,3911,312,344,276,410,5253
E02003010,Westfield,Bath and North East Somerset,South West,1439,4226,345,276,202,281,5330,1327,4177,359,318,216,305,5375
E02003011,Midsomer Norton Redfield,Bath and North East Somerset,South West,1132,3139,308,401,306,412,4566,1110,3456,325,389,333,434,4937
E02003012,Henbury & Brentry,"Bristol, City of",South West,2545,7007,519,560,330,512,8928,2768,8525,543,556,362,484,10470
E02003013,Southmead,"Bristol, City of",South West,2678,7450,485,485,379,501,9300,2843,9453,518,506,372,530,11379
E02003014,Lawrence Weston,"Bristol, City of",South West,2204,5051,304,264,181,292,6092,2275,6039,316,317,175,269,7116
E02003015,Monks Park,"Bristol, City of",South West,1343,4360,275,265,160,290,5350,1344,5172,295,264,196,274,6201
E02003016,Upper Horfield,"Bristol, City of",South West,1480,5936,241,196,144,219,6736,1521,6280,255,227,147,205,7114
E02003017,Westbury Village,"Bristol, City of",South West,1192,3348,316,397,267,560,4888,1223,3950,338,407,306,567,5568
E02003018,Sea Mills,"Bristol, City of",South West,1267,3512,335,312,206,278,4643,1378,4275,363,352,238,261,5489
E02003019,Shirehampton & Avonmouth,"Bristol, City of",South West,1933,6261,464,428,319,463,7935,2015,7583,492,503,327,477,9382
E02003020,Westbury on Trym,"Bristol, City of",South West,1378,3416,360,386,292,678,5132,1479,3823,347,415,328,668,5581
E02003021,Horfield,"Bristol, City of",South West,1329,5433,191,217,110,274,6225,1318,5853,199,209,147,240,6648
E02003022,Henleaze,"Bristol, City of",South West,1340,3172,325,349,238,479,4563,1379,3803,365,367,272,461,5268
E02003023,Stapleton,"Bristol, City of",South West,1076,4384,326,294,216,368,5588,1093,4977,336,332,234,346,6225
E02003024,Fishponds North,"Bristol, City of",South West,1811,6329,374,360,259,567,7889,1851,7305,404,398,255,543,8905
E02003025,Lockleaze,"Bristol, City of",South West,1790,4782,263,232,208,326,5811,1704,5793,292,242,217,344,6888
E02003026,Stoke Bishop,"Bristol, City of",South West,1316,5891,535,514,385,694,8019,1480,7877,565,535,400,703,10080
E02003027,Bishopston,"Bristol, City of",South West,2453,9107,419,322,197,245,10290,2483,10427,474,373,196,268,11738
E02003028,Westbury Park,"Bristol, City of",South West,1641,5649,351,309,204,377,6890,1682,6363,351,379,241,391,7725
E02003029,Fishponds South,"Bristol, City of",South West,1580,4028,213,198,139,215,4793,1555,4945,269,223,156,230,5823
E02003030,Eastville,"Bristol, City of",South West,1452,5493,296,198,168,184,6339,1498,6530,326,239,194,186,7475
E02003031,Redland & St Andrew's,"Bristol, City of",South West,1784,7952,348,248,140,177,8865,1644,8591,419,296,155,146,9607
E02003032,Speedwell,"Bristol, City of",South West,1795,5327,271,265,179,290,6332,1813,6160,349,277,191,283,7260
E02003033,Cotham,"Bristol, City of",South West,757,7474,209,227,139,167,8216,777,7410,260,236,157,168,8231
E02003034,St Paul's,"Bristol, City of",South West,2403,10253,293,185,151,181,11063,2352,12971,375,248,163,211,13968
E02003036,Kingsdown & Stokes Croft,"Bristol, City of",South West,851,8828,200,158,82,187,9455,818,9033,230,181,93,132,9669
E02003037,Clifton East,"Bristol, City of",South West,721,7506,250,182,135,219,8292,796,8403,267,235,158,191,9254
E02003038,Two Mile Hill,"Bristol, City of",South West,1258,4314,235,259,167,279,5254,1376,5083,243,266,204,280,6076
E02003039,St George,"Bristol, City of",South West,1711,5884,327,280,256,292,7039,1711,6669,341,322,244,332,7908
E02003040,Redfield,"Bristol, City of",South West,1636,7239,238,226,178,371,8252,1594,8299,260,265,200,342,9366
E02003041,Clifton Village,"Bristol, City of",South West,625,4602,252,268,166,239,5527,733,5524,264,305,206,251,6550
E02003043,Bristol City Centre,"Bristol, City of",South West,835,17362,195,269,140,148,18114,938,18503,253,243,176,140,19315
E02003044,Crews Hole,"Bristol, City of",South West,1097,3673,258,274,217,254,4676,1052,4308,253,284,253,287,5385
E02003045,Hotwells,"Bristol, City of",South West,586,6054,265,259,130,133,6841,631,5928,244,277,148,134,6731
E02003046,St Annes,"Bristol, City of",South West,1851,6896,315,317,173,286,7987,1932,7751,356,324,209,280,8920
E02003047,Southville,"Bristol, City of",South West,1824,8096,332,278,187,384,9277,1877,8915,393,299,212,305,10124
E02003048,Totterdown,"Bristol, City of",South West,1119,5426,194,134,113,116,5983,1061,5516,214,151,119,113,6113
E02003049,Broom Hill,"Bristol, City of",South West,1515,4765,337,398,257,346,6103,1603,5472,360,370,285,339,6826
E02003050,Bedminster,"Bristol, City of",South West,1155,7701,282,250,197,364,8794,1284,8555,305,281,204,352,9697
E02003051,Windmill Hill,"Bristol, City of",South West,1642,5205,171,178,95,124,5773,1648,5861,211,185,117,142,6516
E02003052,Ashton,"Bristol, City of",South West,1251,4605,256,256,201,274,5592,1327,5078,285,311,210,277,6161
E02003053,Knowle Park,"Bristol, City of",South West,1631,5261,386,325,221,371,6564,1663,5938,392,359,219,353,7261
E02003054,Brislington,"Bristol, City of",South West,1266,4324,283,293,178,232,5310,1286,4837,320,305,196,303,5961
E02003055,Knowle,"Bristol, City of",South West,2197,5247,302,259,161,252,6221,2364,6438,326,285,200,247,7496
E02003056,Knowle West,"Bristol, City of",South West,1942,4602,321,267,176,228,5594,1959,5465,338,303,182,235,6523
E02003057,Bishopsworth,"Bristol, City of",South West,1113,3678,270,327,187,357,4819,1199,4184,295,331,209,368,5387
E02003058,Hengrove,"Bristol, City of",South West,1898,5466,434,429,312,512,7153,2014,6058,489,464,374,494,7879
E02003059,Headley Park,"Bristol, City of",South West,1394,3707,285,202,176,380,4750,1446,4383,328,235,203,347,5496
E02003060,Stockwood,"Bristol, City of",South West,1948,6257,556,528,502,768,8611,2062,7293,609,588,542,804,9836
E02003061,Highridge,"Bristol, City of",South West,1590,3564,264,202,165,269,4464,1630,4257,275,233,171,256,5192
E02003062,Withywood,"Bristol, City of",South West,1466,3526,231,174,155,337,4423,1514,4192,241,200,154,285,5072
E02003063,Whitchurch Park,"Bristol, City of",South West,1172,3914,419,475,368,459,5635,1250,4386,485,481,371,504,6227
E02003064,Hartcliffe,"Bristol, City of",South West,2091,4227,209,158,158,290,5042,2112,4960,262,180,126,281,5809
E02006887,Temple Meads,"Bristol, City of",South West,1316,7944,153,122,78,100,8397,1380,8980,171,122,86,82,9441
E02006888,Upper Easton,"Bristol, City of",South West,1912,4759,177,118,81,195,5330,1927,6598,202,144,84,178,7206
E02006889,Barton Hill,"Bristol, City of",South West,2678,4836,212,139,136,201,5524,2627,6591,213,157,142,189,7292
E02006890,Lower Easton,"Bristol, City of",South West,1945,6166,225,157,155,208,6911,1950,8336,269,182,133,211,9131
E02003065,Portishead Central,North Somerset,South West,1663,5798,568,650,499,708,8223,1712,6279,562,639,505,696,8681
E02003066,Portishead Redcliffe,North Somerset,South West,1011,3344,474,550,368,428,5164,996,3661,434,530,427,474,5526
E02003067,Portishead South,North Somerset,South West,1818,4554,400,429,303,434,6120,1889,5173,397,489,342,502,6903
E02003068,Pill & Easton,North Somerset,South West,1040,3656,383,436,349,425,5249,1078,4124,367,452,374,467,5784
E02003069,Clevedon North & Walton,North Somerset,South West,812,2979,419,463,313,625,4799,827,3183,384,472,342,609,4990
E02003070,Long Ashton & Gordano,North Somerset,South West,3035,7629,764,778,607,818,10596,2804,8002,725,824,608,872,11031
E02003071,Clevedon Central,North Somerset,South West,1332,4585,535,516,375,760,6771,1374,4918,534,510,432,786,7180
E02003072,Nailsea West,North Somerset,South West,1412,4894,586,772,552,909,7713,1420,5361,602,737,619,978,8297
E02003073,Nailsea East,North Somerset,South West,1043,3637,440,582,324,395,5378,993,3870,466,529,417,423,5705
E02003074,Clevedon South & Yeo,North Somerset,South West,1414,4714,456,444,283,417,6314,1338,4887,511,460,321,453,6632
E02003075,Backwell & Flax Bourton,North Somerset,South West,1267,3390,337,399,301,355,4782,1255,3724,351,364,323,413,5175
E02003076,Yatton & Cleeve,North Somerset,South West,1777,5385,621,611,472,568,7657,1767,5949,598,657,478,612,8294
E02003077,"Wrington, Felton & Dundry",North Somerset,South West,1091,3570,371,412,325,413,5091,1135,3989,421,380,376,420,5586
E02003078,Congresbury & Kewstoke,North Somerset,South West,1241,4054,508,609,357,426,5954,1238,4416,525,602,428,446,6417
E02003079,North Worle,North Somerset,South West,1847,5749,525,519,326,373,7492,1847,6084,543,569,358,375,7929
E02003080,Mid Worle,North Somerset,South West,1498,4579,577,761,569,766,7252,1412,5000,553,726,600,797,7676
E02003081,Weston Milton,North Somerset,South West,1517,5242,617,779,572,736,7946,1520,5652,615,756,587,747,8357
E02003082,Weston Hillside,North Somerset,South West,980,5686,566,655,433,909,8249,973,5926,556,648,492,859,8481
E02003084,Weston Town,North Somerset,South West,1680,6849,516,565,312,721,8963,1761,7852,521,530,366,675,9944
E02003085,Weston Bournville,North Somerset,South West,1874,4946,349,291,189,281,6056,1993,5754,375,318,200,251,6898
E02003086,Weston Clarence,North Somerset,South West,788,3600,405,408,278,699,5390,812,3967,393,427,321,685,5793
E02003087,"Hutton, Locking & Banwell",North Somerset,South West,1715,5555,749,894,605,702,8505,1775,6202,736,875,668,728,9209
E02003088,"Winscombe, Langford & Blagdon",North Somerset,South West,1366,4493,635,677,517,756,7078,1484,5189,630,677,586,805,7887
E02003089,Weston Uphill,North Somerset,South West,1087,3253,349,472,349,433,4856,1103,3652,372,426,371,442,5263
E02006845,"South Worle, West Wick & St Georges",North Somerset,South West,2258,6096,449,422,250,422,7639,2255,6163,465,393,294,385,7700
E02006846,Weston Winterstoke,North Somerset,South West,2553,6055,219,185,103,134,6696,2554,6623,257,206,119,116,7321
E02003090,Thornbury North,South Gloucestershire,South West,1557,4682,478,517,388,540,6605,1790,5635,477,502,499,580,7693
E02003091,Thornbury South,South Gloucestershire,South West,1151,3791,393,474,361,488,5507,1140,4176,400,452,356,496,5880
E02003092,"Charfield, Wickwar & Iron Acton",South Gloucestershire,South West,1437,5248,463,436,303,333,6783,1492,5756,459,468,331,368,7382
E02003093,"Alveston, Olveston & Oldbury",South Gloucestershire,South West,965,3476,449,504,444,623,5496,998,3875,434,505,478,646,5938
E02003094,"Almondsbury, Pilning & Severn Beach",South Gloucestershire,South West,1820,5354,469,484,359,448,7114,1695,5913,520,483,383,491,7790
E02003095,Yate North,South Gloucestershire,South West,1346,4736,427,436,268,323,6190,1477,5428,430,460,325,385,7028
E02003096,Yate West,South Gloucestershire,South West,1134,4022,285,350,246,257,5160,1141,4304,317,328,249,346,5544
E02003097,Chipping Sodbury,South Gloucestershire,South West,1029,3468,428,511,443,564,5414,1027,3794,406,511,442,601,5754
E02003098,Bradley Stoke North East,South Gloucestershire,South West,2181,7231,375,235,150,134,8125,2109,7681,341,244,169,163,8598
E02003099,Yate Kingsgate,South Gloucestershire,South West,1464,4326,388,424,379,485,6002,1478,4920,400,437,384,525,6666
E02003100,Patchway,South Gloucestershire,South West,2941,8991,505,595,445,600,11136,3367,10468,577,569,477,659,12750
E02003101,Bradley Stoke Central,South Gloucestershire,South West,2394,7918,302,247,188,238,8893,2340,8245,351,271,226,233,9326
E02003102,Frampton Cotterell,South Gloucestershire,South West,1491,3982,354,411,331,452,5530,1427,4496,355,410,385,460,6106
E02003103,Yate South,South Gloucestershire,South West,1658,4654,310,327,185,137,5613,1522,4923,295,349,210,180,5957
E02003104,Stoke Gifford,South Gloucestershire,South West,1360,4819,463,360,274,324,6240,1358,5110,441,408,299,323,6581
E02003105,Winterbourne,South Gloucestershire,South West,1129,3523,322,400,393,585,5223,1135,4005,344,379,366,608,5702
E02003106,Frenchay & Great Stoke,South Gloucestershire,South West,2420,12018,350,370,273,502,13513,2522,15228,363,383,319,530,16823
E02003107,Filton,South Gloucestershire,South West,1724,7750,408,497,366,583,9604,1691,8560,414,482,383,555,10394
E02003108,Pucklechurch & Westerleigh,South Gloucestershire,South West,2061,6951,597,573,455,612,9188,2334,7606,591,615,474,661,9947
E02003109,Downend North,South Gloucestershire,South West,1269,3447,312,356,306,473,4894,1236,3837,301,384,314,499,5335
E02003110,Emersons Green,South Gloucestershire,South West,2885,7855,400,414,254,336,9259,2830,8097,455,403,330,359,9644
E02003111,Downend South,South Gloucestershire,South West,1164,3845,363,389,289,589,5475,1203,4214,364,408,278,564,5828
E02003112,Mangotsfield,South Gloucestershire,South West,1405,4002,314,308,240,410,5274,1338,4208,299,322,278,405,5512
E02003113,"Marshfield, Wick & Hawkesbury",South Gloucestershire,South West,1916,6297,661,656,510,651,8775,1811,6720,718,675,542,664,9319
E02003114,Staple Hill North,South Gloucestershire,South West,1197,4264,351,421,309,637,5982,1301,4484,336,425,295,537,6077
E02003115,Staple Hill South & Kingswood North West,South Gloucestershire,South West,1889,6308,487,404,338,539,8076,1856,6722,447,436,359,523,8487
E02003116,Kingswood North East,South Gloucestershire,South West,1474,4696,367,376,329,544,6312,1461,5108,358,368,343,558,6735
E02003117,Kingswood South,South Gloucestershire,South West,1959,5879,401,413,326,430,7449,1833,6243,396,423,316,495,7873
E02003118,Cadbury Heath North & Bridgeyate,South Gloucestershire,South West,1778,6719,503,405,327,383,8337,1682,6813,510,465,350,389,8527
E02003119,Cadbury Heath South & North Common,South Gloucestershire,South West,2088,6476,550,534,333,508,8401,1982,6795,568,552,354,492,8761
E02003120,Hanham,South Gloucestershire,South West,1633,5402,508,563,399,715,7587,1637,5833,517,556,450,673,8029
E02003121,Longwell Green & Oldland Common,South Gloucestershire,South West,1563,5784,708,647,528,787,8454,1557,6147,688,713,581,786,8915
E02003122,Glenholt & Widewell,Plymouth,South West,1145,3841,482,591,451,533,5898,1201,3996,517,559,482,644,6198
E02003123,Southway,Plymouth,South West,1890,5136,420,432,335,488,6811,1887,5502,397,422,343,487,7151
E02003124,Tamerton Foliot,Plymouth,South West,1823,4940,338,309,269,380,6236,1873,5323,363,341,273,360,6660
E02003125,Ernesettle,Plymouth,South West,1055,3734,354,363,258,314,5023,1068,3796,372,354,248,308,5078
E02003126,Derriford & Estover,Plymouth,South West,1416,4733,620,527,262,354,6496,1475,5124,658,614,358,335,7089
E02003127,King's Tamerton & West Park,Plymouth,South West,1641,4469,333,381,267,323,5773,1609,4767,377,369,286,348,6147
E02003128,Honicknowle & Manadon,Plymouth,South West,1779,5367,453,467,306,436,7029,1824,5781,440,484,365,405,7475
E02003129,Crownhill,Plymouth,South West,1209,3497,345,420,275,426,4963,1196,3533,336,409,286,421,4985
E02003130,St Budeaux,Plymouth,South West,2165,6431,526,506,337,452,8252,2124,6705,538,528,390,439,8600
E02003131,Deer Park & Leigham,Plymouth,South West,1409,4306,416,483,344,369,5918,1354,4495,418,476,366,387,6142
E02003132,"Ham, Beacon Park & Pennycross",Plymouth,South West,1906,5368,440,478,309,455,7050,1849,5576,473,433,336,445,7263
E02003133,Higher Compton & Eggbuckland,Plymouth,South West,1307,4253,407,473,349,376,5858,1263,4488,412,447,365,423,6135
E02003134,North Prospect,Plymouth,South West,1453,4219,316,303,189,296,5323,1549,4677,319,291,187,273,5747
E02003135,Keyham,Plymouth,South West,1775,5043,260,248,163,181,5895,1571,8284,299,233,168,203,9187
E02003136,Plympton St Mary,Plymouth,South West,1248,4093,505,602,488,792,6480,1179,4408,503,614,515,827,6867
E02003137,Mannamead & Hartley,Plymouth,South West,1340,4452,431,487,349,751,6470,1364,4730,438,488,364,754,6774
E02003138,Peverell,Plymouth,South West,1457,5008,313,277,190,291,6079,1430,5256,321,279,218,264,6338
E02003139,Plympton Chaddlewood,Plymouth,South West,1462,4164,287,323,170,162,5106,1379,4347,305,328,198,167,5345
E02003140,Plympton Underwood,Plymouth,South West,1453,4497,388,431,335,563,6214,1444,4707,391,472,329,552,6451
E02003141,Ford & Blockhouse Park,Plymouth,South West,1352,5453,328,309,201,291,6582,1363,5681,347,338,220,273,6859
E02003142,"Efford, Laira & Crabtree",Plymouth,South West,1782,5724,475,421,282,421,7323,1804,6006,494,413,339,391,7643
E02003143,Plympton St Maurice,Plymouth,South West,1364,4367,466,411,334,404,5982,1340,4448,452,464,328,428,6120
E02003144,Mutley,Plymouth,South West,679,7405,195,192,121,270,8183,669,7719,194,207,156,306,8582
E02003145,Stoke & Pennycomequick,Plymouth,South West,1029,4547,322,335,211,383,5798,1057,4693,321,362,230,373,5979
E02003146,Lipson,Plymouth,South West,1344,6550,234,238,169,219,7410,1271,6761,284,231,157,209,7642
E02003147,"Devonport, Mount Wise & Morice Town",Plymouth,South West,2178,6060,372,320,207,203,7162,2128,6350,383,320,202,257,7512
E02003148,"City Centre, Barbican & Sutton Harbour",Plymouth,South West,938,8508,360,302,212,284,9666,1047,10479,352,297,216,297,11641
E02003149,Cattedown & Prince Rock,Plymouth,South West,1632,6909,312,260,186,207,7874,1534,7429,372,279,221,214,8515
E02003150,Millbay & Stonehouse,Plymouth,South West,1846,8616,557,507,305,532,10517,1748,10560,643,540,353,538,12634
E02003151,Plymstock Elburton,Plymouth,South West,1257,3962,505,681,468,891,6507,1442,4374,527,666,527,909,7003
E02003152,Plymstock Hooe & Oreston,Plymouth,South West,2011,5961,602,688,499,659,8409,2112,6728,641,709,530,706,9314
E02003153,Plymstock Goosewell & Staddiscombe,Plymouth,South West,1364,4248,406,490,379,581,6104,1284,4072,405,488,406,588,5959
E02003154,Watcombe,Torbay,South West,1451,4035,405,479,370,484,5773,1486,4361,402,456,353,491,6063
E02003155,St Marychurch & Maidencombe,Torbay,South West,933,3197,354,455,303,538,4847,854,3429,406,449,354,594,5232
E02003156,Shiphay & the Willows,Torbay,South West,2215,6419,584,561,369,422,8355,2118,6635,601,587,441,463,8727
E02003157,Upton & Hele,Torbay,South West,1232,4014,379,362,197,229,5181,1312,4490,364,356,238,270,5718
E02003158,Babbacombe & Plainmoor,Torbay,South West,873,2992,417,441,343,554,4747,918,3348,362,432,345,576,5063
E02003159,Ellacombe,Torbay,South West,1204,3645,245,295,175,269,4629,1231,4090,294,282,189,233,5088
E02003161,Torquay Central,Torbay,South West,1238,5024,435,327,230,355,6371,1216,5809,463,387,245,362,7266
E02003163,Wellswood,Torbay,South West,595,4086,708,836,601,1018,7249,667,4516,719,897,669,1044,7845
E02003164,Preston & Shorton,Torbay,South West,1325,4758,669,755,504,811,7497,1372,5205,689,752,596,809,8051
E02003165,Clifton & Maidenway,Torbay,South West,1340,4051,423,497,321,478,5770,1310,4441,465,493,357,483,6239
E02003166,Blatchcombe & Blagdon,Torbay,South West,2795,6981,638,665,458,515,9257,2859,7935,695,671,503,562,10366
E02003167,Paignton Central,Torbay,South West,1300,5457,628,614,554,992,8245,1312,6057,671,674,566,1033,9001
E02003168,Goodrington & Roselands,Torbay,South West,1059,3892,528,616,459,593,6088,1013,4193,574,607,515,600,6489
E02003169,Churston & Galmpton,Torbay,South West,819,3204,684,758,518,785,5949,753,3333,603,766,573,803,6078
E02003170,Brixham Town,Torbay,South West,1187,4819,826,1051,697,879,8272,1189,5184,841,943,750,893,8611
E02003171,Higher Brixham,Torbay,South West,1201,3999,590,611,467,655,6322,1060,4201,567,621,471,656,6516
E02006840,"Chelston, Cockington & Livermead",Torbay,South West,2098,6214,692,771,520,650,8847,2085,6980,698,755,542,739,9714
E02003212,Highworth,Swindon,South West,1281,4565,591,667,424,591,6838,1350,5083,593,660,459,613,7408
E02003214,Penhill,Swindon,South West,1673,3640,268,234,144,256,4542,1840,4117,275,246,157,264,5059
E02003215,Haydon Wick,Swindon,South West,932,3839,470,544,423,442,5718,918,4069,397,525,418,515,5924
E02003216,Upper Stratton,Swindon,South West,1586,5552,524,629,411,555,7671,1647,6158,545,567,451,618,8339
E02003217,Moredon,Swindon,South West,1598,4277,358,331,256,305,5527,1613,4659,343,355,254,320,5931
E02003218,Pinehurst,Swindon,South West,1444,3866,321,263,204,258,4912,1404,4245,323,312,207,265,5352
E02003219,"Broad Blunsdon, South Marston & Wanborough",Swindon,South West,2084,5504,506,442,289,411,7152,2793,7647,545,480,336,407,9415
E02003220,Lower Stratton,Swindon,South West,1684,5979,578,471,436,851,8315,1629,6549,602,489,426,818,8884
E02003221,Gorse Hill,Swindon,South West,1398,4750,289,261,162,234,5696,1479,5159,303,254,182,233,6131
E02003222,Roughmoor,Swindon,South West,1182,3958,266,186,103,116,4629,1176,4206,304,224,114,125,4973
E02003223,Rodbourne & Cheney Manor,Swindon,South West,2187,7112,383,326,219,323,8363,2160,7411,397,363,233,343,8747
E02003224,Covingham,Swindon,South West,1323,4845,560,517,441,637,7000,1350,5147,570,541,441,649,7348
E02003225,Westlea & Shaw,Swindon,South West,1165,3951,325,220,132,158,4786,1181,4340,346,304,152,178,5320
E02003226,Central North,Swindon,South West,2226,7508,296,225,141,167,8337,2398,9271,324,254,161,187,10197
E02003227,Walcot East,Swindon,South West,1603,4312,268,177,145,208,5110,1797,4954,276,218,153,226,5827
E02003228,Central East & Walcot West,Swindon,South West,1641,4850,304,270,188,369,5981,1612,5421,341,297,208,365,6632
E02003229,Freshbrook North & Grange Park,Swindon,South West,1082,3674,268,213,70,72,4297,1136,4081,320,228,112,100,4841
E02003230,Central South & Eastcott,Swindon,South West,1583,6361,250,161,152,214,7138,1769,7224,287,199,152,229,8091
E02003231,Park North & Park South,Swindon,South West,2143,5274,346,331,246,380,6577,2185,6151,376,334,257,379,7497
E02003232,Kingshill & Okus,Swindon,South West,1674,5819,343,309,197,315,6983,1668,6112,371,320,201,336,7340
E02003233,Freshbrook South & Toothill,Swindon,South West,1722,5303,521,445,259,348,6876,1827,5768,558,477,298,344,7445
E02003234,Eldene & Dorcan,Swindon,South West,1421,4927,537,514,312,414,6704,1473,5482,547,565,354,464,7412
E02003235,Lawn & East Wichel,Swindon,South West,1717,5556,444,471,339,628,7438,1797,5871,471,474,357,634,7807
E02003236,"Wroughton, Wichelstowe & Chiseldon",Swindon,South West,2296,6657,681,793,540,899,9570,2300,7570,713,721,631,942,10577
E02006847,Mouldon Hill & Oakhurst,Swindon,South West,2515,6442,218,208,84,161,7113,2593,6810,263,241,163,128,7605
E02006848,Abbey Park,Swindon,South West,2165,5582,161,101,92,53,5989,2311,5771,180,106,84,95,6236
E02006849,Groundwell & Abbey Meads,Swindon,South West,2214,6392,340,281,164,215,7392,2230,6872,336,330,218,227,7983
E02003892,Gunnislake & Calstock,Cornwall,South West,915,3527,579,614,399,422,5541,900,3791,601,609,445,436,5882
E02003893,St Neot & St Cleer,Cornwall,South West,976,3758,583,549,361,378,5629,934,3910,590,542,418,401,5861
E02003894,Callington & Pensilva,Cornwall,South West,1400,4911,556,603,389,489,6948,1268,4946,533,597,448,586,7110
E02003895,"Dobwalls, Addington & Menheniot",Cornwall,South West,1718,5175,573,586,333,466,7133,1770,5576,593,637,415,531,7752
E02003896,Liskeard,Cornwall,South West,1041,3343,383,424,290,374,4814,1026,3559,379,429,321,445,5133
E02003897,Saltash Latchbrook & St Stephens,Cornwall,South West,940,3270,391,470,263,244,4638,835,3213,356,454,309,289,4621
E02003898,St Germans & St Mellion,Cornwall,South West,953,3790,574,642,370,396,5772,942,3905,592,600,433,461,5991
E02003899,Mid Saltash,Cornwall,South West,943,3003,396,478,297,361,4535,903,3109,371,468,338,401,4687
E02003900,Saltash Town & Pillmere,Cornwall,South West,1272,4186,456,480,326,384,5832,1270,4265,462,472,398,468,6065
E02003901,"Lanreath, Pelynt & Polraun",Cornwall,South West,1160,4272,682,720,436,583,6693,1115,4500,711,783,529,685,7208
E02003902,Torpoint,Cornwall,South West,949,3091,342,328,231,273,4265,923,3292,346,347,277,377,4639
E02003903,"Kingsand, Antony & Maryfield",Cornwall,South West,968,3631,503,520,339,364,5357,904,4574,499,551,383,430,6437
E02003904,Looe & Polperro,Cornwall,South West,562,2688,472,508,316,449,4433,492,2771,480,529,316,461,4557
E02003905,"Grampound Road, St Newlyn East and Cubert",Cornwall,South West,1401,4165,416,400,232,253,5466,1393,4533,450,470,284,315,6052
E02003906,Perranporth & Goonhavern,Cornwall,South West,1105,3272,409,489,276,386,4832,1123,3976,428,477,352,487,5720
E02003907,St Agnes & Mount Hawke,Cornwall,South West,1637,4786,539,557,379,472,6733,1645,5363,564,600,457,548,7532
E02003908,Truro East,Cornwall,South West,1662,4977,457,508,375,533,6850,1581,5373,435,528,386,597,7319
E02003909,Truro West,Cornwall,South West,1907,6381,621,548,447,587,8584,1839,6919,595,620,451,687,9272
E02003910,Truro South & Central,Cornwall,South West,974,4027,335,379,286,459,5486,1049,4489,367,399,321,531,6107
E02003911,"Shortlanesend, Chacewater & Carnon Downs",Cornwall,South West,1513,4849,642,782,582,672,7527,1462,5398,627,784,613,745,8167
E02003912,Probus & Roseland,Cornwall,South West,1179,4398,634,743,476,579,6830,1191,4805,587,725,520,706,7343
E02003913,Mylor Bridge & Frogpool,Cornwall,South West,948,3201,557,570,404,494,5226,848,3208,500,561,439,524,5232
E02003914,Penryn,Cornwall,South West,1304,5751,347,360,269,308,7035,1252,6214,365,355,291,331,7556
E02003915,Falmouth North,Cornwall,South West,1128,5299,375,379,297,373,6723,1093,5813,401,394,293,377,7278
E02003916,Falmouth East,Cornwall,South West,576,4901,377,431,252,463,6424,575,4714,379,447,307,555,6402
E02003917,Falmouth West & South,Cornwall,South West,1422,4921,545,505,346,456,6773,1477,5069,542,491,372,494,6968
E02003918,Illogan & Portreath,Cornwall,South West,1173,4093,518,517,365,455,5948,1200,4341,531,506,391,466,6235
E02003919,Redruth North,Cornwall,South West,1460,4439,376,439,269,438,5961,1364,4700,373,424,283,388,6168
E02003920,Redruth South,Cornwall,South West,1482,4832,422,524,313,508,6599,1500,5053,434,498,361,466,6812
E02003921,St Day & Lanner,Cornwall,South West,1054,3503,414,451,300,373,5041,1036,3730,416,464,340,429,5379
E02003922,Pool & Illogan Highway,Cornwall,South West,1765,5247,475,459,317,410,6908,1802,5898,477,493,359,395,7622
E02003923,Camborne East,Cornwall,South West,1855,5070,489,461,306,390,6716,1949,5635,454,498,364,412,7363
E02003924,Camborne West,Cornwall,South West,1181,3871,475,549,363,531,5789,1150,4229,455,547,443,647,6321
E02003925,Camborne South,Cornwall,South West,1441,4419,433,427,275,355,5909,1434,5727,443,454,303,417,7344
E02003926,"Crowan, Wendron & Stithians",Cornwall,South West,1547,5059,567,528,360,398,6912,1417,5231,607,597,393,454,7282
E02003927,"Ponsanooth, Mabe Burnthouse & Constantine",Cornwall,South West,1538,7249,745,823,506,633,9956,1522,7724,776,771,576,688,10535
E02003928,Helston,Cornwall,South West,2591,7220,599,660,477,614,9570,2442,7034,644,666,532,710,9586
E02003929,"Porthleven, Breage & Praa Sands",Cornwall,South West,1009,3835,562,628,392,505,5922,974,3971,581,638,429,513,6132
E02003930,The Lizard,Cornwall,South West,1398,5525,769,819,493,626,8232,1341,6011,731,820,576,708,8846
E02003931,Bude & Stratton,Cornwall,South West,1818,5866,790,808,578,807,8849,1807,6083,796,795,602,876,9152
E02003932,Poundstock & Kilkhampton,Cornwall,South West,1308,4189,660,582,314,505,6250,1308,4318,670,589,406,508,6491
E02003933,Crackington & Tintagel,Cornwall,South West,1118,3948,593,616,438,479,6074,1031,4000,612,611,449,494,6166
E02003934,Camelford & Tresmeer,Cornwall,South West,1283,4047,543,623,313,443,5969,1230,4071,518,589,383,450,6011
E02003935,Launceston,Cornwall,South West,2259,6637,536,491,410,585,8659,2104,6710,538,524,424,621,8817
E02003936,Altarnun & Stoke Climsland,Cornwall,South West,1135,4758,711,770,509,616,7364,1112,4804,680,794,561,618,7457
E02003937,Trebetherick & Whitecross,Cornwall,South West,847,2959,423,429,342,630,4783,839,3040,376,456,322,470,4664
E02003938,Padstow & St Issey,Cornwall,South West,1320,3990,459,535,349,463,5796,1162,4077,439,458,373,411,5758
E02003939,Wadebridge,Cornwall,South West,1143,3865,463,545,389,695,5957,1101,3986,435,534,415,627,5997
E02003940,"St Breward, Tredethy & Lanivet",Cornwall,South West,888,3484,521,515,369,465,5354,888,3635,508,559,382,477,5561
E02003941,Bodmin East,Cornwall,South West,1716,5063,429,475,305,454,6726,1694,5504,457,494,356,517,7328
E02003942,Bodmin West,Cornwall,South West,1684,4731,437,413,298,435,6314,1679,5174,414,416,327,393,6724
E02003943,St Ives & Halsetown,Cornwall,South West,961,3960,571,574,354,536,5995,1000,4375,546,564,402,509,6396
E02003944,Hayle,Cornwall,South West,1800,5709,641,799,529,666,8344,1801,6118,611,789,567,684,8769
E02003945,"Towednack, Lelant & Carbis Bay",Cornwall,South West,825,3229,518,571,408,553,5279,780,3359,486,584,432,502,5363
E02003946,"Marazion, St Erth & Gwinear Gwithian",Cornwall,South West,1653,5425,695,759,487,603,7969,1597,5570,666,757,551,644,8188
E02003947,West Penwith & St Buryan,Cornwall,South West,1007,3635,558,578,410,458,5639,959,3813,554,603,414,484,5868
E02003948,Penzance North,Cornwall,South West,1418,4703,509,616,422,616,6866,1375,5030,517,604,461,644,7256
E02003949,Penzance Quay,Cornwall,South West,913,3889,513,494,310,532,5738,912,4319,501,481,354,499,6154
E02003950,St Just & Land's End,Cornwall,South West,946,3083,507,402,268,397,4657,818,3108,476,443,305,359,4691
E02003951,Penzance South & Newlyn,Cornwall,South West,807,3099,517,573,398,535,5122,847,3477,457,559,429,523,5445
E02003952,St Columb Minor & Porth,Cornwall,South West,1729,5202,545,516,340,454,7057,1940,6415,533,574,374,453,8349
E02003953,St Columb Major & St Mawgan,Cornwall,South West,2290,6578,690,748,474,652,9142,2093,6658,641,693,501,558,9051
E02003954,Newquay West,Cornwall,South West,1105,4661,451,388,275,523,6298,1044,5850,483,430,296,464,7523
E02003955,Newquay East,Cornwall,South West,1742,6053,590,616,378,587,8224,1731,7079,551,628,451,612,9321
E02003956,Roche & Goss Moor,Cornwall,South West,1514,4790,472,447,274,396,6379,1529,5088,491,452,326,352,6709
E02003957,Lostwithiel & Penwithick,Cornwall,South West,1977,6465,716,736,501,624,9042,1978,6645,733,754,571,612,9315
E02003958,"Trewoon, Coombe & Foxhole",Cornwall,South West,1652,5044,536,502,296,386,6764,1539,5006,543,500,365,387,6801
E02003959,Par,Cornwall,South West,1297,4159,416,480,306,452,5813,1274,4330,437,434,308,442,5951
E02003960,Tywardreath & Fowey,Cornwall,South West,777,3216,489,575,388,612,5280,709,3299,504,525,415,520,5263
E02003961,St Austell East & Carlyon Bay,Cornwall,South West,1726,5582,666,739,481,669,8137,1638,5601,628,733,527,680,8169
E02003962,St Austell North & Carclaze,Cornwall,South West,1317,4323,414,471,265,523,5996,1255,4557,430,477,304,383,6151
E02003963,St Austell Central,Cornwall,South West,1906,5747,595,608,472,820,8242,1767,5939,569,603,505,774,8390
E02003964,Mevagissey & Polgooth,Cornwall,South West,1025,4135,689,840,562,779,7005,1007,4395,663,783,638,700,7179
E02006781,Isles of Scilly,Isles of Scilly,South West,318,1326,138,165,110,167,1906,312,1549,125,142,133,167,2116
E02006634,"Ramsbury, Ogbournes & Avebury",Wiltshire,South West,1473,5023,581,615,384,557,7160,1412,5439,630,619,450,586,7724
E02006635,Marlborough,Wiltshire,South West,1516,4844,494,505,434,740,7017,1649,5600,506,520,478,828,7932
E02006636,Pewsey & Lockeridge,Wiltshire,South West,1156,3974,510,506,347,494,5831,1124,4267,495,539,409,506,6216
E02006637,Devizes East,Wiltshire,South West,2098,6722,554,588,437,591,8892,2018,6817,559,633,475,653,9137
E02006638,Devizes West,Wiltshire,South West,900,3449,429,478,377,623,5356,861,3749,441,507,420,639,5756
E02006639,Potterne & Rowde,Wiltshire,South West,1183,5072,582,704,433,492,7283,1112,5167,584,670,527,522,7470
E02006640,"Bedwyn, Burbage & Collingbourne",Wiltshire,South West,1358,4315,537,495,288,396,6031,1273,4673,532,521,349,438,6513
E02006641,Market Lavington & Bishops Cannings,Wiltshire,South West,1451,4793,546,503,382,492,6716,1442,5018,547,532,374,535,7006
E02006642,Netheravon & Upavon,Wiltshire,South West,966,3403,389,374,258,263,4687,935,3354,406,391,273,301,4725
E02006643,Tidworth & Ludgershall,Wiltshire,South West,4830,12020,409,357,200,269,13255,4592,14125,469,416,229,282,15521
E02006644,Cricklade & Ashton Keynes,Wiltshire,South West,1049,3783,517,475,326,375,5476,1147,4191,518,547,361,401,6018
E02006645,"Malmesbury, Crudwell & Oaksey",Wiltshire,South West,1590,4652,464,412,324,392,6244,1501,4968,443,462,345,427,6645
E02006646,Lydiard Millicent & Purton,Wiltshire,South West,1697,4561,356,388,238,499,6042,1708,5148,406,402,281,507,6744
E02006647,"Somerford, Dauntsey & Minety",Wiltshire,South West,996,3378,448,504,299,333,4962,988,3691,459,486,344,359,5339
E02006648,Sherston & Hullavington,Wiltshire,South West,1165,3496,364,375,284,425,4944,1141,3614,346,411,317,430,5118
E02006649,Royal Wootton Bassett Town,Wiltshire,South West,1371,4560,436,406,297,451,6150,1339,4857,446,439,312,490,6544
E02006650,Royal Wootton Bassett Outer & Lyneham,Wiltshire,South West,2675,7758,702,760,486,603,10309,2285,9393,670,757,587,679,12086
E02006651,"Sutton Benger, Kington & Biddestone",Wiltshire,South West,1318,4545,465,482,330,335,6157,1253,4508,492,490,384,403,6277
E02006652,Chippenham North,Wiltshire,South West,1915,6149,412,402,287,438,7688,1784,6552,457,392,308,439,8148
E02006653,Chippenham West,Wiltshire,South West,1785,6078,469,552,364,414,7877,1742,6541,543,533,372,464,8453
E02006654,Chippenham South & East,Wiltshire,South West,1593,5701,430,501,388,782,7802,1550,6149,484,505,421,768,8327
E02006655,Derry Hill & Hilmarton,Wiltshire,South West,1206,4307,518,516,351,556,6248,1185,4787,502,555,376,579,6799
E02006656,Chippenham Pewsham,Wiltshire,South West,1177,4653,319,268,165,227,5632,1149,4885,363,295,162,200,5905
E02006657,Calne North,Wiltshire,South West,2502,6679,482,454,336,415,8366,2434,7123,493,494,348,411,8869
E02006658,Calne South,Wiltshire,South West,1315,4476,468,499,333,449,6225,1344,4778,505,519,374,487,6663
E02006659,"Box, Colerne & Rudloe",Wiltshire,South West,1609,4670,438,454,330,433,6325,1708,4895,462,472,364,453,6646
E02006660,"Corsham, Bowden Hill & Lacock",Wiltshire,South West,2658,7717,829,868,546,834,10794,2453,8162,811,866,654,884,11377
E02006661,"Larkhill, Shrewton & Bulford Camp",Wiltshire,South West,2994,6966,257,226,158,204,7811,2484,9151,262,237,181,211,10042
E02006662,Durrington & Bulford,Wiltshire,South West,1202,3740,396,330,241,279,4986,1369,3963,387,368,259,297,5274
E02006663,Amesbury,Wiltshire,South West,2651,7617,584,490,354,658,9703,2524,7890,600,554,400,681,10125
E02006664,"Great Wishford, Woodford Valley & Porton",Wiltshire,South West,1109,3656,429,473,323,413,5294,1020,3682,467,457,342,432,5380
E02006665,Mere & East Knoyle,Wiltshire,South West,993,3541,551,618,450,582,5742,982,3801,566,611,502,628,6108
E02006666,Salisbury Bishopsdown,Wiltshire,South West,1445,3931,300,361,225,418,5235,1427,4158,321,350,245,387,5461
E02006667,Salisbury Bemerton,Wiltshire,South West,1650,4219,331,237,160,216,5163,1776,4662,333,275,178,210,5658
E02006668,Salisbury Stratford,Wiltshire,South West,938,3364,340,444,343,442,4933,907,3612,363,407,350,453,5185
E02006669,"Wilton, Nadder & Ebble",Wiltshire,South West,1660,5765,704,746,595,831,8641,1631,6102,684,782,587,864,9019
E02006670,Salisbury Churchfields,Wiltshire,South West,1107,4308,356,325,261,385,5635,1078,4584,388,351,266,392,5981
E02006671,Salisbury Town North & Milford,Wiltshire,South West,998,3796,316,346,235,417,5110,979,4129,359,368,286,524,5666
E02006672,"Laverstock, Bodenham & Coombe Bissett",Wiltshire,South West,2087,5118,404,475,345,643,6985,2025,5628,404,495,356,655,7538
E02006673,Salisbury Cathedral & Harnham,Wiltshire,South West,716,2652,354,404,285,577,4272,690,2941,382,388,318,572,4601
E02006674,Salisbury East Harnham,Wiltshire,South West,1201,3537,315,291,219,399,4761,1141,3826,344,324,240,376,5110
E02006675,"Whaddon, Whiteparish & Winterslow",Wiltshire,South West,1303,4536,573,546,439,550,6644,1226,4707,587,596,444,570,6904
E02006676,"Tisbury, Donhead & Tollard Royal",Wiltshire,South West,1045,3396,502,498,351,521,5268,1023,3506,500,544,373,508,5431
E02006677,Downton & Morgan's Vale,Wiltshire,South West,1354,4364,572,578,462,700,6676,1286,4668,552,622,472,703,7017
E02006678,Melksham North,Wiltshire,South West,1561,4501,383,457,341,357,6039,1461,4820,410,437,379,408,6454
E02006679,"Bowerhill, Atworth & Whitley",Wiltshire,South West,2236,6644,701,701,476,656,9178,2347,7389,756,698,537,688,10068
E02006680,Melksham South,Wiltshire,South West,1263,4257,459,443,344,640,6143,1225,4551,460,479,365,681,6536
E02006681,"Winsley, Westwood & Holt",Wiltshire,South West,943,3090,467,475,324,513,4869,996,3468,452,495,391,508,5314
E02006682,Bradford-on-Avon,Wiltshire,South West,1722,5300,783,734,567,904,8288,1775,6202,762,780,595,916,9255
E02006683,"Staverton, Hilperton & Semington",Wiltshire,South West,1750,5151,430,408,320,354,6663,1506,5178,441,428,331,385,6763
E02006684,Trowbridge North,Wiltshire,South West,1173,4436,346,318,167,233,5500,1153,4833,365,358,265,384,6205
E02006685,Trowbridge East,Wiltshire,South West,2201,6080,510,512,345,568,8015,2310,6647,504,564,367,570,8652
E02006686,Trowbridge West,Wiltshire,South West,986,3253,311,328,211,448,4551,985,3551,284,327,226,297,4685
E02006687,Trowbridge South East,Wiltshire,South West,1553,4954,393,360,197,229,6133,1601,5501,439,366,258,263,6827
E02006688,Trowbridge South,Wiltshire,South West,1019,3545,261,308,217,274,4605,876,3779,302,310,223,308,4922
E02006689,"Steeple Ashton, North Bradley & Southwick",Wiltshire,South West,1308,3815,472,526,367,397,5577,1181,3912,454,495,405,470,5736
E02006690,Dilton Marsh & Bratton,Wiltshire,South West,1007,3593,530,572,378,456,5529,1052,4026,515,566,402,498,6007
E02006691,Westbury,Wiltshire,South West,2962,9006,665,722,513,746,11652,2834,9241,695,702,556,785,11979
E02006692,Warminster East,Wiltshire,South West,1080,3360,316,291,211,403,4581,1026,3403,288,305,231,372,4599
E02006693,Warminster West & North,Wiltshire,South West,1045,3525,367,421,246,358,4917,1055,3930,389,403,312,340,5374
E02006694,Warminster Central,Wiltshire,South West,872,3600,390,456,347,536,5329,858,3816,385,464,401,576,5642
E02006695,Wylye Valley,Wiltshire,South West,1013,3484,441,553,399,551,5428,975,3841,461,547,415,594,5858
E02003172,Kinson East,"Bournemouth, Christchurch and Poole",South West,1203,3606,360,420,276,456,5118,1181,4097,366,430,289,427,5609
E02003173,Kinson West,"Bournemouth, Christchurch and Poole",South West,1129,3472,451,467,328,590,5308,1091,4171,442,487,357,598,6055
E02003174,Northbourne,"Bournemouth, Christchurch and Poole",South West,1504,4507,466,520,384,598,6475,1478,5216,500,533,407,627,7283
E02003175,Throop & Muscliffe,"Bournemouth, Christchurch and Poole",South West,2191,5355,417,433,304,435,6944,2132,6312,459,432,350,409,7962
E02003176,West Howe,"Bournemouth, Christchurch and Poole",South West,1694,4530,319,310,220,311,5690,1661,5026,341,300,240,291,6198
E02003177,Moordown,"Bournemouth, Christchurch and Poole",South West,1793,4940,383,348,214,418,6303,1837,5767,414,383,271,407,7242
E02003178,East Howe & Ensbury Park,"Bournemouth, Christchurch and Poole",South West,1699,5102,413,437,298,465,6715,1658,5817,413,452,346,469,7497
E02003179,Townsend & Strouden,"Bournemouth, Christchurch and Poole",South West,1354,3729,346,400,294,438,5207,1304,4270,351,379,281,431,5712
E02003180,Winton,"Bournemouth, Christchurch and Poole",South West,1738,6775,280,273,221,263,7812,1638,7324,303,290,174,294,8385
E02003181,Queens Park,"Bournemouth, Christchurch and Poole",South West,1822,5381,391,403,250,420,6845,1719,6333,422,440,282,421,7898
E02003182,Littledown,"Bournemouth, Christchurch and Poole",South West,1261,3893,374,395,224,383,5269,1234,4524,354,407,276,381,5942
E02003183,Talbot & Branksome Woods,"Bournemouth, Christchurch and Poole",South West,963,4499,371,433,252,438,5993,1009,4929,389,411,317,483,6529
E02003184,Charminster,"Bournemouth, Christchurch and Poole",South West,1444,5706,229,193,149,286,6563,1405,6713,287,225,156,282,7663
E02003185,Iford,"Bournemouth, Christchurch and Poole",South West,1669,4566,354,365,224,365,5874,1532,5302,391,383,243,351,6670
E02003186,Springbourne & Queen's Park,"Bournemouth, Christchurch and Poole",South West,1946,6353,308,240,160,223,7284,1958,7668,335,281,181,214,8679
E02003187,Boscombe East,"Bournemouth, Christchurch and Poole",South West,1780,6214,428,368,255,381,7646,1846,7505,466,424,287,401,9083
E02003188,Central Bournemouth,"Bournemouth, Christchurch and Poole",South West,1145,9982,461,459,291,652,11845,1136,11482,481,469,335,598,13365
E02003189,Southbourne West,"Bournemouth, Christchurch and Poole",South West,1338,5141,555,510,336,774,7316,1270,5812,517,575,383,778,8065
E02003190,Boscombe West,"Bournemouth, Christchurch and Poole",South West,1651,7676,453,307,192,368,8996,1612,9002,474,397,215,388,10476
E02003191,East Southbourne & Hengistbury Head,"Bournemouth, Christchurch and Poole",South West,1231,4269,643,699,512,916,7039,1174,4774,598,693,579,917,7561
E02003192,East Cliff,"Bournemouth, Christchurch and Poole",South West,1268,9738,452,489,327,589,11595,1449,11674,453,463,382,617,13589
E02003194,Merley,"Bournemouth, Christchurch and Poole",South West,1036,3185,478,580,359,528,5130,1017,3708,468,534,476,517,5703
E02003195,Bearwood,"Bournemouth, Christchurch and Poole",South West,1048,3357,329,282,179,300,4447,1084,3731,363,301,210,298,4903
E02003196,Broadstone,"Bournemouth, Christchurch and Poole",South West,1519,5449,717,754,558,1173,8651,1453,6135,710,781,597,1160,9383
E02003197,Canford Heath West,"Bournemouth, Christchurch and Poole",South West,1329,4051,436,431,183,299,5400,1306,4448,447,464,233,291,5883
E02003198,Canford Heath East,"Bournemouth, Christchurch and Poole",South West,1582,4573,308,376,278,272,5807,1553,5013,349,375,300,332,6369
E02003199,Creekmoor,"Bournemouth, Christchurch and Poole",South West,1689,5354,570,571,364,604,7463,1608,5904,585,573,426,663,8151
E02003200,Rossmore,"Bournemouth, Christchurch and Poole",South West,2028,6157,517,574,429,530,8207,2123,6861,546,556,426,573,8962
E02003201,Newtown,"Bournemouth, Christchurch and Poole",South West,2217,6887,507,507,338,452,8691,2223,7656,555,503,423,507,9644
E02003202,Branksome East,"Bournemouth, Christchurch and Poole",South West,1013,4037,351,332,229,313,5262,962,4401,353,341,256,354,5705
E02003203,Branksome West,"Bournemouth, Christchurch and Poole",South West,1466,4809,416,312,255,292,6084,1445,5369,392,363,237,327,6688
E02003204,Oakdale East,"Bournemouth, Christchurch and Poole",South West,1576,5471,489,492,391,650,7493,1587,5941,493,515,405,658,8012
E02003205,Oakdale West,"Bournemouth, Christchurch and Poole",South West,1570,4813,510,553,330,552,6758,1519,5469,488,580,387,531,7455
E02003206,Penn Hill,"Bournemouth, Christchurch and Poole",South West,1972,6228,439,539,346,519,8071,1868,6886,538,551,390,548,8913
E02003207,Hamworthy West,"Bournemouth, Christchurch and Poole",South West,1595,4283,300,355,285,330,5553,1626,5405,329,363,307,314,6718
E02003208,Poole Town,"Bournemouth, Christchurch and Poole",South West,1794,7552,614,596,455,912,10129,1819,8034,598,674,497,900,10703
E02003209,Hamworthy East,"Bournemouth, Christchurch and Poole",South West,1182,3857,423,390,258,356,5284,1152,4385,434,455,310,364,5948
E02003210,Parkstone,"Bournemouth, Christchurch and Poole",South West,1648,5370,550,638,490,885,7933,1664,5848,584,665,549,925,8571
E02003211,"Branksome Park, Canford Cliffs & Sandbanks","Bournemouth, Christchurch and Poole",South West,876,4313,689,927,681,1470,8080,837,4341,686,895,798,1474,8194
E02004236,Burton & Airport,"Bournemouth, Christchurch and Poole",South West,895,3293,442,504,360,529,5128,903,3610,490,555,397,577,5629
E02004237,Jumpers Common & Fairmile,"Bournemouth, Christchurch and Poole",South West,1452,4625,467,580,406,730,6808,1478,5083,454,549,431,673,7190
E02004238,Highcliffe & Walkford,"Bournemouth, Christchurch and Poole",South West,816,3331,617,840,644,1198,6630,801,3560,553,837,696,1246,6892
E02004239,West Highcliffe,"Bournemouth, Christchurch and Poole",South West,897,2991,490,602,468,635,5186,861,3244,441,602,478,719,5484
E02004240,Somerford,"Bournemouth, Christchurch and Poole",South West,1253,4025,309,317,186,279,5116,1214,4242,322,306,217,279,5366
E02004241,Christchurch Town,"Bournemouth, Christchurch and Poole",South West,1764,5363,560,648,479,869,7919,1720,5711,546,641,525,976,8399
E02004242,Mudeford,"Bournemouth, Christchurch and Poole",South West,738,2986,600,732,519,841,5678,754,3233,580,670,610,836,5929
E02006883,Westbourne,"Bournemouth, Christchurch and Poole",South West,557,3814,268,321,243,676,5322,620,4463,289,303,294,627,5976
E02006885,West Cliff,"Bournemouth, Christchurch and Poole",South West,794,5297,401,458,317,662,7135,826,6355,433,471,378,648,8285
E02004243,Alderholt & Sixpenny Handley,Dorset,South West,1134,3765,486,507,290,341,5389,1082,3992,474,518,324,375,5683
E02004244,East Verwood,Dorset,South West,1210,4156,458,540,436,626,6216,1243,4559,479,545,452,701,6736
E02004245,West Verwood,Dorset,South West,1398,4257,475,549,411,619,6311,1305,4545,463,579,411,643,6641
E02004246,St Leonards,Dorset,South West,819,3478,723,884,624,826,6535,925,3963,704,922,668,913,7170
E02004247,Sturminster Marshall & Crichel,Dorset,South West,990,3528,469,491,288,389,5165,972,3708,494,475,326,359,5362
E02004248,West Moors,Dorset,South West,829,3547,651,868,638,1090,6794,783,3603,596,828,696,1143,6866
E02004249,Colehill,Dorset,South West,984,3131,409,510,295,372,4717,965,3444,409,507,339,419,5118
E02004250,Ferndown Town,Dorset,South West,1096,3849,629,744,586,1056,6864,1066,4042,587,767,604,1124,7124
E02004251,Ferndown West & Canford Bottom,Dorset,South West,1038,3499,446,557,377,625,5504,974,3665,431,560,427,620,5703
E02004252,Wimborne Minster,Dorset,South West,1234,4230,491,496,422,800,6439,1176,4406,479,552,459,809,6705
E02004253,Parley & Hampreston,Dorset,South West,1294,4705,762,859,749,1272,8347,1294,5155,708,899,785,1355,8902
E02004254,Corfe Mullen,Dorset,South West,1882,5898,666,699,489,585,8337,1759,6489,679,741,535,667,9111
E02004255,Gillingham,Dorset,South West,1152,4313,461,599,377,738,6488,1117,4433,483,571,444,758,6689
E02004256,"Gillingham Outer, Bourton & Motcombe",Dorset,South West,1621,5151,664,655,452,627,7549,1593,5542,689,674,526,668,8099
E02004257,Shaftesbury,Dorset,South West,1728,5116,518,528,389,656,7207,1752,5492,516,553,422,695,7678
E02004258,Sturminster Newton & Stalbridge,Dorset,South West,1478,5402,833,905,636,956,8732,1499,5838,814,906,682,1050,9290
E02004259,Child Okeford & Iwerne Minster,Dorset,South West,1238,3895,588,606,408,521,6018,1128,4263,543,628,451,583,6468
E02004260,Blandford Outer & Tarrants,Dorset,South West,1721,5377,557,576,393,437,7340,1697,5478,550,572,425,454,7479
E02004261,Blandford Forum Town,Dorset,South West,1874,6143,613,656,454,730,8596,1853,6224,645,694,466,768,8797
E02004262,"Milborne, Winterborne & Okeford Fitzpaine",Dorset,South West,1176,4593,666,662,442,437,6800,1176,5003,658,713,456,515,7345
E02004263,Bere Regis & Lytchett Matravers,Dorset,South West,1041,3329,437,405,315,393,4879,1000,3528,428,459,336,397,5148
E02004264,Upton & Lytchett Minster,Dorset,South West,1579,5038,522,581,424,557,7122,1538,5323,542,619,444,584,7512
E02004265,"Wareham, Sandford & Holton Heath",Dorset,South West,1425,4754,678,672,514,744,7362,1317,4902,639,742,561,796,7640
E02004266,"Bovington, Wool & Lulworth",Dorset,South West,1668,5308,517,565,374,434,7198,1546,5345,487,527,416,466,7241
E02004267,Corfe Castle & Langton Matravers,Dorset,South West,599,2681,482,505,309,431,4408,630,2885,461,528,382,476,4732
E02004268,Swanage,Dorset,South West,1222,5232,786,950,671,956,8595,1234,5394,792,911,733,1043,8873
E02004269,Sherborne,Dorset,South West,1785,4996,582,784,612,1135,8109,1678,5115,615,731,672,1143,8276
E02004270,"Yetminster, Bradford Abbas & Longburton",Dorset,South West,1078,4071,674,686,527,643,6601,1279,4909,681,757,577,757,7681
E02004271,"Beaminster, Maiden Newton & Halstock",Dorset,South West,1363,5118,811,924,644,828,8325,1386,5659,855,944,725,915,9098
E02004272,"Charlton Down, Cerne Abbas & Puddletown",Dorset,South West,1928,6611,902,949,671,838,9971,1872,7228,871,973,760,886,10718
E02004273,"Lyme Regis, Charmouth & Marshwood Vale",Dorset,South West,870,3613,692,735,509,804,6353,887,3995,601,735,564,827,6722
E02004274,Bridport North,Dorset,South West,1002,3487,550,555,375,580,5547,912,3616,540,579,420,590,5745
E02004275,Burton Bradstock & Chideock,Dorset,South West,1058,3823,769,744,515,629,6480,1041,4182,778,731,532,658,6881
E02004276,Bridport South & West Bay,Dorset,South West,651,2846,510,550,398,597,4901,637,3003,523,569,433,603,5131
E02004277,Dorchester West & Poundbury,Dorset,South West,1901,7048,737,802,629,1348,10564,1879,7511,712,903,719,1406,11251
E02004278,Dorchester East,Dorset,South West,1567,5061,623,599,464,659,7406,1504,5476,568,626,476,640,7786
E02004279,"Owermoigne, Broadmayne & Winterbourne",Dorset,South West,1160,4469,696,682,448,582,6877,1180,4737,660,706,495,578,7176
E02004280,Chickerell & Chesil Bank,Dorset,South West,1351,4575,641,622,448,593,6879,1299,4931,606,637,509,665,7348
E02004281,Broadwey & Littlemoor,Dorset,South West,1511,4560,419,432,254,308,5973,1448,4846,465,454,309,335,6409
E02004282,Preston & Lodmoor,Dorset,South West,1045,4279,871,928,649,1014,7741,1001,4571,786,947,729,1073,8106
E02004283,Westham North & Radipole,Dorset,South West,1455,4932,583,654,476,651,7296,1538,5481,599,638,513,680,7911
E02004284,"Weymouth Town, Melcombe Regis & Rodwell",Dorset,South West,1338,5899,693,697,431,726,8446,1283,6542,737,725,526,733,9263
E02004285,Westham South,Dorset,South West,1160,4535,476,469,369,536,6385,1198,4904,468,499,350,521,6742
E02004286,Weymouth West,Dorset,South West,874,3091,328,358,197,359,4333,816,3166,342,365,224,346,4443
E02004287,Wyke Regis,Dorset,South West,917,3219,393,464,269,309,4654,905,3392,385,454,289,357,4877
E02004288,Underhill & The Grove,Dorset,South West,974,3960,368,327,177,237,5069,926,4292,350,337,220,231,5430
E02004289,Southwell & Weston,Dorset,South West,1307,4166,534,549,352,360,5961,1213,4315,565,540,418,422,6260
E02004129,"Dunkesewell, Upottery & Stockland",East Devon,South West,894,3065,432,570,377,468,4912,895,3243,461,507,423,480,5114
E02004130,Honiton North & East,East Devon,South West,929,3252,393,477,369,628,5119,889,3335,384,481,402,682,5284
E02004131,Honiton South & West,East Devon,South West,881,3138,359,387,278,458,4620,827,3189,351,391,299,500,4730
E02004132,Feniton & Whimple,East Devon,South West,1567,4887,673,667,414,552,7193,1501,5203,653,656,483,542,7537
E02004133,Axminster,East Devon,South West,1469,5064,702,756,558,770,7850,1556,5549,684,785,635,818,8471
E02004134,"Cranbrook, Broadclyst & Stoke Canon",East Devon,South West,3305,8219,535,531,378,494,10157,3724,9719,600,544,387,561,11811
E02004135,"Kilmington, Colyton & Uplyme",East Devon,South West,1160,4172,767,832,593,826,7190,1045,4350,736,811,657,864,7418
E02004136,Ottery St Mary & West Hill,East Devon,South West,1678,4688,640,686,484,731,7229,1682,5300,609,734,525,810,7978
E02004137,"Sidbury, Offwell & Beer",East Devon,South West,703,2697,501,556,405,533,4692,663,2821,476,570,442,567,4876
E02004138,Seaton,East Devon,South West,801,3337,690,883,698,1126,6734,788,3578,645,895,725,1173,7016
E02004139,Sidmouth Sidford,East Devon,South West,1089,3459,529,633,531,790,5942,996,3605,484,625,573,776,6063
E02004140,Sidmouth Town,East Devon,South West,443,2189,500,590,449,1067,4795,391,2243,471,604,506,1089,4913
E02004141,"Poppleford, Otterton & Woodbury",East Devon,South West,967,3409,474,482,340,480,5185,962,3598,482,514,374,506,5474
E02004142,"Clyst, Exton & Lympstone",East Devon,South West,987,4206,466,449,294,433,5848,900,4604,432,439,339,447,6261
E02004143,Exmouth Brixington,East Devon,South West,1029,3571,474,531,401,470,5447,990,3598,444,517,412,522,5493
E02004144,Exmouth Halsdon,East Devon,South West,1137,3678,540,567,397,617,5799,1076,3797,547,572,488,594,5998
E02004145,Budleigh Salterton,East Devon,South West,773,2714,605,711,541,874,5445,694,2840,574,671,586,910,5581
E02004146,Exmouth Withycombe Raleigh,East Devon,South West,1426,4387,467,442,280,412,5988,1465,4670,458,496,324,411,6359
E02004147,Exmouth Town,East Devon,South West,1182,4783,411,429,221,361,6205,1081,4901,409,434,253,367,6364
E02004148,Exmouth Littleham,East Devon,South West,964,3570,538,740,580,1122,6550,966,3959,574,741,650,1197,7121
E02004149,Pennsylvania & University,Exeter,South West,888,9130,429,447,281,455,10742,962,13190,433,468,328,443,14862
E02004150,Mincinglake & Beacon Heath,Exeter,South West,1346,4824,270,212,160,207,5673,1264,4918,309,269,211,274,5981
E02004151,Pinhoe & Whipton North,Exeter,South West,1864,5592,474,451,330,657,7504,1985,6338,479,496,397,644,8354
E02004152,St James's Park & Hoopern,Exeter,South West,572,8155,193,190,141,334,9013,573,7737,209,182,161,194,8483
E02004153,Exwick & Foxhayes,Exeter,South West,1554,4956,314,333,213,195,6011,1466,5184,351,344,244,241,6364
E02004154,Heavitree West & Polsloe,Exeter,South West,1296,6253,225,248,201,315,7242,1199,6103,262,266,179,337,7147
E02004155,Heavitree East & Whipton South,Exeter,South West,1454,4534,424,399,272,458,6087,1502,4893,451,415,290,429,6478
E02004156,Central Exeter,Exeter,South West,987,9906,360,304,205,326,11101,909,11022,352,354,247,383,12358
E02004157,St Leonard's,Exeter,South West,1030,4457,298,296,211,428,5690,1021,5094,316,294,227,376,6307
E02004158,St Thomas East,Exeter,South West,1501,5532,290,306,213,341,6682,1426,5924,330,325,209,340,7128
E02004159,Middlemoor & Sowton,Exeter,South West,2558,8065,557,559,373,438,9992,2470,8064,569,607,415,499,10154
E02004160,St Thomas West,Exeter,South West,1316,4234,399,407,331,588,5959,1258,4464,402,447,350,609,6272
E02004161,Wonford & St Loye's,Exeter,South West,1558,5386,304,327,248,464,6729,1724,6036,361,358,291,495,7541
E02004162,Alphington & Marsh Barton,Exeter,South West,1162,4697,368,341,300,474,6180,1010,4518,379,367,317,520,6101
E02004163,Countess Wear & Topsham,Exeter,South West,1342,4207,519,567,417,662,6372,1388,4845,550,611,458,684,7148
E02004164,"Bampton, Holcombe & Westleigh",Mid Devon,South West,1098,3824,525,560,354,484,5747,1021,3947,524,575,404,521,5971
E02004165,Tiverton North & Outer,Mid Devon,South West,1467,4833,588,633,516,650,7220,1391,5139,549,625,509,742,7564
E02004166,Uffculme & Hemyock,Mid Devon,South West,1309,3884,455,474,313,404,5530,1242,3999,438,483,360,415,5695
E02004167,Tiverton East,Mid Devon,South West,1647,4501,335,320,253,383,5792,1582,4702,373,348,292,411,6126
E02004168,Tiverton West,Mid Devon,South West,1201,3753,397,333,252,373,5108,1247,4050,350,375,269,383,5427
E02004169,"Willand, Sampford Peverell & Halberton",Mid Devon,South West,1344,4301,445,446,324,460,5976,1388,4671,459,475,360,494,6459
E02004170,Cullompton,Mid Devon,South West,1705,5352,500,453,321,464,7090,1677,5675,481,469,364,467,7456
E02004171,"Bradninch, Silverton & Thorverton",Mid Devon,South West,1551,4829,562,552,368,500,6811,1543,5229,577,561,433,509,7309
E02004172,"Bow, Lapford & Yeoford",Mid Devon,South West,1055,3659,503,492,298,363,5315,1052,3919,496,503,347,394,5659
E02004173,"Morchard Bishop, Copplestone & Newton St Cyres",Mid Devon,South West,1278,4243,593,528,342,436,6142,1239,4501,577,565,372,500,6515
E02004174,Crediton,Mid Devon,South West,1487,4607,455,483,342,551,6438,1506,4882,454,505,374,558,6773
E02004175,Ilfracombe East,North Devon,South West,930,3190,361,360,221,321,4453,914,3619,376,344,276,349,4964
E02004176,Lynton & Combe Martin,North Devon,South West,711,3001,528,478,345,420,4772,812,3514,510,539,369,411,5343
E02004177,Ilfracombe West,North Devon,South West,1000,3454,410,414,257,368,4903,1023,3805,413,467,289,382,5356
E02004178,"Woolacombe, Georgeham & Croyde",North Devon,South West,918,3015,394,422,271,371,4473,914,3308,375,444,329,371,4827
E02004179,Braunton,North Devon,South West,1780,5390,496,611,469,690,7656,1749,5635,477,593,505,753,7963
E02004180,"Bratton Fleming, Goodleigh & Kings Heanton",North Devon,South West,1092,3487,469,430,294,378,5058,1065,3874,471,475,384,443,5647
E02004181,Barnstaple Pilton,North Devon,South West,1021,3434,331,364,256,424,4809,1016,3639,336,384,259,421,5039
E02004182,Barnstaple Central,North Devon,South West,1235,3829,306,344,239,390,5108,1144,4250,337,326,263,397,5573
E02004183,Barnstaple Sticklepath,North Devon,South West,877,3267,359,505,349,538,5018,845,3577,365,465,411,544,5362
E02004184,Barnstaple South,North Devon,South West,1907,5502,371,444,283,384,6984,1781,5742,409,444,275,387,7257
E02004185,Fremington & Instow,North Devon,South West,1030,3228,464,606,402,667,5367,989,3580,468,568,522,669,5807
E02004186,Roundswell & Landkey,North Devon,South West,1751,5409,539,573,466,508,7495,1878,6156,586,611,487,610,8450
E02004187,South Molton,North Devon,South West,1645,5722,648,724,510,722,8326,1786,6226,751,802,580,794,9153
E02004188,"Bishop's Nympton, Witheridge & Chulmleigh",North Devon,South West,980,3800,525,587,416,518,5846,993,4022,564,576,467,588,6217
E02004189,Woolwell & Lee Mill,South Hams,South West,945,3946,379,346,224,295,5190,985,3876,410,373,248,322,5229
E02004190,South Brent & Cornwood,South Hams,South West,1355,4751,618,633,395,565,6962,1346,5308,628,699,442,555,7632
E02004191,Totnes Town,South Hams,South West,1388,5117,683,598,454,604,7456,1388,5954,653,658,502,645,8412
E02004192,"Marldon, Stoke Gabriel & Kingswear",South Hams,South West,1073,3996,709,719,425,571,6420,1077,4246,673,742,511,580,6752
E02004193,Ivybridge,South Hams,South West,2224,7090,672,678,468,625,9533,2136,7390,694,722,520,658,9984
E02004194,Loddiswell & Dartington,South Hams,South West,1302,4072,549,525,303,475,5924,1367,4560,579,542,354,467,6502
E02004195,Dartmouth,South Hams,South West,671,3088,433,488,336,411,4756,648,3395,435,447,347,472,5096
E02004196,"Yealmpton, Modbury & Aveton Gifford",South Hams,South West,1316,4163,637,705,359,526,6390,1375,4552,609,713,461,570,6905
E02004197,"Wembury, Brixton & Newton Ferrers",South Hams,South West,967,3487,572,641,500,607,5807,995,3817,547,610,523,646,6143
E02004198,Kingsbridge,South Hams,South West,1058,3598,430,483,331,596,5438,962,3717,419,468,373,594,5571
E02004199,"Chillington, Torcross & Stoke Fleming",South Hams,South West,776,2722,548,644,424,550,4888,738,2973,509,647,444,631,5204
E02004200,"Salcombe, Malborough & Thurlestone",South Hams,South West,653,2662,479,525,381,465,4512,650,2866,443,483,376,496,4664
E02004201,"Tedburn, Shillingford & Higher Ashton",Teignbridge,South West,788,2865,482,463,367,418,4595,771,3046,488,487,402,456,4879
E02004202,Starcross & Exminster,Teignbridge,South West,1509,5113,562,569,372,515,7131,1564,5393,565,590,450,547,7545
E02004203,"Moretonhampstead, Lustleigh & East Dartmoor",Teignbridge,South West,772,3278,523,508,318,485,5112,813,3436,493,570,343,494,5336
E02004204,Chudleigh & Bovey Tracey,Teignbridge,South West,1720,5491,684,670,496,694,8035,1700,5906,692,673,575,709,8555
E02004205,Dawlish North,Teignbridge,South West,1438,4832,676,683,370,500,7061,1422,5217,742,684,505,542,7690
E02004206,Dawlish South,Teignbridge,South West,810,3501,566,649,470,714,5900,745,3748,573,628,530,750,6229
E02004207,Heathfield & Liverton,Teignbridge,South West,1090,3614,453,471,348,475,5361,1065,3949,447,473,412,488,5769
E02004208,Teignmouth North,Teignbridge,South West,1306,4562,717,787,452,644,7162,1227,4667,663,793,536,641,7300
E02004209,Kingsteignton,Teignbridge,South West,1563,5328,475,550,429,562,7344,1628,5702,482,557,460,611,7812
E02004210,Teignmouth South,Teignbridge,South West,1013,3957,441,445,313,639,5795,1056,4144,463,451,344,612,6014
E02004211,Bishopsteignton & Shaldon,Teignbridge,South West,881,3342,655,724,433,663,5817,842,3491,638,735,474,723,6061
E02004212,"Newton Abbot, Highweek",Teignbridge,South West,1078,3770,375,398,228,301,5072,1059,3782,358,392,250,370,5152
E02004213,"Ogwell, Mile End & Teigngrace",Teignbridge,South West,1649,5282,429,393,257,378,6739,1751,5824,471,431,277,374,7377
E02004214,"Newton Abbot, Town Centre",Teignbridge,South West,1158,3956,296,316,212,317,5097,1041,3991,301,316,258,311,5177
E02004215,"Newton Abbot, Broadlands & Wolborough",Teignbridge,South West,922,3482,344,364,210,446,4846,936,3875,359,362,261,499,5356
E02004216,"Newton Abbot, Milber & Buckland",Teignbridge,South West,890,3198,414,403,291,407,4713,867,3376,406,399,338,438,4957
E02004217,Ashburton & Buckfastleigh,Teignbridge,South West,1413,4621,566,550,392,493,6622,1334,4830,553,566,442,514,6905
E02004218,Kingskerswell,Teignbridge,South West,921,3498,459,498,314,455,5224,967,3645,442,502,372,460,5421
E02004219,Ipplepen & Broadhempston,Teignbridge,South West,825,3040,420,473,357,501,4791,813,3268,425,472,424,506,5095
E02004220,Appledore & Northam North,Torridge,South West,817,3240,551,542,426,522,5281,787,3363,523,575,470,559,5490
E02004221,Westward Ho! & Northam South,Torridge,South West,726,3107,613,669,488,778,5655,763,3292,529,667,518,744,5750
E02004222,Bideford North,Torridge,South West,993,3635,396,374,220,341,4966,952,3937,377,411,277,350,5352
E02004223,Bideford South & East,Torridge,South West,2727,7622,758,706,448,553,10087,2715,8131,754,759,520,598,10762
E02004224,Hartland Coast,Torridge,South West,915,3606,556,593,365,473,5593,886,3628,554,575,417,528,5702
E02004225,Great Torrington,Torridge,South West,1092,3465,365,379,272,407,4888,1017,3526,357,415,293,455,5046
E02004226,Winkleigh & High Bickington,Torridge,South West,988,4029,667,641,456,531,6324,1024,4152,675,651,492,575,6545
E02004227,"Holsworthy, Bradworthy & Welcombe",Torridge,South West,1656,5712,832,773,503,657,8477,1639,5919,760,811,561,678,8729
E02004228,"Shebbear, Cookworthy & Broadheath",Torridge,South West,1008,3995,629,594,402,454,6074,1024,4357,630,670,494,526,6677
E02004229,"Hatherleigh, Exbourne & North Tawton",West Devon,South West,1674,5574,645,671,469,614,7973,1680,5773,652,674,513,659,8271
E02004230,Okehampton,West Devon,South West,1371,4373,460,485,366,554,6238,1300,4681,460,514,425,575,6655
E02004231,"Chagford, Princetown & Dartmoor",West Devon,South West,957,4080,549,558,386,415,5988,950,4351,553,555,411,471,6341
E02004232,"Lifton, Lamerton & Bridestowe",West Devon,South West,1013,3779,557,543,322,434,5635,967,3970,569,555,402,477,5973
E02004233,Tavistock,West Devon,South West,2135,6839,883,995,667,1026,10410,1966,7162,904,990,786,1126,10968
E02004234,Horrabridge & Mary Tavy,West Devon,South West,843,3259,518,580,357,511,5225,857,3390,551,571,427,520,5459
E02004235,"Bere Alston, Buckland Monachorum & Yelverton",West Devon,South West,896,3394,531,596,394,523,5438,934,3645,503,622,443,554,5767
E02004600,Swindon Village & Wyman's Brook,Cheltenham,South West,979,3376,325,312,228,227,4468,1009,3728,348,327,219,269,4891
E02004601,Prestbury & Racecourse,Cheltenham,South West,834,2787,400,480,332,544,4543,908,3182,398,455,357,575,4967
E02004602,Springbank,Cheltenham,South West,1398,3872,322,288,215,297,4994,1477,4652,312,296,216,296,5772
E02004603,St Paul's,Cheltenham,South West,1166,6189,260,277,114,259,7099,1162,6634,286,270,194,261,7645
E02004604,Arle & Hesters Way,Cheltenham,South West,1939,5080,337,247,212,299,6175,1989,5759,351,238,199,303,6850
E02004605,Oakley,Cheltenham,South West,1223,3458,275,253,203,203,4392,1327,3932,295,243,202,226,4898
E02004606,Alstone & St Mark's,Cheltenham,South West,1719,6884,405,358,215,486,8348,1815,7831,405,390,257,534,9417
E02004607,Pittville & Fairview,Cheltenham,South West,1231,6635,468,407,270,447,8227,1219,7128,461,477,313,478,8857
E02004608,Lansdown & Montpellier,Cheltenham,South West,1272,7073,467,468,290,720,9018,1414,7597,447,465,375,658,9542
E02004609,Benhall & The Reddings,Cheltenham,South West,1236,4215,352,420,358,431,5776,1276,4593,371,400,357,521,6242
E02004610,The Park & Warden Hill,Cheltenham,South West,1175,4547,438,501,382,681,6549,1082,5192,402,539,404,710,7247
E02004611,Battledown & Charlton Kings,Cheltenham,South West,2553,6784,540,562,386,674,8946,2597,7636,545,543,426,721,9871
E02004612,Hatherley,Cheltenham,South West,1590,5340,513,527,444,687,7511,1634,5784,519,545,447,688,7983
E02004613,Charlton Park,Cheltenham,South West,1235,3535,414,441,334,511,5235,1206,3951,421,402,362,550,5686
E02004614,Leckhampton,Cheltenham,South West,1085,2986,327,349,220,508,4390,1124,3351,350,374,238,489,4802
E02004615,"Willersley, Chipping Campden & Blockley",Cotswold,South West,1259,4471,681,675,583,809,7219,1219,4919,713,699,609,808,7748
E02004616,Moreton & Stow-on-the-Wold,Cotswold,South West,1439,5346,685,707,573,901,8212,1475,5851,682,721,598,925,8777
E02004617,Bourton-on-the-Water & Vale,Cotswold,South West,1673,5231,591,631,458,622,7533,1729,5805,582,618,513,642,8160
E02004618,"Sandywell, Ermin & Chedworth",Cotswold,South West,1226,4363,545,512,291,361,6072,1135,4640,577,555,340,386,6498
E02004619,"Northleach, Coln Valley & Ampneys",Cotswold,South West,1127,4256,550,559,383,491,6239,1091,4482,542,539,436,497,6496
E02004620,Cirencester East & Stratton,Cotswold,South West,1624,5002,539,466,321,372,6700,1578,5433,512,538,337,418,7238
E02004621,Cirencester Central,Cotswold,South West,826,3896,323,392,350,764,5725,765,4430,320,411,333,749,6243
E02004622,Cirencester South,Cotswold,South West,1239,4740,389,413,288,517,6347,1199,4524,396,421,338,495,6174
E02004623,Fairford & Lechlade,Cotswold,South West,1606,5025,667,676,468,659,7495,1578,5500,657,741,522,656,8076
E02004624,Kemble & South Cerney,Cotswold,South West,1162,3862,425,474,309,363,5433,1181,4252,444,454,357,423,5930
E02004625,Tetbury,Cotswold,South West,1671,5587,695,676,500,577,8035,1700,6220,713,716,540,680,8869
E02004626,"Dymock, Hartpury & Huntley",Forest of Dean,South West,1379,6359,714,675,533,648,8929,1380,6450,694,708,530,674,9056
E02004627,Newent,Forest of Dean,South West,970,3612,416,449,318,422,5217,1108,3834,390,438,355,445,5462
E02004628,"Mitcheldean, Drybrook & Ruardean",Forest of Dean,South West,1451,4749,535,530,354,434,6602,1389,4865,539,553,408,457,6822
E02004629,Cinderford,Forest of Dean,South West,2396,7896,829,754,528,695,10702,2338,8063,844,778,559,718,10962
E02004630,"Longhope, Westbury & Blakeney",Forest of Dean,South West,972,3752,515,504,359,512,5642,939,4002,491,522,373,501,5889
E02004631,"Lydbrook, Newland & St Briavels",Forest of Dean,South West,733,2918,450,416,296,286,4366,660,3009,383,413,294,343,4442
E02004632,Coleford,Forest of Dean,South West,1886,6355,714,723,493,722,9007,1826,6478,740,753,571,752,9294
E02004633,"Bream, Pillowell & Yorkley",Forest of Dean,South West,1379,4954,671,633,409,440,7107,1301,5043,640,626,423,503,7235
E02004634,Lydney,Forest of Dean,South West,1848,6231,657,709,505,664,8766,1874,6671,648,742,564,734,9359
E02004635,Tidenham & Woolaston,Forest of Dean,South West,1271,4226,541,539,367,495,6168,1201,4434,483,546,360,464,6287
E02004636,Longlevens,Gloucester,South West,1296,4897,424,488,337,486,6632,1275,5058,462,467,372,471,6830
E02004637,Kingsholm & Wotton,Gloucester,South West,1338,5971,454,396,347,638,7806,1393,6243,430,436,323,613,8045
E02004638,Elmbridge,Gloucester,South West,1097,3480,313,319,213,324,4649,1115,3790,288,335,233,362,5008
E02004639,Central Gloucester & Hempsted,Gloucester,South West,1496,7152,341,381,268,450,8592,1733,8026,419,395,324,532,9696
E02004640,Barton,Gloucester,South West,2066,5328,263,195,171,200,6157,2239,6483,312,202,184,239,7420
E02004641,Hucclecote,Gloucester,South West,1135,3979,456,609,503,689,6236,1138,4164,471,541,525,716,6417
E02004642,"Coney Hill, Barnwood & Abbeydale",Gloucester,South West,2618,7487,615,504,309,430,9345,2537,8174,592,530,396,422,10114
E02004643,Tredworth,Gloucester,South West,1970,5131,265,209,149,251,6005,2030,5904,284,229,170,254,6841
E02004644,Podsmead & Linden,Gloucester,South West,1911,5658,390,343,250,362,7003,1878,6084,414,334,260,371,7463
E02004645,Abbeymead & Abbeydale,Gloucester,South West,1653,5717,529,529,308,399,7482,1572,5856,532,524,361,412,7685
E02004646,Matson & Robinswood,Gloucester,South West,1956,5407,453,427,278,403,6968,1990,5846,455,437,316,406,7460
E02004647,Tuffley,Gloucester,South West,1070,3412,393,358,287,438,4888,1107,3712,364,377,269,448,5170
E02004648,Lower Tuffley,Gloucester,South West,973,3187,353,460,393,381,4774,913,3252,321,450,396,430,4849
E02004649,Quedgeley North,Gloucester,South West,1465,4908,264,238,163,263,5836,1482,5173,305,234,156,152,6020
E02004650,Quedgeley South,Gloucester,South West,3914,9632,417,315,216,217,10797,3838,9549,471,379,262,340,11001
E02004651,Upton St Leonards & Hardwicke,Stroud,South West,2304,6111,517,461,299,353,7741,2374,6778,492,512,321,375,8478
E02004652,"Painswick, Bisley & Eastcombe",Stroud,South West,1001,3534,518,539,462,545,5598,976,3735,543,566,458,646,5948
E02004653,"Frampton, Whitminster & Eastington",Stroud,South West,1157,4095,466,456,293,394,5704,1274,4656,497,514,354,500,6521
E02004654,Ebley & Randwick,Stroud,South West,2185,7182,707,684,464,648,9685,2019,7222,667,743,518,698,9848
E02004655,Stonehouse,Stroud,South West,1546,4879,470,429,299,408,6485,1415,5237,492,469,333,473,7004
E02004656,Stroud Town,Stroud,South West,1969,7641,625,544,338,570,9718,1899,7736,692,616,381,591,10016
E02004657,Rodborough & Thrupp,Stroud,South West,1182,4197,413,413,274,338,5635,1154,4460,429,426,320,370,6005
E02004658,Chalford & Bussage,Stroud,South West,1082,3766,371,410,259,372,5178,1060,4023,374,426,306,386,5515
E02004659,Leonard Stanley & Uley,Stroud,South West,1187,3921,490,504,382,427,5724,1211,4202,524,515,386,496,6123
E02004660,Minchinhampton & Amberley,Stroud,South West,1086,3393,512,586,403,705,5599,1065,3743,476,590,472,698,5979
E02004661,Cam,Stroud,South West,1372,5101,550,610,430,554,7245,1331,5182,548,652,455,605,7442
E02004662,Berkeley & Sharpness,Stroud,South West,1061,3925,427,394,285,362,5393,1067,4005,458,424,297,391,5575
E02004663,Nailsworth,Stroud,South West,1108,3916,467,432,280,399,5494,1113,4098,481,468,314,412,5773
E02004664,Dursley,Stroud,South West,1609,4655,332,363,249,442,6041,1508,4843,342,366,275,460,6286
E02004665,Wotton-under-Edge & Kingswood,Stroud,South West,1566,5121,591,607,449,541,7309,1507,5420,560,595,474,578,7627
E02004666,Tewkesbury East & Ashchurch,Tewkesbury,South West,2519,7805,638,557,348,478,9826,2325,7893,640,573,429,495,10030
E02004667,Tewkesbury West & Twyning,Tewkesbury,South West,1776,6744,750,778,590,809,9671,1726,6697,735,818,609,845,9704
E02004668,Winchcombe & Washbourne,Tewkesbury,South West,1473,4958,718,771,553,706,7706,1466,5269,704,852,610,709,8144
E02004669,"Cleeve Hill, Gotherington & Apperley",Tewkesbury,South West,1282,4155,587,559,387,526,6214,1294,4347,534,569,405,519,6374
E02004670,Bishop's Cleeve,Tewkesbury,South West,3302,9155,784,771,672,1026,12408,3272,9812,781,806,690,1061,13150
E02004671,"Highnam, Longford & Norton",Tewkesbury,South West,1261,4081,549,505,298,339,5772,1429,4470,593,531,372,398,6364
E02004672,Churchdown & Innsworth,Tewkesbury,South West,2497,8015,681,719,510,804,10729,2374,8429,613,673,547,813,11075
E02004673,"Shurdington, Staverton & Witcombe",Tewkesbury,South West,1239,3984,410,416,382,471,5663,1467,4503,438,432,350,528,6251
E02004674,Brockworth & Coopers Edge,Tewkesbury,South West,2526,7268,507,533,334,513,9155,2569,7629,559,520,392,551,9651
E02006047,"Rode, Mells & Woodlands",Mendip,South West,1533,4990,619,675,368,487,7139,1474,5533,603,667,465,535,7803
E02006048,"Stratton, Holcombe & Highbury",Mendip,South West,1308,4147,520,456,305,382,5810,1333,4631,489,515,345,406,6386
E02006049,Frome North East,Mendip,South West,1229,4222,517,549,402,490,6180,1161,4396,516,597,454,544,6507
E02006050,Frome North West,Mendip,South West,1802,5493,485,381,272,488,7119,1836,5946,482,410,297,474,7609
E02006051,"Draycott, Westbury & Wookey",Mendip,South West,1381,4437,575,625,462,661,6760,1378,4960,602,609,467,693,7331
E02006052,"Oakhill, Horrington & Chewton Mendip",Mendip,South West,1243,4544,525,522,395,584,6570,1209,4971,545,514,440,583,7053
E02006053,Frome South & East,Mendip,South West,2336,6321,577,465,337,458,8158,2366,7136,587,555,396,498,9172
E02006054,Wells Town,Mendip,South West,1269,4600,571,632,435,902,7140,1196,5042,555,654,517,865,7633
E02006055,Shepton Mallet,Mendip,South West,1840,5811,468,453,284,400,7416,1828,6216,477,478,324,414,7909
E02006056,Evercreech & Nunney,Mendip,South West,1337,4452,535,559,376,464,6386,1323,4781,494,585,400,496,6756
E02006057,Glastonbury Town,Mendip,South West,1327,4526,592,508,349,483,6458,1264,5338,596,590,382,500,7406
E02006058,Glastonbury West & Street South,Mendip,South West,1663,5146,513,560,372,523,7114,1721,5780,510,563,397,531,7781
E02006059,"Pilton, Butleigh & Alhampton",Mendip,South West,1053,3847,552,561,356,424,5740,1066,4262,548,574,374,473,6231
E02006060,Street Village,Mendip,South West,1536,4994,387,449,352,558,6740,1527,5369,422,453,352,589,7185
E02006061,Cheddar & Axbridge,Sedgemoor,South West,1562,5271,610,660,443,686,7670,1527,5681,581,682,537,714,8195
E02006062,Berrow & Brent Knoll,Sedgemoor,South West,1665,6104,868,932,676,914,9494,1527,6385,953,985,742,1007,10072
E02006063,Wedmore & Mark,Sedgemoor,South West,1081,3830,562,558,415,454,5819,1026,4037,513,602,427,491,6070
E02006064,Burnham-on-Sea,Sedgemoor,South West,964,3917,649,670,551,905,6692,923,4206,580,713,595,949,7043
E02006065,Highbridge,Sedgemoor,South West,1724,5081,535,629,408,484,7137,1713,5548,578,605,493,503,7727
E02006066,"Pawlett, Puriton & Woolavington",Sedgemoor,South West,1322,4636,699,646,473,530,6984,1369,4983,627,679,496,567,7352
E02006067,"Cannington, Combwich & Nether Stowey",Sedgemoor,South West,1079,3829,533,571,369,528,5830,1070,4167,547,564,431,578,6287
E02006068,Bridgwater North,Sedgemoor,South West,1864,4895,328,357,204,308,6092,1801,5383,332,351,213,326,6605
E02006069,Bridgwater Town,Sedgemoor,South West,1902,6874,472,434,240,439,8459,1978,7633,424,443,244,431,9175
E02006070,Bridgwater East,Sedgemoor,South West,1649,5129,452,397,273,391,6642,1663,5444,420,442,323,393,7022
E02006071,Wembdon & Chilton Trinity,Sedgemoor,South West,1884,5662,527,531,363,643,7726,1749,5980,519,582,419,619,8119
E02006072,"Westonzoyland, Ashcott & Cossington",Sedgemoor,South West,1347,5352,759,784,513,683,8091,1299,5638,781,804,572,677,8472
E02006073,Bridgwater South,Sedgemoor,South West,1667,4502,376,330,254,349,5811,1766,5285,353,358,232,350,6578
E02006074,Stockmoor & North Petherton,Sedgemoor,South West,2316,6597,584,572,394,558,8705,2430,7205,569,609,436,532,9351
E02006075,"Bruton, Brewham & Cucklington",South Somerset,South West,1165,3205,351,307,280,308,4451,1086,3630,334,327,263,322,4876
E02006076,Castle Cary & Kenton Mandeville,South Somerset,South West,1286,4716,716,716,491,773,7412,1242,5265,711,747,584,806,8113
E02006077,Somerton,South Somerset,South West,962,2904,447,462,367,497,4677,998,3371,429,514,377,582,5273
E02006078,Langport & Long Sutton,South Somerset,South West,986,3237,519,484,377,503,5120,914,3571,519,547,339,466,5442
E02006079,"Wincanton, Cheriton & Charlton Horethorne",South Somerset,South West,1486,4410,583,524,365,509,6391,1502,4922,540,543,410,546,6961
E02006080,"Ilchester, Sparkford & Mudford",South Somerset,South West,1254,4557,367,417,277,379,5997,1235,5212,370,417,313,396,6708
E02006081,Curry Rivel & Fivehead,South Somerset,South West,855,2926,454,465,311,354,4510,907,3322,466,485,360,453,5086
E02006082,"Templecombe, Hentsridge & Milborne Port",South Somerset,South West,1171,3660,543,524,376,361,5464,1183,4040,518,571,424,429,5982
E02006083,Martock,South Somerset,South West,826,3161,433,478,303,404,4779,760,3213,397,494,341,423,4868
E02006084,"South Petherton, Seavington & Kingsbury",South Somerset,South West,1195,3911,647,634,445,618,6255,1114,4136,663,648,482,655,6584
E02006085,Yeovil North East,South Somerset,South West,1452,4306,439,481,286,355,5867,1538,4698,425,478,314,362,6277
E02006086,Yeovil Lufton & Hollands,South Somerset,South West,1505,4324,353,391,292,444,5804,1497,4783,341,442,337,425,6328
E02006087,Yeovil Larkhill,South Somerset,South West,1324,3852,270,257,190,326,4895,1285,3943,256,263,220,330,5012
E02006088,Yeovil Milford Park,South Somerset,South West,1773,4801,372,368,227,393,6161,1721,5295,373,352,240,381,6641
E02006089,Yeovil Town,South Somerset,South West,1203,4741,297,271,165,350,5824,1282,5433,317,278,193,355,6576
E02006090,Yeovil Preston Plucknett,South Somerset,South West,1312,4219,360,344,286,433,5642,1412,4721,348,376,282,495,6222
E02006091,Ham Hill & Merriott,South Somerset,South West,1619,5247,810,781,593,677,8108,1547,5693,765,834,651,730,8673
E02006092,Yeovil South,South Somerset,South West,1017,3721,476,486,269,382,5334,981,3881,442,503,332,367,5525
E02006093,Ilminster & Horton,South Somerset,South West,1490,4724,601,641,550,803,7319,1449,4931,547,711,563,795,7547
E02006094,Stoford & the Cokers,South Somerset,South West,791,2909,393,453,286,452,4493,796,3039,399,469,342,447,4696
E02006095,Crewkerne,South Somerset,South West,1320,4360,602,607,485,651,6705,1289,4741,557,663,521,692,7174
E02006096,Chard North & East,South Somerset,South West,1328,4040,416,504,300,413,5673,1360,4457,428,524,350,455,6214
E02006097,Chard West,South Somerset,South West,1244,3960,379,381,346,562,5628,1278,4484,389,408,318,559,6158
E02006098,Tatworth & Combe St Nicholas,South Somerset,South West,1016,3772,730,723,442,589,6256,998,4102,666,722,528,580,6598
E02006099,Bishops Lydeard & Cotford St Luke,Somerset West and Taunton,South West,1372,4004,501,438,273,386,5602,1315,4288,449,498,349,420,6004
E02006100,Taunton Rowbarton & Kingston,Somerset West and Taunton,South West,1473,4704,445,431,345,456,6381,1605,5159,451,474,380,504,6968
E02006101,Wiveliscombe & Milverton,Somerset West and Taunton,South West,907,3182,433,427,307,456,4805,882,3358,436,408,355,443,5000
E02006102,Taunton Pyrland & Priorswood,Somerset West and Taunton,South West,1309,4082,434,347,257,443,5563,1341,4477,428,380,281,440,6006
E02006103,Ruishton & North Curry,Somerset West and Taunton,South West,1423,4134,634,639,481,566,6454,1333,4519,596,658,500,624,6897
E02006104,Taunton Halcon & Monkton Heathfield,Somerset West and Taunton,South West,2189,6182,479,490,295,361,7807,2167,6754,494,455,367,406,8476
E02006105,Taunton North Town,Somerset West and Taunton,South West,1913,7587,484,467,318,578,9434,1992,8186,548,481,354,512,10081
E02006106,Bishop's Hull & Norton Fitzwarren,Somerset West and Taunton,South West,1884,6006,520,446,328,544,7844,1968,6470,501,485,356,523,8335
E02006107,Taunton Holway & Lambrook,Somerset West and Taunton,South West,1909,5051,476,390,241,425,6583,1919,5689,473,437,279,404,7282
E02006108,Taunton Wilton,Somerset West and Taunton,South West,1266,5218,454,524,458,992,7646,1235,5679,474,542,469,1005,8169
E02006109,Taunton Galmington & Trull,Somerset West and Taunton,South West,1416,4335,504,599,462,766,6666,1405,4630,475,573,497,730,6905
E02006110,Wellington North,Somerset West and Taunton,South West,1926,5736,553,496,362,567,7714,1989,6406,556,565,378,581,8486
E02006111,"Wellington South, Rockwell Green & West Buckland",Somerset West and Taunton,South West,1627,5708,818,961,633,936,9056,1482,6070,793,947,689,933,9432
E02006112,Dowslands & Blackdown,Somerset West and Taunton,South West,1181,4384,622,608,402,674,6690,1253,4984,601,605,444,664,7298
E02006113,Minehead Town,Somerset West and Taunton,South West,1154,3824,550,601,470,876,6321,1027,4267,510,586,502,868,6733
E02006114,Minehead Outer & Porlock,Somerset West and Taunton,South West,756,3484,585,608,479,688,5844,794,3748,582,672,490,763,6255
E02006115,"Watchet, Washford & Carhampton",Somerset West and Taunton,South West,1108,3862,754,679,454,572,6321,1147,4167,717,684,546,647,6761
E02006116,"Williton, Quantock & Stogursey",Somerset West and Taunton,South West,1087,4089,767,784,518,748,6906,1004,4387,764,813,619,729,7312
E02006117,"Dunster, Dulverton & Exmoor",Somerset West and Taunton,South West,625,2880,560,583,387,543,4953,636,3106,530,555,430,538,5159
E02002905,"Wigmore, Orleton & Brimfield","Herefordshire, County of",West Midlands,959,3568,559,589,397,392,5505,824,3550,545,548,439,462,5544
E02002906,Leominster North,"Herefordshire, County of",West Midlands,1161,3363,340,383,285,573,4944,1086,3319,333,366,261,451,4730
E02002907,Leominster South,"Herefordshire, County of",West Midlands,1084,3729,436,402,293,352,5212,1081,3992,448,444,344,491,5719
E02002908,"Shobdon, Luston & Bodenham","Herefordshire, County of",West Midlands,1335,4909,749,788,520,628,7594,1267,5152,756,810,596,685,7999
E02002909,Bromyard & Bishop's Frome,"Herefordshire, County of",West Midlands,1579,6127,909,835,529,789,9189,1473,6335,925,964,629,829,9682
E02002910,"Kington, Eardisley & Staunton","Herefordshire, County of",West Midlands,1238,4528,658,677,477,649,6989,1092,4452,689,633,507,715,6996
E02002911,"Credenhill, Weobley & Wellington","Herefordshire, County of",West Midlands,1710,5371,671,684,461,713,7900,1531,6498,659,754,512,731,9154
E02002912,"Lugwardine, Withington & Moreton on Lugg","Herefordshire, County of",West Midlands,1275,4667,501,492,319,417,6396,1228,4802,495,499,348,467,6611
E02002913,"Colwall, Cradley & Wellington Heath","Herefordshire, County of",West Midlands,823,3110,500,531,395,469,5005,783,3230,525,548,420,495,5218
E02002914,Hereford North West,"Herefordshire, County of",West Midlands,1605,5763,476,510,379,561,7689,1543,5734,499,518,407,554,7712
E02002915,Hereford North East,"Herefordshire, County of",West Midlands,1281,4566,421,433,358,691,6469,1275,4759,423,428,415,688,6713
E02002916,Hereford Central,"Herefordshire, County of",West Midlands,1656,6823,441,428,271,449,8412,1629,6990,474,470,299,459,8692
E02002917,Hereford West,"Herefordshire, County of",West Midlands,1162,4667,334,340,261,410,6012,1128,4567,333,365,275,444,5984
E02002918,Hereford East,"Herefordshire, County of",West Midlands,1082,3336,391,377,294,511,4909,1001,3434,365,386,298,560,5043
E02002919,Hereford South,"Herefordshire, County of",West Midlands,2078,6100,450,418,316,417,7701,1948,5820,402,441,310,443,7416
E02002920,"Belmont, Madley & Clehonger","Herefordshire, County of",West Midlands,1132,4214,380,375,327,351,5647,1082,4119,390,365,332,349,5555
E02002921,Hereford South West,"Herefordshire, County of",West Midlands,2101,5131,340,289,163,246,6169,1963,5372,330,329,181,249,6461
E02002922,"Fownhope, Tarrington & Marcle","Herefordshire, County of",West Midlands,1056,3967,498,535,345,459,5804,1003,3979,506,541,366,500,5892
E02002923,Ledbury,"Herefordshire, County of",West Midlands,1555,5600,637,776,551,935,8499,1410,5469,567,771,628,930,8365
E02002924,Golden Valley,"Herefordshire, County of",West Midlands,1063,3368,497,502,345,471,5183,994,3386,485,530,337,494,5232
E02002925,Kingstone & Kingsthorne,"Herefordshire, County of",West Midlands,1919,6701,811,735,477,626,9350,1854,6703,771,752,548,710,9484
E02002926,Ross-on-Wye,"Herefordshire, County of",West Midlands,1800,6380,796,758,615,960,9509,1750,6508,777,802,637,997,9721
E02002927,"Penyard, Llangarron & Goodrich","Herefordshire, County of",West Midlands,1589,6904,1007,972,726,862,10471,1519,7022,1033,936,778,869,10638
E02002928,Newport North,Telford and Wrekin,West Midlands,1000,3663,381,402,245,291,4982,953,3516,378,440,311,350,4995
E02002929,Edgemond & Church Aston,Telford and Wrekin,West Midlands,881,3946,421,449,286,375,5477,955,5092,424,449,371,431,6767
E02002930,Newport South,Telford and Wrekin,West Midlands,1082,3788,355,414,297,436,5290,1202,4078,356,440,344,469,5687
E02002931,Muxton & Lilleshall,Telford and Wrekin,West Midlands,1273,4122,367,393,302,305,5489,1205,4415,367,400,329,353,5864
E02002932,Donnington,Telford and Wrekin,West Midlands,2110,5811,387,344,271,296,7109,2104,5951,379,360,258,331,7279
E02002933,Dothill & Shawbirch,Telford and Wrekin,West Midlands,1291,4842,429,444,370,494,6579,1283,5074,447,468,380,501,6870
E02002934,Apley & Leegomery,Telford and Wrekin,West Midlands,1132,3825,406,273,177,215,4896,1157,4094,435,338,210,239,5316
E02002935,Wrockwardine Wood & Trench,Telford and Wrekin,West Midlands,1187,3885,395,393,327,347,5347,1166,4082,386,417,297,393,5575
E02002936,Hadley & Horton,Telford and Wrekin,West Midlands,2585,6844,338,285,197,216,7880,2717,7725,352,321,210,258,8866
E02002937,"Ironbridge, Admaston & Higher Ercall",Telford and Wrekin,West Midlands,1632,6126,660,680,448,514,8428,1553,6542,662,683,542,629,9058
E02002938,Wellington East,Telford and Wrekin,West Midlands,1671,4510,327,275,207,247,5566,1689,5193,359,322,221,286,6381
E02002939,Wellington West,Telford and Wrekin,West Midlands,1177,4191,404,408,291,493,5787,1254,4655,393,447,342,512,6349
E02002940,St George's,Telford and Wrekin,West Midlands,966,3714,323,314,238,301,4890,992,3766,344,337,246,327,5020
E02002941,Oakengates & Ketley,Telford and Wrekin,West Midlands,2033,6492,533,532,418,476,8451,1935,6743,578,538,451,531,8841
E02002942,Priorslee,Telford and Wrekin,West Midlands,1596,4680,377,285,155,260,5757,1711,5045,415,352,206,283,6301
E02002943,Horsehay & The Rock,Telford and Wrekin,West Midlands,3765,9619,519,373,252,330,11093,4136,10791,584,458,283,350,12466
E02002944,Malinslee,Telford and Wrekin,West Midlands,1946,5092,382,331,208,255,6268,1946,5652,413,344,234,245,6888
E02002945,Hollinswood & Randlay,Telford and Wrekin,West Midlands,2120,6234,466,383,240,247,7570,2097,7170,508,428,306,253,8665
E02002946,Dawley & Aqueduct,Telford and Wrekin,West Midlands,1357,4954,434,370,251,326,6335,1335,5122,408,434,262,340,6566
E02002947,Brookside,Telford and Wrekin,West Midlands,1784,4320,337,318,208,196,5379,1803,4905,346,339,234,219,6043
E02002948,Woodside,Telford and Wrekin,West Midlands,2247,4528,251,227,159,148,5313,2229,5122,252,269,169,181,5993
E02002949,Madeley,Telford and Wrekin,West Midlands,853,3259,365,373,221,294,4512,818,3524,399,390,243,312,4868
E02002950,Sutton Hill,Telford and Wrekin,West Midlands,1371,3263,316,300,264,254,4397,1462,3885,322,322,234,289,5052
E02002951,Great Chell & Packmoor,Stoke-on-Trent,West Midlands,1381,4455,544,484,315,436,6234,1378,4903,506,553,317,453,6732
E02002952,Goldenhill & Sandyford,Stoke-on-Trent,West Midlands,1703,4610,307,295,241,339,5792,1896,5084,318,314,236,351,6303
E02002953,Bradeley & Chell Heath,Stoke-on-Trent,West Midlands,1523,4182,432,514,338,384,5850,1617,4551,452,470,380,408,6261
E02002954,Norton,Stoke-on-Trent,West Midlands,1744,4869,449,411,322,398,6449,1824,5195,462,406,332,432,6827
E02002955,Tunstall,Stoke-on-Trent,West Midlands,1980,4822,266,207,198,228,5721,2162,5690,285,230,186,228,6619
E02002956,Little Chell & Stanfield,Stoke-on-Trent,West Midlands,2088,5725,438,382,260,358,7163,2126,6314,424,418,293,379,7828
E02002957,Baddley & Milton,Stoke-on-Trent,West Midlands,1703,5564,550,603,490,656,7863,1614,5931,526,634,503,720,8314
E02002958,Smallthorne & Sneyd Green,Stoke-on-Trent,West Midlands,1727,5062,393,389,293,376,6513,1800,5410,392,370,291,445,6908
E02002959,Longport & Burslem Park,Stoke-on-Trent,West Midlands,2160,6045,347,334,210,337,7273,2203,6442,347,306,236,337,7668
E02002960,Birches Head,Stoke-on-Trent,West Midlands,1023,3621,368,303,213,238,4743,999,3824,388,329,242,287,5070
E02002961,Cobridge & Central Forest,Stoke-on-Trent,West Midlands,1591,4562,236,241,185,201,5425,1931,5872,301,209,183,254,6819
E02002962,Abbey Hulton,Stoke-on-Trent,West Midlands,1639,4321,347,360,254,352,5634,1937,5072,374,331,269,363,6409
E02002963,Northwood,Stoke-on-Trent,West Midlands,1377,4897,292,237,198,246,5870,1490,5505,322,265,194,245,6531
E02002964,Townsend & Eaton Park,Stoke-on-Trent,West Midlands,1540,4812,552,626,410,554,6954,1552,5256,534,611,438,573,7412
E02002965,Hanley & Etruria,Stoke-on-Trent,West Midlands,1868,5957,226,140,126,152,6601,2127,6889,248,188,130,169,7624
E02002966,Shelton & Joiner's Square,Stoke-on-Trent,West Midlands,1573,7601,291,265,166,224,8547,1884,8805,310,279,173,236,9803
E02002967,Bentilee & Ubberley,Stoke-on-Trent,West Midlands,2733,6331,360,334,194,387,7606,2880,7022,401,327,199,369,8318
E02002968,Basford & Hartshill,Stoke-on-Trent,West Midlands,1596,6223,395,379,254,397,7648,1598,6550,441,403,247,418,8059
E02002969,Boothen & Penkhull,Stoke-on-Trent,West Midlands,1626,6595,352,360,225,298,7830,1733,7087,376,338,242,329,8372
E02002970,Fenton,Stoke-on-Trent,West Midlands,1644,5298,346,367,251,237,6499,1618,5577,379,356,279,282,6873
E02002971,Fen Park,Stoke-on-Trent,West Midlands,906,3092,340,274,125,117,3948,907,3384,310,320,182,154,4350
E02002972,Longton West & Sandford Hill,Stoke-on-Trent,West Midlands,1291,3884,323,341,225,228,5001,1298,4084,321,354,239,245,5243
E02002973,Oakhill & Trent Vale,Stoke-on-Trent,West Midlands,1786,5430,357,303,219,295,6604,1645,5587,353,336,230,300,6806
E02002974,Weston Coyney,Stoke-on-Trent,West Midlands,1128,3259,391,438,305,457,4850,1128,3594,388,416,298,474,5170
E02002975,Longton East,Stoke-on-Trent,West Midlands,1185,4486,423,421,305,252,5887,1130,4637,476,410,297,304,6124
E02002976,Hollybush & Blurton North,Stoke-on-Trent,West Midlands,1253,3632,301,355,204,271,4763,1276,3914,306,336,240,287,5083
E02002977,Dresden,Stoke-on-Trent,West Midlands,849,3163,399,467,361,463,4853,938,3407,384,388,375,486,5040
E02002978,Meir North,Stoke-on-Trent,West Midlands,1712,4045,293,279,176,268,5061,1681,4291,323,281,204,285,5384
E02002979,Florence,Stoke-on-Trent,West Midlands,1587,3611,236,203,161,219,4430,1825,4309,262,206,165,203,5145
E02002980,Hanford & Trentham West,Stoke-on-Trent,West Midlands,1047,3196,392,471,357,530,4946,969,3481,404,447,384,579,5295
E02002981,Meir South & Lightwood,Stoke-on-Trent,West Midlands,2033,5270,344,306,239,237,6396,2105,5698,353,336,213,311,6911
E02002982,Newstead & Blurton South,Stoke-on-Trent,West Midlands,1892,5038,354,286,146,259,6083,2027,5461,410,313,194,247,6625
E02002983,Meir Park,Stoke-on-Trent,West Midlands,832,3014,342,381,276,238,4251,866,3303,375,369,286,275,4608
E02002984,Trentham East,Stoke-on-Trent,West Midlands,834,3093,438,402,277,323,4533,863,3338,440,438,304,373,4893
E02006008,Shifnal,Shropshire,West Midlands,1662,5701,527,575,401,529,7733,1812,6129,537,547,439,560,8212
E02006009,Cosford & Albrighton,Shropshire,West Midlands,1070,4204,373,388,344,591,5900,985,5012,321,416,364,616,6729
E02006010,Much Wenlock & Broseley,Shropshire,West Midlands,1970,6764,889,883,573,717,9826,1831,6693,875,959,643,774,9944
E02006011,Bridgnorth West,Shropshire,West Midlands,935,3233,404,483,351,557,5028,825,3239,374,453,384,575,5025
E02006012,Bridgnorth East,Shropshire,West Midlands,782,3642,525,516,404,489,5576,823,3643,475,533,406,554,5611
E02006013,"Alveley, Claverley & Worfield",Shropshire,West Midlands,1113,4261,601,681,506,590,6639,1067,4448,559,649,543,647,6846
E02006014,Highley & Ditton Priors,Shropshire,West Midlands,1478,5410,775,822,582,617,8206,1334,5377,755,823,651,678,8284
E02006015,Whitchurch,Shropshire,West Midlands,1833,6259,609,659,450,689,8666,1727,6296,614,663,517,749,8839
E02006016,"Woore, Prees & Tilstock",Shropshire,West Midlands,1235,4718,653,690,465,475,7001,1194,4963,601,641,489,492,7186
E02006017,Ellesmere,Shropshire,West Midlands,1331,4789,545,545,395,542,6816,1251,4808,590,569,399,582,6948
E02006018,Market Drayton,Shropshire,West Midlands,2248,7271,693,763,584,768,10079,2167,7249,707,781,667,808,10212
E02006019,Wem,Shropshire,West Midlands,1054,3647,394,425,291,532,5289,981,3690,379,420,344,536,5369
E02006020,Hinstock & Hodnet,Shropshire,West Midlands,1261,5167,416,367,230,328,6508,1148,5142,451,392,274,347,6606
E02006021,"Baschurch, Cockshutt & Harmer Hill",Shropshire,West Midlands,1367,5283,587,530,372,439,7211,1459,5568,621,592,428,487,7696
E02006022,Shawbury & Weston,Shropshire,West Midlands,1085,3911,385,360,245,352,5253,1041,4050,406,368,285,353,5462
E02006023,"Gobowen, St Martin's & Weston Rhyn",Shropshire,West Midlands,1794,5841,703,627,456,612,8239,1682,5971,675,668,460,629,8403
E02006024,Oswestry East,Shropshire,West Midlands,1902,6260,562,512,349,579,8262,1790,6247,589,547,409,560,8352
E02006025,Oswestry West,Shropshire,West Midlands,1600,5987,515,629,474,750,8355,1432,6182,522,580,516,736,8536
E02006026,"Ruyton-XI-Towns, West Felton & Whittington",Shropshire,West Midlands,1261,4170,533,476,345,364,5888,1250,4490,530,566,404,418,6408
E02006027,Trefonen & Pant,Shropshire,West Midlands,809,3074,436,436,308,428,4682,794,3197,422,413,312,447,4791
E02006028,Bomere Heath & Montford Bridge,Shropshire,West Midlands,1498,5567,580,640,499,648,7934,1439,5679,637,652,526,727,8221
E02006029,Shrewsbury Harlescott Grange,Shropshire,West Midlands,1724,4928,388,371,300,410,6397,1657,5238,398,362,272,396,6666
E02006030,Shrewsbury Harlescott & Sundorne,Shropshire,West Midlands,1761,5200,381,328,248,331,6488,1727,5415,382,355,259,356,6767
E02006031,Shrewsbury Greenfields,Shropshire,West Midlands,1350,5525,399,390,260,437,7011,1208,5330,424,354,300,423,6831
E02006032,Shrewsbury Monkmoor,Shropshire,West Midlands,1846,5506,467,484,345,362,7164,1726,5744,475,463,393,405,7480
E02006033,Shrewsbury Town,Shropshire,West Midlands,1054,5603,486,557,417,665,7728,1026,5529,512,530,433,708,7712
E02006034,Shrewsbury Copthorne & Bowbrook,Shropshire,West Midlands,1905,6327,586,540,392,552,8397,2013,6632,586,634,433,578,8863
E02006035,Shrewsbury London Road,Shropshire,West Midlands,752,2972,423,544,369,542,4850,804,3154,396,537,400,578,5065
E02006036,Shrewsbury Sutton & Coleham,Shropshire,West Midlands,964,3956,437,380,252,438,5463,909,4120,404,423,322,451,5720
E02006037,Shrewsbury Meole & Kingsland,Shropshire,West Midlands,1961,6133,591,556,436,657,8373,1891,6586,637,587,435,674,8919
E02006038,Bayston Hill & Atcham,Shropshire,West Midlands,1394,4663,615,586,429,526,6819,1453,4914,569,573,468,556,7080
E02006039,"Hanwood, Pontesbury & Minsterley",Shropshire,West Midlands,1388,4654,575,591,420,561,6801,1359,4842,581,633,508,624,7188
E02006040,"Cressage, Dorrington & Pulverbatch",Shropshire,West Midlands,1258,4784,486,581,412,435,6698,1155,4984,490,562,460,471,6967
E02006041,"Bishop's Castle, Brockton & Chirbury",Shropshire,West Midlands,851,3414,494,473,307,406,5094,772,3357,481,502,331,400,5071
E02006042,Church Stretton,Shropshire,West Midlands,703,3000,533,585,442,726,5286,617,3032,495,608,471,789,5395
E02006043,Craven Arms & Broadstone,Shropshire,West Midlands,1048,3888,545,501,402,446,5782,1038,3955,530,508,433,465,5891
E02006044,Clun & Bucknell,Shropshire,West Midlands,882,3417,583,599,377,480,5456,785,3414,578,631,442,489,5554
E02006045,Ludlow Town,Shropshire,West Midlands,1527,6045,766,852,646,1152,9461,1479,5955,778,865,698,1180,9476
E02006046,"Cleobury Mortimer, Burford & Ashford Carbonell",Shropshire,West Midlands,1382,5162,684,737,553,603,7739,1341,5150,727,690,633,675,7875
E02006118,Rugeley North & Etchinghill,Cannock Chase,West Midlands,1118,4353,537,569,441,463,6363,1105,4489,503,574,472,483,6521
E02006119,Rugeley Town,Cannock Chase,West Midlands,1533,5221,421,381,280,471,6774,1494,5432,391,439,294,470,7026
E02006120,Rugeley South & Brereton,Cannock Chase,West Midlands,1837,5786,497,468,361,498,7610,1827,5963,482,489,379,487,7800
E02006121,Hednesford Pye Green,Cannock Chase,West Midlands,1066,3779,319,312,194,197,4801,996,3740,351,317,214,221,4843
E02006122,Hednesford Central,Cannock Chase,West Midlands,1352,5174,377,367,250,289,6457,1453,5065,382,342,272,301,6362
E02006123,Wimblebury & Cannock Wood,Cannock Chase,West Midlands,1126,4289,352,272,181,253,5347,1190,4372,374,329,231,290,5596
E02006124,Cannock North,Cannock Chase,West Midlands,1583,4707,373,361,215,340,5996,1530,4783,376,356,255,328,6098
E02006125,Cannock North East,Cannock Chase,West Midlands,1367,4620,402,427,323,300,6072,1308,4752,398,433,361,343,6287
E02006126,Hednesford South & Heath Hayes,Cannock Chase,West Midlands,1429,5237,412,490,272,404,6815,1404,5112,484,464,328,402,6790
E02006127,Hawks Green,Cannock Chase,West Midlands,1507,5191,338,202,124,197,6052,1429,5031,353,243,130,175,5932
E02006128,Cannock West & Mill Green,Cannock Chase,West Midlands,1173,5040,572,657,467,669,7405,1233,4988,536,693,492,736,7445
E02006129,Cannock South,Cannock Chase,West Midlands,1667,5376,364,363,287,440,6830,1594,5434,385,351,312,393,6875
E02006130,Norton Canes,Cannock Chase,West Midlands,1305,4587,422,457,335,376,6177,1456,5066,435,437,351,391,6680
E02006131,"Mayfield, Rocester & Bramshall",East Staffordshire,West Midlands,1182,4603,523,525,395,460,6506,1231,4834,506,564,393,530,6827
E02006132,Uttoxeter Heath,East Staffordshire,West Midlands,1322,3954,362,339,249,326,5230,1399,4521,323,349,282,336,5811
E02006133,Uttoxeter Town,East Staffordshire,West Midlands,1157,4379,342,348,280,409,5758,1145,4857,384,357,277,399,6274
E02006134,Rolleston-on-Dove & Tutbury,East Staffordshire,West Midlands,1648,5499,605,640,564,650,7958,1781,6393,632,664,539,714,8942
E02006135,Burton Stretton,East Staffordshire,West Midlands,1246,4450,474,510,361,504,6299,1211,4731,513,516,387,517,6664
E02006136,"Abbots Bromley, Yoxall & Marchington",East Staffordshire,West Midlands,1194,5231,563,656,498,581,7529,1166,5917,575,620,560,590,8262
E02006137,Burton Horninglow,East Staffordshire,West Midlands,1991,5539,395,413,292,522,7161,2007,5963,411,391,320,460,7545
E02006138,Burton Eton Park,East Staffordshire,West Midlands,2002,4807,232,198,126,175,5538,2134,5733,240,218,130,179,6500
E02006139,Burton Shobnall,East Staffordshire,West Midlands,1998,5356,347,235,178,244,6360,2150,6012,343,287,160,268,7070
E02006140,Burton Winshill,East Staffordshire,West Midlands,1798,5094,457,428,368,446,6793,1705,5412,449,453,378,469,7161
E02006141,Burton Central,East Staffordshire,West Midlands,2743,8296,348,260,218,319,9441,2986,9724,378,307,237,364,11010
E02006142,Burton Brizlincote,East Staffordshire,West Midlands,795,3100,318,355,236,289,4298,816,3285,355,372,242,301,4555
E02006143,Branston,East Staffordshire,West Midlands,1555,4901,384,366,302,330,6283,1693,5552,409,395,282,349,6987
E02006144,Burton Stapenhill,East Staffordshire,West Midlands,1616,4794,448,403,265,446,6356,1598,5545,428,416,287,419,7095
E02006145,Barton-under-Needwood,East Staffordshire,West Midlands,1103,3320,428,468,269,409,4894,1044,3538,403,445,337,397,5120
E02006146,Armitage & Colton,Lichfield,West Midlands,1537,5170,543,549,388,432,7082,1517,5218,516,544,436,439,7153
E02006147,"Alrewas, Fradley & King's Bromley",Lichfield,West Midlands,1510,4841,504,527,372,436,6680,1455,5101,484,532,410,482,7009
E02006148,Burntwood North East & Longdon,Lichfield,West Midlands,1070,3945,527,604,435,379,5890,1055,4349,495,592,513,435,6384
E02006149,Lichfield Central,Lichfield,West Midlands,2217,6715,544,528,475,819,9081,1992,6812,529,522,486,809,9158
E02006150,Lichfield East,Lichfield,West Midlands,1669,6508,841,934,632,838,9753,1721,7002,842,946,688,873,10351
E02006151,Burntwood West,Lichfield,West Midlands,1632,5690,526,550,474,433,7673,1637,5883,531,559,510,476,7959
E02006152,Lichfield West & South,Lichfield,West Midlands,1870,6185,485,702,444,612,8428,1898,6401,511,684,500,618,8714
E02006153,"Whittington, Hopwas & Clifton Campville",Lichfield,West Midlands,1375,4665,468,494,365,421,6413,1551,5778,494,487,418,465,7642
E02006154,Burntwood Chase Terrace & Hammerwich,Lichfield,West Midlands,1383,5324,666,942,769,685,8386,1307,5387,634,858,798,764,8441
E02006155,Burntwood Chasetown,Lichfield,West Midlands,1269,3569,261,274,231,220,4555,1226,3670,253,271,232,238,4664
E02006156,"Shenstone, Stonnall & Little Aston",Lichfield,West Midlands,1165,4329,511,634,514,721,6709,1157,4649,527,600,529,736,7041
E02006157,"Fazeley, Mile Oak & Drayton Basset",Lichfield,West Midlands,1222,4704,400,412,293,378,6187,1142,4433,416,409,317,388,5963
E02006158,Kidsgrove East,Newcastle-under-Lyme,West Midlands,1143,5057,529,567,415,337,6905,1151,5197,532,590,471,433,7223
E02006159,Kidsgrove Central,Newcastle-under-Lyme,West Midlands,1052,3448,357,356,220,334,4715,1081,3578,340,352,272,344,4886
E02006160,Kidsgrove West,Newcastle-under-Lyme,West Midlands,1497,5280,535,566,384,451,7216,1564,5372,548,576,394,456,7346
E02006161,Talke & Crackley,Newcastle-under-Lyme,West Midlands,1080,4369,374,427,325,354,5849,1058,4320,380,411,325,394,5830
E02006162,Audley & Bignall End,Newcastle-under-Lyme,West Midlands,1357,5235,581,550,369,457,7192,1313,5332,531,615,395,521,7394
E02006163,Bradwell,Newcastle-under-Lyme,West Midlands,1652,5076,423,373,309,467,6648,1611,5243,388,374,299,411,6715
E02006164,Chesterton & Knutton,Newcastle-under-Lyme,West Midlands,1669,4991,389,297,195,429,6301,1602,4896,389,324,219,356,6184
E02006165,Porthill,Newcastle-under-Lyme,West Midlands,1340,5179,368,432,247,417,6643,1222,4956,360,438,275,446,6475
E02006166,May Bank,Newcastle-under-Lyme,West Midlands,1120,4470,397,433,297,421,6018,1124,4583,444,449,319,451,6246
E02006167,Newcastle West & Cross Heath,Newcastle-under-Lyme,West Midlands,2015,6671,416,385,307,455,8234,1997,6582,445,400,303,407,8137
E02006168,Newcastle Town,Newcastle-under-Lyme,West Midlands,1087,6583,372,357,288,609,8209,1006,5868,381,363,272,603,7487
E02006169,Silverdale & Keele,Newcastle-under-Lyme,West Midlands,1111,7426,301,287,205,265,8484,1125,7225,300,307,232,263,8327
E02006170,Madeley & Betley,Newcastle-under-Lyme,West Midlands,836,3114,357,407,248,380,4506,784,3152,337,418,285,426,4618
E02006171,Clayton & Langdale,Newcastle-under-Lyme,West Midlands,1642,5405,521,514,421,661,7522,1643,5649,502,534,405,657,7747
E02006172,Westlands & Seabridge,Newcastle-under-Lyme,West Midlands,1432,5422,635,660,497,768,7982,1469,5757,655,688,561,845,8506
E02006173,Loggerheads & Baldwins Gate,Newcastle-under-Lyme,West Midlands,931,3989,584,601,374,505,6053,907,4284,551,616,421,486,6358
E02006174,Penkridge & Acton Trussell,South Staffordshire,West Midlands,1614,6032,761,798,614,648,8853,1616,6278,738,817,648,709,9190
E02006175,Huntington,South Staffordshire,West Midlands,1380,4718,318,328,275,265,5904,1351,4502,300,317,274,263,5656
E02006176,Brewood & Wheaton Aston,South Staffordshire,West Midlands,1132,4453,502,593,438,557,6543,1118,4475,523,589,479,566,6632
E02006177,Cheslyn Hay,South Staffordshire,West Midlands,1659,5769,670,676,541,571,8227,1564,5949,654,678,592,606,8479
E02006178,Great Wyrley,South Staffordshire,West Midlands,1174,4804,476,573,405,395,6653,1200,4803,437,547,433,436,6656
E02006179,"Featherstone West, Coven & Shareshill",South Staffordshire,West Midlands,962,6622,469,486,420,399,8396,970,7384,440,471,422,452,9169
E02006180,Featherstone East & Essington,South Staffordshire,West Midlands,1243,4093,402,371,297,546,5709,1302,4337,385,366,320,548,5956
E02006181,Bilbrook,South Staffordshire,West Midlands,989,3293,343,345,289,463,4733,950,3334,328,368,281,457,4768
E02006182,Codsall,South Staffordshire,West Midlands,1175,3917,422,516,429,594,5878,1206,4129,397,481,471,620,6098
E02006183,Perton West & Pattingham,South Staffordshire,West Midlands,1166,4567,566,460,331,435,6359,1122,4534,587,499,342,467,6429
E02006184,Perton East,South Staffordshire,West Midlands,981,3256,387,290,173,194,4300,873,3265,395,331,194,227,4412
E02006185,Wombourne Inner,South Staffordshire,West Midlands,1241,4219,451,456,383,591,6100,1197,4366,422,444,396,611,6239
E02006186,"Wombourne Outer, Swindon & Seisdon",South Staffordshire,West Midlands,1851,7488,833,879,667,1123,10990,1764,7378,855,865,658,1092,10848
E02006187,Kinver,South Staffordshire,West Midlands,969,3948,566,614,525,602,6255,963,4098,518,622,547,652,6437
E02006188,Fulford & Meir Heath,Stafford,West Midlands,989,3299,433,452,357,523,5064,923,3445,398,429,400,511,5183
E02006189,"Barlaston, Tittensor & Swynnerton",Stafford,West Midlands,1106,4172,563,581,378,618,6312,1016,4000,530,571,435,621,6157
E02006190,Stone Town,Stafford,West Midlands,1991,6470,590,570,432,783,8845,1923,6710,549,624,492,776,9151
E02006191,Little Stoke & Milwich,Stafford,West Midlands,1303,4734,589,605,419,430,6777,1246,4767,606,606,460,455,6894
E02006192,Eccleshall & Yarnfield,Stafford,West Midlands,1425,5368,584,626,426,505,7509,1416,5530,629,598,492,555,7804
E02006193,Stafford Common & Great Bridgeford,Stafford,West Midlands,1125,4123,405,433,416,438,5815,1322,4600,424,425,412,488,6349
E02006194,Doxey & Holmcroft,Stafford,West Midlands,1723,5112,373,356,325,550,6716,1726,5426,347,403,318,510,7004
E02006195,Weston & Haywood,Stafford,West Midlands,1343,4938,679,763,477,542,7399,1292,5074,672,753,568,601,7668
E02006196,Stafford North East,Stafford,West Midlands,1341,5347,313,248,196,229,6333,1354,5324,302,256,209,223,6314
E02006197,Central Stafford,Stafford,West Midlands,1743,6639,298,314,238,392,7881,1709,6913,342,310,274,426,8265
E02006198,Littleworth & Hopton,Stafford,West Midlands,1505,6044,470,461,349,465,7789,1604,6904,475,503,366,502,8750
E02006199,Rowley & Derrington,Stafford,West Midlands,1135,4869,502,563,420,602,6956,1204,5279,557,555,456,627,7474
E02006200,Highfields & Burton Manor,Stafford,West Midlands,1657,4924,380,333,286,351,6274,1684,5160,384,363,288,361,6556
E02006201,Weeping Cross & Brocton,Stafford,West Midlands,2256,6577,769,898,721,900,9865,2159,6961,748,921,764,975,10369
E02006202,Gnosall & Haughton,Stafford,West Midlands,1332,5356,693,729,513,547,7838,1285,6095,682,746,552,620,8695
E02006203,Mosspit & Silkmore Lane,Stafford,West Midlands,1552,4944,409,422,284,322,6381,1533,5025,404,431,312,345,6517
E02006204,Leek East & Upper Hulme,Staffordshire Moorlands,West Midlands,1384,4517,503,478,310,429,6237,1455,4640,447,527,344,470,6428
E02006205,Biddulph Moor & Rudyard,Staffordshire Moorlands,West Midlands,1010,4224,661,658,470,473,6486,951,4147,588,704,479,540,6458
E02006206,Biddulph Central,Staffordshire Moorlands,West Midlands,1794,5390,370,301,200,418,6679,1665,5326,381,331,210,339,6587
E02006207,Biddulph North & Brownlees,Staffordshire Moorlands,West Midlands,865,3347,515,612,418,479,5371,826,3475,475,626,498,540,5614
E02006208,Leek Town,Staffordshire Moorlands,West Midlands,1425,5265,451,440,270,419,6845,1373,5257,467,453,298,457,6932
E02006209,Leek South & Cheddleton,Staffordshire Moorlands,West Midlands,1777,6383,706,819,544,766,9218,1641,6380,721,799,607,800,9307
E02006210,"Ipstones, Warslow & Hamps Valley",Staffordshire Moorlands,West Midlands,769,3246,425,415,304,337,4727,756,3186,455,406,322,334,4703
E02006211,Endon & Brown Edge,Staffordshire Moorlands,West Midlands,950,3606,452,466,440,574,5538,922,3730,407,478,415,633,5663
E02006212,Werrington & Wetley Rocks,Staffordshire Moorlands,West Midlands,1178,4432,552,627,430,634,6675,1146,4647,549,604,468,656,6924
E02006213,"Cheadle North, Alton & Kingsley",Staffordshire Moorlands,West Midlands,1034,3982,414,452,321,361,5530,1014,4132,417,462,369,386,5766
E02006214,Cheadle Town,Staffordshire Moorlands,West Midlands,996,3727,400,453,347,364,5291,966,3729,383,418,360,387,5277
E02006215,"Blythe Bridge, Forsbrook & Caverswall",Staffordshire Moorlands,West Midlands,1159,4658,555,622,441,512,6788,1127,4614,538,594,469,569,6784
E02006216,Cheadle South & Upper Tean,Staffordshire Moorlands,West Midlands,1413,5089,611,685,445,466,7296,1341,4922,572,689,478,520,7181
E02006217,Coton Farm & Perry Crofts,Tamworth,West Midlands,1609,5122,562,670,540,683,7577,1747,6109,614,643,521,707,8594
E02006218,Central Tamworth,Tamworth,West Midlands,1378,5070,393,459,361,625,6908,1436,5678,433,468,396,523,7498
E02006219,Amington,Tamworth,West Midlands,1436,4804,482,422,255,230,6193,1498,5351,491,469,305,251,6867
E02006220,Bolehall,Tamworth,West Midlands,1338,4342,440,462,428,410,6082,1289,4622,429,436,405,472,6364
E02006221,Kettlebrook,Tamworth,West Midlands,1062,4050,306,291,172,153,4972,960,4151,318,297,174,168,5108
E02006222,Belgrave,Tamworth,West Midlands,1446,4205,393,376,245,253,5472,1376,4517,386,412,268,288,5871
E02006223,Glascote Heath,Tamworth,West Midlands,1876,4206,304,291,160,162,5123,1808,4694,311,329,182,156,5672
E02006224,Wilnecote East,Tamworth,West Midlands,1439,4953,415,314,165,188,6035,1395,5065,493,356,205,179,6298
E02006225,Dosthill & Two Gates,Tamworth,West Midlands,1280,4277,500,471,282,362,5892,1303,4702,501,484,329,385,6401
E02006226,Wilnecote West & Hockley,Tamworth,West Midlands,2016,6156,488,386,231,301,7562,2079,6488,465,447,274,317,7991
E02006468,"Polesworth, Warton & Austrey",North Warwickshire,West Midlands,1942,6586,627,747,501,608,9069,1836,6782,668,694,522,609,9275
E02006469,"Dordon, Hurley & Wood End",North Warwickshire,West Midlands,1841,5685,486,466,297,425,7359,1707,5706,473,455,349,406,7389
E02006470,Atherstone,North Warwickshire,West Midlands,2221,7219,710,692,477,702,9800,2125,7681,664,709,541,677,10272
E02006471,Kingsbury & Curdworth,North Warwickshire,West Midlands,993,4216,490,512,388,348,5954,1025,4413,517,540,393,377,6240
E02006472,Hartshill & Ansley,North Warwickshire,West Midlands,1686,5872,580,546,409,456,7863,1784,6187,533,577,437,520,8254
E02006473,Coleshill & Water Orton,North Warwickshire,West Midlands,1634,6212,564,611,438,701,8526,1682,6683,590,677,479,730,9159
E02006474,New Arley & Fillongley,North Warwickshire,West Midlands,1070,3814,401,416,285,390,5306,1060,4019,423,406,293,394,5535
E02006475,Weddington & St Nicholas Park,Nuneaton and Bedworth,West Midlands,1741,4806,527,483,390,536,6742,1828,5647,502,530,377,562,7618
E02006476,Camp Hill,Nuneaton and Bedworth,West Midlands,2221,5409,352,326,218,283,6588,2263,6234,381,339,244,292,7490
E02006477,Horeston Grange,Nuneaton and Bedworth,West Midlands,1333,4525,469,466,328,426,6214,1577,5364,453,500,356,461,7134
E02006478,Galley Common & Whittleford,Nuneaton and Bedworth,West Midlands,1592,5113,390,336,211,160,6210,1615,5700,470,365,240,197,6972
E02006479,Nuneaton Town Centre,Nuneaton and Bedworth,West Midlands,1668,6254,411,353,257,301,7576,1761,6945,428,353,305,339,8370
E02006480,Tomkinson Road,Nuneaton and Bedworth,West Midlands,1549,4599,430,354,280,254,5917,1498,4983,379,373,249,259,6243
E02006481,Stockingford,Nuneaton and Bedworth,West Midlands,1536,4258,326,357,273,256,5470,1667,4686,341,389,326,285,6027
E02006482,Bermuda & Heath End,Nuneaton and Bedworth,West Midlands,1367,4514,381,413,196,251,5755,1427,4724,368,410,258,277,6037
E02006483,Caldwell & Chilvers Coton,Nuneaton and Bedworth,West Midlands,1770,5009,382,377,227,407,6402,1678,5246,375,389,259,428,6697
E02006484,Attleborough,Nuneaton and Bedworth,West Midlands,1462,4718,355,374,265,413,6125,1420,5139,376,325,279,403,6522
E02006485,Whitestone,Nuneaton and Bedworth,West Midlands,851,3718,532,497,355,414,5516,866,4102,512,557,398,474,6043
E02006486,Bedworth Woodlands,Nuneaton and Bedworth,West Midlands,1223,4269,399,408,290,369,5735,1190,4648,426,417,330,415,6236
E02006487,Bedworth Town,Nuneaton and Bedworth,West Midlands,1244,3986,428,442,355,421,5632,1265,4403,393,437,372,414,6019
E02006488,Bulkington,Nuneaton and Bedworth,West Midlands,875,3115,457,555,480,614,5221,871,3480,440,518,488,650,5576
E02006489,Bedworth Coalpit Field & Exhall,Nuneaton and Bedworth,West Midlands,1762,5092,371,409,204,225,6301,1772,5553,396,392,296,265,6902
E02006490,Bedworth Heath,Nuneaton and Bedworth,West Midlands,1597,4660,413,350,261,439,6123,1563,4979,395,439,286,429,6528
E02006806,Ash Green & Keresley End,Nuneaton and Bedworth,West Midlands,1788,5202,437,395,293,450,6777,1757,5804,448,396,347,474,7469
E02006492,"Brinklow, Wolvey & Clifton",Rugby,West Midlands,2652,8308,674,621,466,647,10716,3013,10060,685,668,521,664,12598
E02006493,Brownsover,Rugby,West Midlands,2334,6834,479,356,204,221,8094,2206,7764,475,409,249,231,9128
E02006494,Town North & Newbold on Avon,Rugby,West Midlands,1517,4852,324,287,232,366,6061,1331,5510,348,288,234,383,6763
E02006495,"Wolston, Binley Woods & Ryton",Rugby,West Midlands,1320,4304,477,559,443,484,6267,1280,4891,462,528,463,515,6859
E02006496,Town East,Rugby,West Midlands,1390,4987,198,209,151,145,5690,1323,5897,230,220,132,183,6662
E02006497,New Bilton,Rugby,West Midlands,1729,5692,282,237,190,249,6650,1654,6282,299,257,201,275,7314
E02006498,Cawston & Long Lawford,Rugby,West Midlands,3368,8141,552,601,316,395,10005,3275,9130,539,632,418,444,11163
E02006499,Eastlands,Rugby,West Midlands,1171,3533,260,327,239,352,4711,1330,4279,291,315,272,384,5541
E02006500,Town South & School,Rugby,West Midlands,1136,3446,310,340,285,453,4834,1197,3998,310,318,314,398,5338
E02006501,Hillmorton,Rugby,West Midlands,2081,5720,487,531,550,667,7955,2010,6112,518,499,506,636,8271
E02006502,Overslade & Bilton,Rugby,West Midlands,1811,5725,629,809,648,1108,8919,1859,6575,598,791,692,1065,9721
E02006503,"Dunchurch, Stretton-on-Dunsmore & Marton",Rugby,West Midlands,1526,4623,519,661,474,721,6998,1871,5781,547,627,555,710,8220
E02006504,"Earlswood, Tanworth-in-Arden & Sambourne",Stratford-on-Avon,West Midlands,897,3274,433,444,366,411,4928,901,3643,455,423,381,450,5352
E02006505,Henley-in-Arden & Claverdon,Stratford-on-Avon,West Midlands,987,3525,476,648,466,678,5793,1038,4103,473,586,512,681,6355
E02006506,Studley,Stratford-on-Avon,West Midlands,1123,3350,351,369,299,450,4819,1046,3561,339,408,333,459,5100
E02006507,"Southam, Stockton & Napton",Stratford-on-Avon,West Midlands,1785,5917,520,566,424,589,8016,1833,7117,557,628,502,648,9452
E02006508,"Harbury, Long Itchington & Fenny Compton",Stratford-on-Avon,West Midlands,1817,6097,621,719,522,589,8548,1937,6861,667,656,589,606,9379
E02006509,Alcester,Stratford-on-Avon,West Midlands,929,3415,382,462,324,589,5172,902,3567,415,442,379,518,5321
E02006510,Wilmcote & Great Alne,Stratford-on-Avon,West Midlands,1091,3811,506,552,443,530,5842,1044,4315,497,566,485,606,6469
E02006511,Wellesbourne & Snitterfield,Stratford-on-Avon,West Midlands,1780,5722,623,731,431,705,8212,1926,6719,677,698,535,721,9350
E02006512,Stratford North,Stratford-on-Avon,West Midlands,1973,7854,611,661,458,760,10344,2022,9252,691,715,544,743,11945
E02006513,Stratford South East & Tiddington,Stratford-on-Avon,West Midlands,1511,4732,463,531,409,655,6790,1461,5299,474,532,426,720,7451
E02006514,Stratford South West,Stratford-on-Avon,West Midlands,1274,5358,633,675,503,923,8092,1265,6163,624,695,536,884,8902
E02006515,Bidford & Welford,Stratford-on-Avon,West Midlands,1868,6100,685,733,501,668,8687,1946,6958,724,773,557,685,9697
E02006516,"Kineton, Tysoe & Warmington",Stratford-on-Avon,West Midlands,1553,5597,589,678,369,532,7765,1530,6308,640,647,494,574,8663
E02006517,Lower Quinton & Ettington,Stratford-on-Avon,West Midlands,1774,5167,524,602,360,511,7164,1895,6081,569,601,473,498,8222
E02006518,Shipston-on-Stour & Brailes,Stratford-on-Avon,West Midlands,1429,5247,724,715,594,855,8135,1439,5920,726,799,624,840,8909
E02006519,Kenilworth West,Warwick,West Midlands,1166,4154,481,546,427,675,6283,1303,5109,517,530,455,670,7281
E02006520,Kenilworth East,Warwick,West Midlands,1333,4770,473,524,369,557,6693,1430,5439,490,536,438,621,7524
E02006521,Kenilworth South,Warwick,West Midlands,1219,3900,419,535,403,664,5921,1218,4471,446,526,429,721,6593
E02006522,Kingswood & Leek Wootton,Warwick,West Midlands,800,3106,362,418,270,284,4440,884,3736,429,423,319,348,5255
E02006523,"Cubbington, Stoneleigh & Radford Semele",Warwick,West Midlands,1857,8601,595,622,475,777,11070,1737,6188,612,660,516,792,8768
E02006524,Lillington,Warwick,West Midlands,1117,3332,262,263,186,319,4362,1086,3795,282,268,196,295,4836
E02006525,Leamington Central & North,Warwick,West Midlands,2024,9080,539,662,488,885,11654,2043,10004,599,685,550,906,12744
E02006526,Warwick North,Warwick,West Midlands,1438,5169,521,495,327,458,6970,1507,5787,595,514,402,458,7756
E02006527,Leamington West & Milverton,Warwick,West Midlands,1439,6460,455,452,316,529,8212,1494,7141,443,503,374,491,8952
E02006528,Leamington East & Sydenham,Warwick,West Midlands,1675,7969,430,358,270,377,9404,1795,8744,478,430,301,394,10347
E02006529,Warwick South West & Aylesford,Warwick,West Midlands,2627,7997,527,520,329,585,9958,2640,8744,535,558,388,555,10780
E02006530,"Warwick South East, Myton & Heathcote",Warwick,West Midlands,2343,7187,538,564,430,568,9287,2509,8661,562,585,483,662,10953
E02006531,Leamington Brunswick,Warwick,West Midlands,1697,8186,354,250,159,291,9240,1661,8443,395,273,197,278,9586
E02006532,"Bishops Tachbrook, Barford & Hatton Park",Warwick,West Midlands,2050,5829,510,542,340,439,7660,2441,7203,523,528,422,446,9122
E02006533,Whitnash,Warwick,West Midlands,1960,6201,407,366,391,489,7854,2008,7169,468,407,351,532,8927
E02006696,Hagley,Bromsgrove,West Midlands,1587,3906,323,414,374,558,5575,1516,4224,320,397,391,592,5924
E02006697,"Dodford, Belbroughton & Romsley",Bromsgrove,West Midlands,1189,4271,531,541,357,617,6317,1162,4517,527,513,403,568,6528
E02006698,Rubery West,Bromsgrove,West Midlands,1083,3911,391,360,284,494,5440,1095,4128,402,390,263,489,5672
E02006699,Hollywood & Drakes Cross,Bromsgrove,West Midlands,1099,3313,405,441,352,455,4966,1089,3381,399,407,350,481,5018
E02006700,Wythall & Gay Hill,Bromsgrove,West Midlands,995,3457,384,423,352,649,5265,1077,3766,434,396,404,569,5569
E02006701,Barnt Green & Lickey Hills,Bromsgrove,West Midlands,1382,4068,442,378,333,417,5638,1380,4450,447,414,344,460,6115
E02006702,Catshill,Bromsgrove,West Midlands,1214,3683,328,356,216,328,4911,1199,3889,326,356,247,348,5166
E02006703,Marlbrook & Lickey End,Bromsgrove,West Midlands,1405,4610,473,442,351,441,6317,1479,4949,488,475,368,501,6781
E02006704,"Alvechurch, Hopwood & Holt End",Bromsgrove,West Midlands,1319,3984,494,443,347,528,5796,1219,4060,482,467,383,532,5924
E02006705,Bromsgrove Sidemoor,Bromsgrove,West Midlands,1348,4519,376,381,274,401,5951,1451,4749,390,385,314,401,6239
E02006706,Bromsgrove Central & Sanders Park,Bromsgrove,West Midlands,1164,4437,413,390,348,700,6288,1123,4543,382,432,364,662,6383
E02006707,Bromsgrove Stoney Hill,Bromsgrove,West Midlands,1507,4094,339,401,261,391,5486,1430,4344,323,411,279,386,5743
E02006708,Bromsgrove Charford,Bromsgrove,West Midlands,1858,5368,382,315,216,331,6612,1712,5327,360,344,239,309,6579
E02006709,"Stoke Heath, Finstall & Bentley",Bromsgrove,West Midlands,1217,5269,525,499,288,371,6952,1222,5683,534,485,358,367,7427
E02006710,"Tenbury Wells, Mamble & Clifton",Malvern Hills,West Midlands,1283,4448,610,690,505,663,6916,1275,4777,636,699,539,637,7288
E02006711,"Abberley, Holt Heath & Hallow",Malvern Hills,West Midlands,1346,4612,646,638,471,586,6953,1288,4980,626,631,474,650,7361
E02006712,"Broadheath, Sinton & Alfrick",Malvern Hills,West Midlands,1176,4007,576,593,420,586,6182,1226,4444,538,607,446,596,6631
E02006713,Malvern Link,Malvern Hills,West Midlands,951,3674,371,437,359,646,5487,893,3735,371,446,388,629,5569
E02006714,"Colletts Green, Callow End & Hanley",Malvern Hills,West Midlands,844,3009,425,497,359,516,4806,841,3276,397,510,379,525,5087
E02006715,North Malvern,Malvern Hills,West Midlands,1535,5284,552,504,339,425,7104,1526,5525,528,547,351,448,7399
E02006716,Malvern Pickersleigh,Malvern Hills,West Midlands,1418,3726,340,324,241,348,4979,1433,4093,329,353,267,345,5387
E02006717,Kempsey & Ryall,Malvern Hills,West Midlands,1058,3535,475,523,378,501,5412,1061,3796,476,514,400,521,5707
E02006718,Barnard's Green,Malvern Hills,West Midlands,926,3295,454,513,366,663,5291,882,3547,441,541,385,646,5560
E02006719,Malvern Wells & Priory,Malvern Hills,West Midlands,1005,4417,630,636,414,791,6888,966,4573,604,665,457,743,7042
E02006720,"Upton-upon-Severn, Welland & Eldersfield",Malvern Hills,West Midlands,1046,3927,563,534,451,617,6092,962,4223,577,564,431,624,6419
E02006721,Riverside & Church Hill North,Redditch,West Midlands,1125,3562,434,457,285,305,5043,1140,3772,464,513,315,332,5396
E02006722,Church Hill South,Redditch,West Midlands,1337,3375,310,217,88,88,4078,1280,3725,280,263,110,111,4489
E02006723,Batchley & Brockhill,Redditch,West Midlands,2101,5432,364,301,207,378,6682,2057,5987,367,332,228,349,7263
E02006724,Redditch Town & Abbeydale,Redditch,West Midlands,1597,4817,248,181,149,215,5610,1566,5499,280,229,153,240,6401
E02006725,Winyates Green,Redditch,West Midlands,1063,3520,426,270,171,132,4519,1089,3809,390,341,180,167,4887
E02006726,Southcrest,Redditch,West Midlands,1269,4226,301,295,210,256,5288,1228,4554,365,317,221,264,5721
E02006727,Arrow Valley & Ipsley,Redditch,West Midlands,1077,3534,382,399,277,314,4906,1066,3794,404,408,292,344,5242
E02006728,Webheath,Redditch,West Midlands,1249,4206,502,383,307,505,5903,1302,4622,521,432,340,505,6420
E02006729,Matchborough & Park Farm,Redditch,West Midlands,1400,4284,501,491,219,217,5712,1472,4868,473,523,287,219,6370
E02006730,Greenlands,Redditch,West Midlands,1694,4141,265,269,131,160,4966,1696,4466,260,252,193,158,5329
E02006731,Oakenshaw,Redditch,West Midlands,1028,3356,346,348,264,267,4581,955,3573,363,350,275,268,4829
E02006732,Crabbs Cross,Redditch,West Midlands,1197,4347,438,439,263,320,5807,1133,4498,450,440,316,387,6091
E02006733,Hunt End & Feckenham,Redditch,West Midlands,1034,3539,408,450,264,334,4995,1007,3731,395,422,308,285,5141
E02006734,Northwick,Worcester,West Midlands,1473,4514,523,509,387,670,6603,1485,4912,518,502,455,619,7006
E02006735,Warndon West,Worcester,West Midlands,1425,3316,201,174,159,221,4071,1424,3749,235,186,151,224,4545
E02006736,Warndon East,Worcester,West Midlands,1213,4338,232,200,147,151,5068,1203,4797,255,225,171,174,5622
E02006737,Barbourne & Rainbow Hill,Worcester,West Midlands,1424,5259,418,447,302,320,6746,1398,5463,437,455,332,350,7037
E02006738,King George's Field,Worcester,West Midlands,2224,5569,352,310,251,288,6770,2250,6818,437,318,243,296,8112
E02006739,Henwick,Worcester,West Midlands,602,3848,260,291,285,405,5089,555,3590,281,289,281,411,4852
E02006740,Worcester Town North,Worcester,West Midlands,851,5855,318,274,195,290,6932,783,5866,362,313,210,314,7065
E02006741,Lyppard Grange,Worcester,West Midlands,1235,3930,236,237,123,268,4794,1297,4401,262,249,151,246,5309
E02006742,Dines Green & St Johns,Worcester,West Midlands,1662,5691,408,368,305,402,7174,1637,5979,389,392,308,426,7494
E02006743,Ronkswood & Nunnery Wood,Worcester,West Midlands,1433,4130,326,309,163,189,5117,1555,4709,330,333,188,209,5769
E02006744,Worcester Town South,Worcester,West Midlands,1304,5129,300,237,164,286,6116,1241,5718,348,284,188,286,6824
E02006745,Lower Wick & Bromwich Road,Worcester,West Midlands,1388,4763,523,530,360,603,6779,1418,5354,534,585,388,644,7505
E02006746,Battenhall & Diglis,Worcester,West Midlands,1457,5226,473,467,283,426,6875,1457,5655,465,546,352,461,7479
E02006747,St Peters,Worcester,West Midlands,940,3476,258,293,176,254,4457,917,3751,293,319,225,279,4867
E02006748,Hartlebury & Wychbold,Wychavon,West Midlands,1502,4622,517,483,356,505,6483,1588,5349,505,533,364,520,7271
E02006749,Droitwich Spa West & North,Wychavon,West Midlands,1214,3069,308,316,175,197,4065,1196,3582,296,301,184,194,4557
E02006750,Droitwich Spa East,Wychavon,West Midlands,809,3002,347,396,308,580,4633,812,3150,331,401,330,605,4817
E02006751,Droitwich Spa Central,Wychavon,West Midlands,1041,3333,403,427,318,469,4950,991,3601,326,421,315,443,5106
E02006752,Droitwich Spa South,Wychavon,West Midlands,1290,4399,484,547,335,412,6177,1462,5091,517,528,366,456,6958
E02006753,Fernhill Heath & Ombersley,Wychavon,West Midlands,1203,3945,457,510,352,418,5682,1285,4450,506,497,365,470,6288
E02006754,Crowle & Tibberton,Wychavon,West Midlands,909,3200,439,484,324,316,4763,880,3360,424,470,347,348,4949
E02006755,Inkberrow & Flyford Flavell,Wychavon,West Midlands,820,3147,436,490,393,435,4901,781,3466,450,459,416,483,5274
E02006756,Drakes Broughton & Norton,Wychavon,West Midlands,1251,3809,370,325,214,348,5066,1223,4037,363,367,248,296,5311
E02006757,"Wick, Elmley Castle & Fladbury",Wychavon,West Midlands,951,3902,587,581,452,608,6130,909,4196,563,600,476,631,6466
E02006758,Honeybourne & Littleton,Wychavon,West Midlands,938,3691,406,421,277,292,5087,1006,4046,412,440,304,297,5499
E02006759,Pershore,Wychavon,West Midlands,1364,4246,598,631,494,763,6732,1356,4616,556,641,565,760,7138
E02006760,"Harvington, Offenham & Badsey",Wychavon,West Midlands,1554,5244,664,653,445,654,7660,1467,5449,665,649,520,663,7946
E02006761,Evesham Central,Wychavon,West Midlands,1104,4479,308,261,173,370,5591,1086,4831,334,275,202,339,5981
E02006762,Evesham North & Hampton,Wychavon,West Midlands,1266,4077,363,432,295,387,5554,1251,4520,364,418,323,445,6070
E02006763,Evesham East,Wychavon,West Midlands,1799,5296,470,447,270,426,6909,1664,5566,469,506,314,487,7342
E02006764,Evesham South,Wychavon,West Midlands,1153,3923,326,275,177,251,4952,1102,4030,321,294,187,237,5069
E02006765,"Broadway, Wickhamford & Sedgeberrow",Wychavon,West Midlands,801,3187,560,554,424,667,5392,814,3514,523,584,462,699,5782
E02006766,"Bredon, Ashton & Eckington",Wychavon,West Midlands,1147,4195,684,723,420,568,6590,1068,4536,658,733,505,583,7015
E02006767,"Wolverley, Cookley & Blakedown",Wyre Forest,West Midlands,1512,5035,615,766,501,677,7594,1448,5387,684,739,613,724,8147
E02006768,Franche,Wyre Forest,West Midlands,1208,3886,413,526,407,443,5675,1182,4123,384,513,482,462,5964
E02006769,Greenhill,Wyre Forest,West Midlands,1173,4213,441,431,323,429,5837,1140,4449,411,432,368,486,6146
E02006770,Kidderminster Town,Wyre Forest,West Midlands,1887,5515,304,333,232,271,6655,1838,5765,306,319,248,260,6898
E02006771,Bewdley East & Upper Arley,Wyre Forest,West Midlands,1001,3740,603,587,438,465,5833,970,3957,575,600,459,499,6090
E02006772,Habberley,Wyre Forest,West Midlands,1048,3754,406,465,329,550,5504,1138,4059,375,476,371,515,5796
E02006773,Comberton,Wyre Forest,West Midlands,1419,4767,546,651,453,603,7020,1395,4894,545,633,487,602,7161
E02006774,Foley Park,Wyre Forest,West Midlands,1402,4747,415,432,250,333,6177,1344,4887,398,422,294,329,6330
E02006775,Birchen Coppice,Wyre Forest,West Midlands,1426,3637,281,266,209,254,4647,1451,4067,295,289,223,235,5109
E02006776,Spennells & Hoobrook,Wyre Forest,West Midlands,1020,3828,481,501,273,316,5399,992,3837,426,528,312,327,5430
E02006777,"Bewdley West, Ribbesford & Far Forest",Wyre Forest,West Midlands,906,3729,636,650,455,678,6148,901,4132,651,690,554,636,6663
E02006778,Stourport Lickhill & Burlish,Wyre Forest,West Midlands,1297,3881,414,499,367,556,5717,1289,4237,424,539,427,597,6224
E02006779,Stourport Mitton & Wilden,Wyre Forest,West Midlands,1254,4674,515,583,404,501,6677,1230,4863,507,623,441,533,6967
E02006780,Stourport Areley Kings,Wyre Forest,West Midlands,968,3107,452,531,397,400,4887,936,3323,447,517,443,469,5199
E02001827,Hill Hook,Birmingham,West Midlands,1304,3441,341,400,267,518,4967,1270,3870,384,379,315,523,5471
E02001828,Four Oaks,Birmingham,West Midlands,1318,3858,364,427,379,660,5688,1320,4305,359,444,434,674,6216
E02001829,Little Sutton & Roughley,Birmingham,West Midlands,2014,4944,427,494,372,581,6818,2059,5749,444,498,407,573,7671
E02001830,Sutton Coldfield North & Park,Birmingham,West Midlands,1526,5263,588,665,477,861,7854,1558,5891,593,686,538,846,8554
E02001831,Reddicap Heath,Birmingham,West Midlands,2202,6165,482,441,338,538,7964,2351,7136,491,483,364,531,9005
E02001832,Rectory Park & New Hall Valley,Birmingham,West Midlands,1388,4758,465,475,350,487,6535,1314,5122,490,499,376,512,6999
E02001833,Kingstanding North,Birmingham,West Midlands,1141,3492,292,310,230,328,4652,1162,3952,343,316,254,341,5206
E02001834,Old Oscott,Birmingham,West Midlands,1495,3711,223,208,158,253,4553,1503,4203,228,235,177,237,5080
E02001835,Sutton Coldfield South & Central,Birmingham,West Midlands,1512,4996,386,388,311,566,6647,1459,5426,431,436,327,571,7191
E02001836,New Oscott,Birmingham,West Midlands,1696,5762,522,455,423,611,7773,1697,5778,585,520,451,607,7941
E02001837,Kingstanding South East,Birmingham,West Midlands,2708,6443,372,328,227,328,7698,2799,7681,417,346,252,330,9026
E02001838,Walmley,Birmingham,West Midlands,1200,4362,531,434,337,453,6117,1224,4843,597,496,330,490,6756
E02001839,Queslett,Birmingham,West Midlands,1289,3936,291,300,247,378,5152,1263,4309,313,303,230,379,5534
E02001840,Perry Common - College Road,Birmingham,West Midlands,2433,5809,362,298,233,363,7065,2543,6779,402,314,242,351,8088
E02001841,Wylde Green,Birmingham,West Midlands,916,3032,436,480,297,426,4671,1042,3793,431,538,372,476,5610
E02001842,Perry Beeches West,Birmingham,West Midlands,1592,4687,300,306,277,354,5924,1731,5436,317,335,294,385,6767
E02001843,Kingstanding South West,Birmingham,West Midlands,1367,4086,290,298,250,370,5294,1325,4315,312,307,273,361,5568
E02001844,Chester Road,Birmingham,West Midlands,1554,5901,527,513,464,836,8241,1573,6283,540,547,456,813,8639
E02001845,Perry Beeches East,Birmingham,West Midlands,1486,4163,243,268,186,171,5031,1513,4452,275,250,233,196,5406
E02001846,Short Heath,Birmingham,West Midlands,1947,5188,284,252,252,274,6250,1907,5800,324,281,238,262,6905
E02001847,Minworth,Birmingham,West Midlands,983,3070,391,336,236,365,4398,1034,3476,368,396,261,347,4848
E02001848,Upper Witton,Birmingham,West Midlands,1912,4339,222,202,188,291,5242,1936,4943,235,235,171,306,5890
E02001849,Erdington Town,Birmingham,West Midlands,2226,5193,269,225,144,229,6060,2312,6200,304,232,168,231,7135
E02001850,Perry Barr & South Hamstead,Birmingham,West Midlands,1888,5217,265,304,247,354,6387,2097,6305,341,319,272,378,7615
E02001851,Pype Hayes Park,Birmingham,West Midlands,1864,5591,400,380,263,418,7052,1908,6155,464,402,276,403,7700
E02001852,Stockland Green - Marsh Hill,Birmingham,West Midlands,1593,4623,291,249,174,296,5633,1629,5581,288,280,183,284,6616
E02001854,Birches Green,Birmingham,West Midlands,1648,4841,298,333,249,381,6102,1734,5637,356,326,268,379,6966
E02001855,Castle Vale,Birmingham,West Midlands,2166,5996,401,333,303,551,7584,2359,7132,446,358,312,517,8765
E02001856,Brookvale,Birmingham,West Midlands,2302,6579,294,192,146,247,7458,2439,7494,331,244,161,244,8474
E02001857,Gravelly Hill & South Erdington,Birmingham,West Midlands,2931,9968,435,378,249,364,11394,2920,10986,483,386,234,396,12485
E02001858,Handsworth East,Birmingham,West Midlands,1826,6427,356,227,167,246,7423,1857,7305,383,238,163,292,8381
E02001859,Birchfield East,Birmingham,West Midlands,2661,7149,278,167,159,309,8062,3052,10003,346,228,170,321,11068
E02001860,Handsworth West,Birmingham,West Midlands,2448,6085,275,176,159,280,6975,2761,8314,319,196,155,273,9257
E02001861,Birchfield West,Birmingham,West Midlands,2804,7190,304,171,166,297,8128,3000,9165,353,199,184,295,10196
E02001862,Middlemore,Birmingham,West Midlands,2709,7010,373,194,205,357,8139,2930,9498,432,262,171,371,10734
E02001863,Aston Park,Birmingham,West Midlands,2271,5139,209,141,120,223,5832,2553,6874,269,181,119,243,7686
E02001864,Bromford,Birmingham,West Midlands,1679,3351,153,167,114,146,3931,1750,3869,161,156,115,141,4442
E02001865,Handsworth South,Birmingham,West Midlands,2979,7592,356,209,222,282,8661,3226,11006,397,266,206,329,12204
E02001866,Lozells West,Birmingham,West Midlands,2385,5987,234,144,128,237,6730,2536,7867,308,180,122,253,8730
E02001867,Lozells East,Birmingham,West Midlands,2424,4715,191,157,129,163,5355,2742,6760,237,168,132,227,7524
E02001868,Hodge Hill,Birmingham,West Midlands,2589,5847,296,248,201,380,6972,2810,6756,304,284,209,382,7935
E02001869,Nechells,Birmingham,West Midlands,2254,4054,175,141,101,132,4603,2438,4962,209,133,99,157,5560
E02001870,Ward End & Bromford West,Birmingham,West Midlands,3871,7732,340,219,219,358,8868,4254,9539,371,293,205,364,10772
E02001871,Buckland End,Birmingham,West Midlands,1926,4966,338,308,303,387,6302,2088,5547,394,368,280,373,6962
E02001872,Shard End & Kingfisher,Birmingham,West Midlands,1829,4374,345,331,178,330,5558,1909,5014,322,317,212,277,6142
E02001873,Winson Green & Gib Heath,Birmingham,West Midlands,3253,7716,312,210,184,250,8672,3508,10190,357,245,177,248,11217
E02001874,Washwood Heath,Birmingham,West Midlands,3106,6325,231,146,145,202,7049,3472,7886,278,172,139,215,8690
E02001875,Hockley & Jewellery Quarter,Birmingham,West Midlands,2527,6460,181,128,122,216,7107,2560,7009,187,131,98,128,7553
E02001876,North Central & Dartmouth Circus,Birmingham,West Midlands,2118,12020,133,126,70,161,12510,2391,11699,189,138,99,194,12319
E02001877,Saltley East,Birmingham,West Midlands,3664,7212,289,172,128,311,8112,4065,9547,398,214,143,303,10605
E02001878,Saltley West,Birmingham,West Midlands,2627,5795,185,129,94,237,6440,2943,7458,277,152,104,246,8237
E02001879,Summerfield,Birmingham,West Midlands,2580,7123,302,144,184,339,8092,2528,9648,313,188,167,351,10667
E02001880,Glebe Farm,Birmingham,West Midlands,3031,5892,276,243,172,233,6816,3118,6901,340,249,175,200,7865
E02001881,Belchers Lane & Eastfield Road,Birmingham,West Midlands,3460,6119,248,167,130,236,6900,3717,7852,282,200,136,246,8716
E02001882,Stechford,Birmingham,West Midlands,2193,5271,293,295,213,380,6452,2272,5928,315,297,255,351,7146
E02001883,Kitts Green,Birmingham,West Midlands,2118,5025,327,313,185,310,6160,2157,5568,315,338,212,302,6735
E02001884,Bordesley Green North,Birmingham,West Midlands,3482,6079,159,113,93,164,6608,3954,7971,222,151,98,182,8624
E02001886,Rotton Park,Birmingham,West Midlands,2156,7157,361,268,206,278,8270,2223,8803,403,322,224,343,10095
E02001888,Kent's Moat,Birmingham,West Midlands,1764,3994,242,245,167,308,4956,1892,4770,271,262,200,285,5788
E02001889,Little Bromwich,Birmingham,West Midlands,2795,5482,200,126,142,222,6172,3105,7246,256,157,119,221,7999
E02001890,Edgbaston North,Birmingham,West Midlands,1612,8265,345,331,309,382,9632,1722,9227,418,363,297,440,10745
E02001892,Yardley Fields,Birmingham,West Midlands,3470,6587,253,228,181,275,7524,3762,8201,289,250,176,248,9164
E02001893,Yardley,Birmingham,West Midlands,1896,5133,384,335,270,476,6598,1972,5938,400,354,272,449,7413
E02001895,Sheldon North,Birmingham,West Midlands,2214,5366,397,365,235,395,6758,2130,6027,389,365,263,423,7467
E02001896,Small Heath Park,Birmingham,West Midlands,2770,6046,216,136,130,270,6798,3242,8350,314,195,115,318,9292
E02001897,Sparkbrook North,Birmingham,West Midlands,2248,5352,194,146,124,258,6074,2642,6953,245,184,131,254,7767
E02001898,Lyndon Green,Birmingham,West Midlands,1143,3895,311,323,240,372,5141,1229,4203,336,320,287,364,5510
E02001899,Harborne West,Birmingham,West Midlands,1506,4864,428,469,358,711,6830,1678,5686,493,503,409,686,7777
E02001900,Five Ways South & Calthorpe Park,Birmingham,West Midlands,1377,4932,253,243,153,349,5930,1465,5273,265,252,208,306,6304
E02001901,Harborne East,Birmingham,West Midlands,1483,5817,319,259,198,343,6936,1587,6576,359,315,213,333,7796
E02001902,Yardley South,Birmingham,West Midlands,1317,3791,288,202,189,278,4748,1379,4150,269,235,184,261,5099
E02001903,Sparkbrook South,Birmingham,West Midlands,2037,4858,201,130,101,148,5438,2432,6581,264,185,113,208,7351
E02001904,Hay Mills & Tyseley,Birmingham,West Midlands,2177,4868,230,176,110,222,5606,2285,5832,259,199,138,243,6671
E02001905,Edgbaston South & University,Birmingham,West Midlands,1238,9761,279,245,197,361,10843,1320,12560,275,277,243,380,13735
E02001906,Quinton Ridgacre,Birmingham,West Midlands,1936,5732,384,392,262,454,7224,1976,6634,425,418,320,434,8231
E02001907,Sheldon South,Birmingham,West Midlands,1926,6198,440,496,389,579,8102,1979,6834,466,467,392,537,8696
E02001908,Sparkhill North,Birmingham,West Midlands,2520,5682,243,131,119,221,6396,2753,7647,298,182,138,238,8503
E02001909,Balsall Heath East,Birmingham,West Midlands,2326,5247,186,127,114,228,5902,2513,6684,235,135,110,231,7395
E02001910,Balsall Heath West & Kingswood Road,Birmingham,West Midlands,1895,4640,196,143,124,212,5315,2040,5564,251,165,122,234,6336
E02001911,Quinton East,Birmingham,West Midlands,2330,5151,248,273,205,272,6149,2399,6037,310,284,220,301,7152
E02001913,Metchley,Birmingham,West Midlands,1344,6329,300,283,204,323,7439,1420,8681,302,281,225,355,9844
E02001914,Moor Green & Cannon Hill,Birmingham,West Midlands,1412,4633,268,205,131,247,5484,1515,5171,299,241,139,245,6095
E02001915,Acocks Green East,Birmingham,West Midlands,2549,7977,482,408,326,518,9711,2528,8593,489,430,318,511,10341
E02001916,Acocks Green West,Birmingham,West Midlands,2675,6004,261,242,173,285,6965,2731,6888,321,265,191,275,7940
E02001918,Moseley Village,Birmingham,West Midlands,1413,6300,445,327,196,303,7571,1518,6837,440,409,200,345,8231
E02001919,Moseley,Birmingham,West Midlands,1130,4574,324,215,151,352,5616,1322,5161,344,231,162,337,6235
E02001920,Woodgate Valley,Birmingham,West Midlands,1828,4563,364,408,213,222,5770,1829,5292,368,397,280,249,6586
E02001921,California,Birmingham,West Midlands,1837,5022,315,303,257,325,6222,1893,5704,347,317,246,295,6909
E02001922,Selly Oak,Birmingham,West Midlands,649,16848,74,54,79,97,17152,667,15404,84,76,48,121,15733
E02001923,Springfield & Hall Green West,Birmingham,West Midlands,2698,6855,426,334,268,414,8297,2980,8358,458,379,272,441,9908
E02001924,Hall Green East,Birmingham,West Midlands,1505,4184,259,203,150,297,5093,1576,4836,335,217,163,259,5810
E02001925,Selly Oak Park & Lodge Hill,Birmingham,West Midlands,1302,4273,352,291,254,393,5563,1395,5224,322,329,254,422,6551
E02001926,Stirchley North & Selly Park,Birmingham,West Midlands,1260,5577,271,224,199,372,6643,1442,6344,303,263,205,375,7490
E02001927,Weoley Castle,Birmingham,West Midlands,1973,4766,330,314,184,376,5970,1982,5472,349,285,219,365,6690
E02001928,Woodgate,Birmingham,West Midlands,1501,4094,369,420,212,256,5351,1525,4519,393,415,250,287,5864
E02001929,Fox Hollies,Birmingham,West Midlands,2808,6273,289,253,212,267,7294,2970,7195,327,268,174,275,8239
E02001930,Kings Heath,Birmingham,West Midlands,1543,5284,399,262,157,229,6331,1574,5768,393,292,211,234,6898
E02001931,Wake Green East & Moseley Bog,Birmingham,West Midlands,1708,4938,470,360,272,419,6459,1808,5663,470,437,302,420,7292
E02001932,Bartley Green & Shenley Fields,Birmingham,West Midlands,1911,4678,288,236,179,291,5672,1921,5353,323,269,163,243,6351
E02001933,Kings Heath Park & Stirchley East,Birmingham,West Midlands,1540,4661,271,290,205,309,5736,1709,5608,336,298,226,306,6774
E02001934,Hall Green Central,Birmingham,West Midlands,1545,4290,305,280,218,330,5423,1603,4794,331,288,224,325,5962
E02001935,Shenley Lane,Birmingham,West Midlands,1776,4602,371,352,298,555,6178,1829,5407,391,382,322,557,7059
E02001936,Brandwood North,Birmingham,West Midlands,1401,3831,341,334,253,369,5128,1301,4161,356,346,293,400,5556
E02001937,Billesley Common,Birmingham,West Midlands,2028,4952,349,265,204,355,6125,2106,5696,363,305,209,351,6924
E02001938,Bournville East & Stirchley West,Birmingham,West Midlands,1491,5416,321,254,189,294,6474,1496,5893,358,276,183,273,6983
E02001939,Bournville West,Birmingham,West Midlands,1137,3498,376,373,301,521,5069,1157,3952,363,404,328,538,5585
E02001941,Yardley Wood West,Birmingham,West Midlands,1488,3667,241,245,180,333,4666,1591,4219,272,241,179,319,5230
E02001942,Cotteridge,Birmingham,West Midlands,1374,4237,344,282,214,361,5438,1396,4644,336,316,246,366,5908
E02001943,Brandwood East,Birmingham,West Midlands,1369,3983,289,223,198,295,4988,1456,4446,301,288,174,266,5475
E02001944,Brandwood End,Birmingham,West Midlands,1691,5254,350,328,243,288,6463,1656,5408,386,362,244,300,6700
E02001945,Allens Cross,Birmingham,West Midlands,1911,4746,295,248,172,209,5670,2066,5721,346,264,193,225,6749
E02001946,Northfield Victoria Common,Birmingham,West Midlands,1436,4591,431,412,276,434,6144,1384,5150,431,455,281,427,6744
E02001947,Druids Heath,Birmingham,West Midlands,1571,3739,248,187,218,313,4705,1627,4108,271,202,196,290,5067
E02001948,Highter's Heath & Maypole,Birmingham,West Midlands,1492,4491,351,317,231,406,5796,1484,4763,363,333,244,386,6089
E02001949,Lifford & Walkers Heath,Birmingham,West Midlands,1478,3641,235,223,167,305,4571,1371,3879,246,233,182,334,4874
E02001950,Longbridge North,Birmingham,West Midlands,1612,5143,424,404,298,431,6700,1649,5596,455,467,342,438,7298
E02001951,Frankley,Birmingham,West Midlands,2299,5237,496,389,216,230,6568,2357,6097,518,451,241,235,7542
E02001952,Turves Green,Birmingham,West Midlands,2174,5776,402,333,241,330,7082,2247,6359,449,369,239,302,7718
E02001953,King's Norton,Birmingham,West Midlands,1365,3944,441,446,289,498,5618,1295,4534,391,476,309,473,6183
E02001954,Hawkesley,Birmingham,West Midlands,1865,4382,407,380,211,260,5640,2003,5198,360,396,230,257,6441
E02001955,Longbridge South,Birmingham,West Midlands,1648,4521,258,292,228,401,5700,1731,5106,313,273,246,454,6392
E02001956,Rubery East,Birmingham,West Midlands,1518,4212,299,297,153,284,5245,1504,4660,315,285,198,233,5691
E02001957,West Heath,Birmingham,West Midlands,1491,4786,347,390,295,368,6186,1460,5131,371,361,335,386,6584
E02006807,Yardley Wood East,Birmingham,West Midlands,1697,4791,371,334,221,408,6125,1774,5323,409,333,271,395,6731
E02006809,Handsworth Wood,Birmingham,West Midlands,1995,6675,525,346,246,492,8284,2074,7626,586,430,242,498,9382
E02006895,Attwood Green & Park Central,Birmingham,West Midlands,1633,7664,171,112,88,150,8185,1937,8581,171,138,90,170,9150
E02006896,Digbeth,Birmingham,West Midlands,783,6326,98,92,52,83,6651,784,5496,120,75,61,82,5834
E02006897,Five Ways North,Birmingham,West Midlands,1315,6740,133,97,69,79,7118,1472,7406,151,110,73,74,7814
E02006898,Ladywood -Summer Hill,Birmingham,West Midlands,1125,6686,145,95,76,68,7070,1137,6700,194,98,67,83,7142
E02006899,Central,Birmingham,West Midlands,361,7820,62,60,39,44,8025,401,6334,57,52,23,20,6486
E02006900,Bordesley,Birmingham,West Midlands,4748,9653,409,227,233,402,10924,5356,12705,457,262,198,436,14058
E02006901,Greet & Sparkhill South,Birmingham,West Midlands,4817,9613,366,218,225,322,10744,5256,12384,481,283,223,373,13744
E02001958,Longford,Coventry,West Midlands,1619,5360,313,303,259,256,6491,1682,5893,359,310,256,293,7111
E02001959,Keresley,Coventry,West Midlands,1431,4249,268,302,251,358,5428,1565,4814,293,290,233,395,6025
E02001961,Bell Green,Coventry,West Midlands,2067,5406,312,247,218,248,6431,2095,6108,325,267,219,277,7196
E02001962,Little Heath,Coventry,West Midlands,1968,4627,204,155,112,195,5293,2193,5652,232,196,120,227,6427
E02001963,Whitmore Park,Coventry,West Midlands,1126,3911,355,274,206,341,5087,1112,4123,353,297,225,322,5320
E02001964,Henley Green & Wood End,Coventry,West Midlands,3156,6007,351,247,192,301,7098,3451,7782,397,267,211,290,8947
E02001965,Walsgrave & Woodway Park,Coventry,West Midlands,1611,5246,432,392,271,425,6766,1708,5769,493,404,309,433,7408
E02001966,Foleshill West,Coventry,West Midlands,2248,4969,182,119,110,189,5569,2372,6257,210,156,114,199,6936
E02001967,Brownshill Green,Coventry,West Midlands,1187,3864,395,463,379,461,5562,1202,4390,411,462,408,545,6216
E02001968,Radford East,Coventry,West Midlands,2151,5397,275,199,145,220,6236,2210,6048,315,230,188,249,7030
E02001969,Radford West,Coventry,West Midlands,1584,4540,260,256,166,362,5584,1536,4914,250,272,197,321,5954
E02001970,Wyken Croft,Coventry,West Midlands,1143,3623,225,316,292,486,4942,1190,3819,276,273,294,493,5155
E02001971,Coundon,Coventry,West Midlands,1301,3771,240,290,210,264,4775,1229,4159,271,286,238,289,5243
E02001972,Foleshill East,Coventry,West Midlands,3472,7917,301,193,154,161,8726,3657,9834,361,259,165,277,10896
E02001973,Stoke Heath,Coventry,West Midlands,2107,6148,305,273,216,239,7181,2206,6572,324,311,202,262,7671
E02001974,Sherbourne,Coventry,West Midlands,1926,6141,426,439,353,501,7860,1809,6351,431,432,363,545,8122
E02001975,Ravensdale,Coventry,West Midlands,1846,5384,338,281,225,291,6519,1757,5565,336,275,228,312,6716
E02001976,Clifford Park,Coventry,West Midlands,1606,4842,397,379,232,406,6256,1605,5273,388,411,275,427,6774
E02001977,Naul's Mill & Bishopsgate Green,Coventry,West Midlands,1975,8783,288,241,192,265,9769,1931,8243,304,259,197,251,9254
E02001978,Barras Heath,Coventry,West Midlands,1367,4733,270,222,160,285,5670,1444,5018,296,245,180,263,6002
E02001979,Allesley Park,Coventry,West Midlands,1112,3484,251,296,252,493,4776,1068,3631,250,276,249,511,4917
E02001980,Allesley Green & Lower Eastern Green,Coventry,West Midlands,844,3302,379,488,384,493,5046,842,3435,345,460,406,508,5154
E02001981,Hillfields,Coventry,West Midlands,2895,12220,236,152,148,168,12924,3356,12987,294,199,141,216,13837
E02001982,Eastern Green & Tanyard Farm,Coventry,West Midlands,1675,5720,366,372,296,439,7193,1620,5376,379,366,308,489,6918
E02001983,Whoberley,Coventry,West Midlands,1495,5227,393,350,239,390,6599,1456,5443,414,353,253,363,6826
E02001984,Copsewood,Coventry,West Midlands,2118,7474,364,336,264,346,8784,2212,7977,381,360,309,361,9388
E02001985,Lower Stoke & Gosford Park,Coventry,West Midlands,1226,11181,126,98,105,105,11615,1335,9485,141,101,96,144,9967
E02001986,Tile Hill,Coventry,West Midlands,1906,5624,312,366,269,378,6949,1783,5561,365,350,274,359,6909
E02001987,Chapelfields,Coventry,West Midlands,777,5660,180,194,119,220,6373,777,5066,183,193,156,274,5872
E02001988,Central Coventry,Coventry,West Midlands,1142,15538,220,169,136,204,16267,1057,12459,238,209,133,228,13267
E02001989,Earl Place & Lime Tree Park,Coventry,West Midlands,1314,4363,246,240,185,227,5261,1315,4603,262,278,173,250,5566
E02001990,Binley,Coventry,West Midlands,1652,5682,543,497,364,571,7657,1659,6116,554,529,396,632,8227
E02001991,Earlsdon & Canley Gardens,Coventry,West Midlands,1219,5874,540,530,308,538,7790,1183,5895,578,524,375,597,7969
E02001992,Ernesford Grange & Stoke Aldermoor,Coventry,West Midlands,2665,6599,388,431,279,346,8043,2903,7784,436,417,322,321,9280
E02001993,Canley & Westwood Heath,Coventry,West Midlands,1738,5687,334,353,216,338,6928,1655,6532,376,344,253,318,7823
E02001994,Cheylesmore Daventry Road,Coventry,West Midlands,1774,5769,374,413,285,420,7261,1823,6173,366,422,305,437,7703
E02001995,Whitley & Tollbar End,Coventry,West Midlands,2058,7518,282,306,241,389,8736,2109,7474,344,296,252,368,8734
E02001996,Willenhall,Coventry,West Midlands,1907,4647,267,218,196,242,5570,2082,5501,304,236,178,272,6491
E02001997,Stivichall & Finham,Coventry,West Midlands,1561,5112,504,497,426,658,7197,1544,5348,508,481,408,685,7430
E02001998,Finham Park,Coventry,West Midlands,1089,3488,275,333,284,392,4772,1099,3828,294,341,312,419,5194
E02001999,Cannon Park & University,Coventry,West Midlands,818,7867,331,346,266,339,9149,968,18864,365,336,274,373,20212
E02006805,Holbrooks,Coventry,West Midlands,2409,6051,302,232,207,311,7103,2380,6837,343,276,199,349,8004
E02002000,Coseley Wallbrook,Dudley,West Midlands,1654,4866,384,360,293,418,6321,1753,5191,411,364,285,450,6701
E02002001,Sedgley East,Dudley,West Midlands,1095,3777,298,311,247,340,4973,1067,3892,327,291,239,359,5108
E02002002,Sedgley West,Dudley,West Midlands,920,3615,488,607,475,739,5924,930,3862,485,563,546,769,6225
E02002003,West Coseley,Dudley,West Midlands,1616,5454,469,481,397,676,7477,1579,5698,469,474,390,655,7686
E02002004,Woodsetton,Dudley,West Midlands,1568,4603,317,309,259,413,5901,1592,5047,371,327,262,409,6416
E02002005,Dudley Priory & Wrens Nest,Dudley,West Midlands,2629,5635,364,303,315,298,6915,2633,6345,386,304,283,326,7644
E02002006,Upper Gornal & Ruiton,Dudley,West Midlands,1261,4084,321,277,220,324,5226,1259,4204,321,271,227,311,5334
E02002007,Lower Gornal & The Straits,Dudley,West Midlands,1558,5081,488,603,510,776,7458,1527,5297,477,570,522,793,7659
E02002008,Dibdale,Dudley,West Midlands,1476,5630,372,302,234,328,6866,1421,5637,397,311,239,362,6946
E02002009,Kates Hill,Dudley,West Midlands,1869,4210,273,227,142,208,5060,1890,4888,290,235,172,213,5798
E02002010,New Dock & Eve Hill,Dudley,West Midlands,1792,5158,315,239,232,370,6314,1768,5905,331,276,245,400,7157
E02002011,Kingswinford North,Dudley,West Midlands,871,3148,401,397,326,438,4710,920,3433,413,430,369,449,5094
E02002012,Russell's Hall,Dudley,West Midlands,1781,5214,365,337,298,501,6715,1787,5620,355,363,301,530,7169
E02002013,Wall Heath,Dudley,West Midlands,981,3565,416,493,401,606,5481,909,3815,402,457,446,650,5770
E02002014,Dixons Green,Dudley,West Midlands,1948,4929,280,260,198,292,5959,2071,5687,286,292,188,284,6737
E02002015,Pensett & Kingswinford East,Dudley,West Midlands,1301,3988,334,333,263,372,5290,1264,4303,310,363,262,371,5609
E02002016,Brockmoor & Woodside,Dudley,West Midlands,1995,4794,337,284,239,321,5975,1842,5087,326,323,232,359,6327
E02002017,Netherton,Dudley,West Midlands,1679,5502,396,391,311,435,7035,1731,5367,409,369,279,431,6855
E02002018,Kingswinford South,Dudley,West Midlands,1502,4847,557,672,561,711,7348,1423,5335,519,683,598,765,7900
E02002019,Dudley Wood & Saltwells,Dudley,West Midlands,1795,4887,366,336,279,361,6229,1793,5115,365,328,274,351,6433
E02002020,Wordsley & Buckpool,Dudley,West Midlands,1599,5707,540,635,575,654,8111,1498,5658,508,641,551,692,8050
E02002021,Brierley Hill,Dudley,West Midlands,1632,5090,299,260,215,267,6131,1537,5054,322,292,215,319,6202
E02002022,Hawbush,Dudley,West Midlands,2019,5532,429,323,215,304,6803,1932,5672,434,362,229,300,6997
E02002023,Ashwood,Dudley,West Midlands,940,3190,312,373,377,253,4505,870,3229,265,352,381,273,4500
E02002024,Quarry Bank,Dudley,West Midlands,1837,5347,447,428,345,458,7025,1688,5446,464,426,344,443,7123
E02002025,Shell Corner & Hurst Green,Dudley,West Midlands,1643,5177,353,342,295,405,6572,1773,5752,391,354,304,382,7183
E02002026,Amblecote East,Dudley,West Midlands,1117,4082,457,477,289,286,5591,1103,4188,427,487,338,342,5782
E02002027,Withymoor Village,Dudley,West Midlands,877,3510,409,318,154,133,4524,805,3581,439,350,199,143,4712
E02002028,Wollaston,Dudley,West Midlands,882,3396,337,351,344,564,4992,892,3447,369,359,317,530,5022
E02002029,Quinton West,Dudley,West Midlands,988,3513,342,365,296,506,5022,1007,3655,350,350,320,506,5181
E02002030,Amblecote West & Stambermill,Dudley,West Midlands,1282,4041,347,338,236,307,5269,1272,4304,351,375,296,343,5669
E02002031,Cradley West & Hayes Lane,Dudley,West Midlands,1142,3927,368,290,186,233,5004,1216,4054,379,318,206,243,5200
E02002032,Cradley East,Dudley,West Midlands,2237,6285,458,459,318,423,7943,2140,6424,434,473,361,423,8115
E02002033,Hawne,Dudley,West Midlands,1518,4715,474,500,325,438,6452,1463,4893,439,515,372,436,6655
E02002034,Stourbridge Town & Old Quarter,Dudley,West Midlands,1383,5127,462,389,321,416,6715,1380,5409,463,456,329,462,7119
E02002035,Halesowen East,Dudley,West Midlands,1078,3573,433,441,296,429,5172,1047,3721,433,457,337,446,5394
E02002036,Lye & Wynall,Dudley,West Midlands,1432,4128,337,300,246,251,5262,1495,4356,364,318,243,288,5569
E02002037,Norton North,Dudley,West Midlands,1096,3507,394,413,249,320,4883,999,3584,377,402,285,349,4997
E02002038,Halesowen Town,Dudley,West Midlands,1691,5843,478,624,458,484,7887,1670,6008,507,560,533,514,8122
E02002039,Oldswinford & Pedmore,Dudley,West Midlands,1215,3692,330,365,306,495,5188,1033,3702,336,379,296,535,5248
E02002040,Norton South,Dudley,West Midlands,939,3323,472,470,366,532,5163,905,3390,441,490,381,541,5243
E02002041,Pedmore Fields,Dudley,West Midlands,1061,3291,382,502,371,573,5119,1019,3535,390,437,407,601,5370
E02002042,Hayley Green,Dudley,West Midlands,1458,4654,519,529,423,604,6729,1415,4774,531,528,433,583,6849
E02002043,Wood Green & Old Park,Sandwell,West Midlands,1995,5444,420,298,223,352,6737,1914,5804,464,309,229,339,7145
E02002044,Yew Tree & Tamebridge,Sandwell,West Midlands,1851,4908,299,267,178,227,5879,1931,5475,304,312,185,240,6516
E02002045,Woods & Mesty Croft,Sandwell,West Midlands,1739,4806,339,301,262,378,6086,1738,5273,367,298,247,372,6557
E02002046,Friar Park,Sandwell,West Midlands,1556,3427,260,167,120,138,4112,1621,3931,274,183,150,149,4687
E02002047,Wednesbury,Sandwell,West Midlands,1247,4012,374,355,345,466,5552,1292,4491,401,397,340,443,6072
E02002048,Great Barr,Sandwell,West Midlands,1010,3970,365,339,324,472,5470,1112,4335,391,348,329,519,5922
E02002049,Princes End & Willingsworth,Sandwell,West Midlands,1271,3880,267,295,211,229,4882,1216,3972,283,285,226,244,5010
E02002051,Ocker Hill,Sandwell,West Midlands,1523,3420,228,206,149,166,4169,1621,3928,235,219,157,173,4712
E02002052,Stone Cross & Hateley Heath,Sandwell,West Midlands,2767,7133,427,408,307,525,8800,2623,7723,466,432,287,493,9401
E02002053,Hamstead East,Sandwell,West Midlands,1313,4257,370,313,267,379,5586,1259,4184,323,273,248,352,5380
E02002054,Hamstead West,Sandwell,West Midlands,1035,3394,252,299,285,343,4573,1091,3745,250,304,264,369,4932
E02002055,Wednesbury South,Sandwell,West Midlands,2200,6351,484,358,262,408,7863,2412,7632,521,433,295,418,9299
E02002056,Tibbington,Sandwell,West Midlands,2324,5797,339,326,240,307,7009,2512,6552,371,336,254,323,7836
E02002057,Tipton,Sandwell,West Midlands,2081,6245,426,341,324,420,7756,2378,7231,461,408,299,435,8834
E02002058,Great Bridge & Dudley Port,Sandwell,West Midlands,2768,8446,464,332,274,326,9842,2912,9229,523,410,301,394,10857
E02002059,West Bromwich North,Sandwell,West Midlands,2411,7079,483,409,331,493,8795,2483,8571,553,488,336,526,10474
E02002060,Greets Green West,Sandwell,West Midlands,1785,4242,228,189,180,291,5130,1935,5236,295,211,141,282,6165
E02002061,Greets Green East,Sandwell,West Midlands,1426,3792,239,208,190,338,4767,1682,5038,292,235,179,323,6067
E02002062,West Bromwich East & Kenrick Park,Sandwell,West Midlands,2155,5422,332,288,248,366,6656,2189,7122,389,329,239,396,8475
E02002063,North Tividale,Sandwell,West Midlands,2450,6540,350,312,206,317,7725,2494,7239,390,350,216,312,8507
E02002064,Tividale,Sandwell,West Midlands,2858,7728,472,472,379,488,9539,2924,8268,492,496,390,498,10144
E02002065,Smethwick North & West,Sandwell,West Midlands,3625,8424,384,270,303,397,9778,3885,11757,505,362,300,442,13366
E02002066,Oldbury & Rood End,Sandwell,West Midlands,2087,5038,317,242,199,242,6038,2217,6136,336,268,198,279,7217
E02002067,Rowley West,Sandwell,West Midlands,1148,3233,246,303,292,354,4428,1295,3794,273,292,279,388,5026
E02002068,Smethwick East,Sandwell,West Midlands,4302,9005,320,236,170,287,10018,4570,11715,396,298,189,295,12893
E02002069,Whiteheath,Sandwell,West Midlands,1457,4230,329,328,256,358,5501,1502,4655,312,320,243,365,5895
E02002070,Smethwick South,Sandwell,West Midlands,2503,6036,297,283,276,419,7311,2877,7924,376,296,276,455,9327
E02002071,Rowley East,Sandwell,West Midlands,1535,3947,295,315,253,259,5069,1527,4291,295,312,259,269,5426
E02002072,Langley Green,Sandwell,West Midlands,1713,5629,363,354,244,375,6965,1745,6143,444,378,287,399,7651
E02002073,Warley East,Sandwell,West Midlands,1918,4798,310,358,244,294,6004,2086,5938,342,352,243,347,7222
E02002074,Warley West,Sandwell,West Midlands,1815,4929,362,356,294,349,6290,1853,5751,382,358,295,352,7138
E02002075,Blackheath,Sandwell,West Midlands,1734,5498,384,409,303,411,7005,1717,5833,395,418,309,394,7349
E02002076,Bearwood & Warley Woods,Sandwell,West Midlands,2383,7636,344,301,219,355,8855,2455,8373,407,346,251,361,9738
E02002077,Old Hill,Sandwell,West Midlands,2210,6387,471,490,364,499,8211,2189,6772,485,444,391,454,8546
E02002078,Warley South,Sandwell,West Midlands,1171,3790,265,362,254,370,5041,1297,4324,285,349,293,369,5620
E02002079,Brandhall,Sandwell,West Midlands,1701,5109,388,404,267,458,6626,1960,5900,427,425,306,404,7462
E02002080,Cradley Heath,Sandwell,West Midlands,1435,4256,302,305,230,346,5439,1557,4643,364,308,238,350,5903
E02006810,Charlemont,Sandwell,West Midlands,2004,6337,563,541,433,563,8437,2018,7015,581,614,423,594,9227
E02002081,Castle Bromwich West,Solihull,West Midlands,834,3180,415,404,229,355,4583,872,3396,404,427,294,346,4867
E02002082,Smith's Wood North,Solihull,West Midlands,1427,3563,252,277,213,131,4436,1441,4049,223,272,212,141,4897
E02002083,Castle Bromwich East,Solihull,West Midlands,964,3581,362,362,280,424,5009,1005,3900,333,397,283,418,5331
E02002084,Smith's Wood South,Solihull,West Midlands,1587,3965,298,302,224,251,5040,1665,4440,305,316,217,255,5533
E02002085,Kingshurst,Solihull,West Midlands,1674,3876,288,260,186,286,4896,1662,4296,274,290,187,280,5327
E02002086,Chelmsley Wood West,Solihull,West Midlands,1354,3641,258,301,204,207,4611,1291,3976,254,299,231,217,4977
E02002087,Fordbridge,Solihull,West Midlands,1548,3811,216,274,216,238,4755,1570,4318,214,259,208,246,5245
E02002088,Chelmsley Wood East,Solihull,West Midlands,2409,5785,344,420,337,345,7231,2268,6436,337,431,385,400,7989
E02002089,Marston Green & Airport,Solihull,West Midlands,1391,4831,394,494,343,368,6430,1450,5243,368,484,386,414,6895
E02002090,Lyndon North,Solihull,West Midlands,1259,3710,247,277,181,255,4670,1257,4034,276,240,212,275,5037
E02002091,Elmdon Park,Solihull,West Midlands,1306,4464,319,395,320,631,6129,1430,4936,345,357,322,567,6527
E02002092,Lyndon South,Solihull,West Midlands,1411,4355,380,385,309,471,5900,1404,4805,370,353,326,454,6308
E02002093,Olton & Kineton Green,Solihull,West Midlands,1184,4307,311,344,310,462,5734,1123,4378,360,327,292,499,5856
E02002094,Ulverley Green & Langley,Solihull,West Midlands,1083,3532,376,353,271,577,5109,982,3752,376,379,314,530,5351
E02002095,Elmdon Heath & Catherine-de-Barnes,Solihull,West Midlands,1726,5449,527,549,358,459,7342,1579,5549,531,564,420,474,7538
E02002096,Lode Heath,Solihull,West Midlands,1961,5894,545,596,525,1014,8574,2082,6769,533,638,547,961,9448
E02002097,"Meriden, Hampton-in-Arden & Temple Balsall",Solihull,West Midlands,1251,4312,446,495,325,439,6017,1273,4764,463,512,395,457,6591
E02002098,Shirley East,Solihull,West Midlands,2059,5764,436,465,372,760,7797,2048,6410,448,505,380,741,8484
E02002099,Central Solihull & Sharmans Cross,Solihull,West Midlands,1217,3984,416,403,338,596,5737,1232,4299,432,401,357,626,6115
E02002101,Solihull Lodge,Solihull,West Midlands,1083,3719,317,361,278,478,5153,1128,4042,341,359,311,468,5521
E02002102,Blossomfield,Solihull,West Midlands,1856,5266,433,458,312,685,7154,1801,5703,457,465,347,673,7645
E02002103,Shirley Heath,Solihull,West Midlands,1054,3473,380,477,290,483,5103,972,3714,397,461,323,526,5421
E02002104,Monkspath North,Solihull,West Midlands,992,3722,417,349,221,263,4972,985,4077,405,394,263,322,5461
E02002105,Balsall Common,Solihull,West Midlands,1492,4820,497,528,412,606,6863,1457,5056,476,544,456,607,7139
E02002106,Knowle,Solihull,West Midlands,1791,5105,650,804,567,854,7980,1775,5747,613,749,636,916,8661
E02002107,Monkspath South,Solihull,West Midlands,968,3459,377,367,206,320,4729,1022,3646,376,402,255,281,4960
E02002108,Dorridge,Solihull,West Midlands,2025,5621,547,611,455,759,7993,1999,6193,546,625,490,753,8607
E02002109,"Dickens Heath, Cheswick Green & Hockley Heath",Solihull,West Midlands,2215,6963,514,568,318,378,8741,2356,7666,508,594,403,397,9568
E02006808,Shirley West,Solihull,West Midlands,1443,4028,303,268,210,313,5122,1479,4462,284,287,218,325,5576
E02002110,Brownhills West & Clayhanger,Walsall,West Midlands,1490,4606,306,316,256,261,5745,1410,4681,283,335,279,296,5874
E02002111,Brownhills,Walsall,West Midlands,1225,3686,307,370,282,343,4988,1331,4020,308,366,301,391,5386
E02002112,Pelsall North,Walsall,West Midlands,933,3161,302,382,271,311,4427,903,3381,312,336,277,299,4605
E02002113,Walsall Wood,Walsall,West Midlands,1200,3962,336,330,226,312,5166,1221,4100,336,333,252,358,5379
E02002114,Pelsall South,Walsall,West Midlands,918,3431,298,435,350,595,5109,968,3607,305,394,350,597,5253
E02002115,Little Bloxwich,Walsall,West Midlands,1364,3960,331,360,327,442,5420,1439,4390,335,360,283,450,5818
E02002116,Aldridge North,Walsall,West Midlands,1099,3810,437,472,401,463,5583,1057,4107,447,468,405,520,5947
E02002117,Bloxwich Central & North,Walsall,West Midlands,1126,4103,376,367,223,311,5380,1129,4109,399,376,219,315,5418
E02002118,Bloxwich North West,Walsall,West Midlands,1641,4476,312,294,258,478,5818,1740,4832,319,311,242,446,6150
E02002119,Shelfield,Walsall,West Midlands,1057,3579,296,309,274,358,4816,1130,3964,307,311,269,350,5201
E02002120,Ashmore,Walsall,West Midlands,1182,3750,394,299,235,210,4888,1193,3960,416,346,213,228,5163
E02002121,Blakenall North,Walsall,West Midlands,1706,3927,280,271,211,413,5102,1733,4371,284,256,199,337,5447
E02002122,Blakenall South,Walsall,West Midlands,2062,4002,238,195,152,169,4756,2310,4678,231,204,117,208,5438
E02002123,New Invention,Walsall,West Midlands,1345,3899,307,332,297,366,5201,1382,4121,317,327,290,403,5458
E02002124,Aldridge Central,Walsall,West Midlands,1179,3982,339,461,357,780,5919,1143,4106,367,422,359,718,5972
E02002125,Rushall,Walsall,West Midlands,1248,3858,311,306,214,351,5040,1290,4115,317,330,215,344,5321
E02002126,Bloxwich South,Walsall,West Midlands,1716,4227,290,228,169,227,5141,1712,4273,324,244,166,225,5232
E02002127,Walsall Ryecroft,Walsall,West Midlands,2770,6018,364,261,185,287,7115,2771,6519,369,281,196,292,7657
E02002128,Short Heath East,Walsall,West Midlands,974,3243,351,342,297,347,4580,968,3238,327,352,323,406,4646
E02002129,Short Heath West,Walsall,West Midlands,1046,3455,417,368,269,343,4852,1042,3743,393,373,295,346,5150
E02002130,Leamore,Walsall,West Midlands,1858,4339,297,230,193,224,5283,1791,4653,276,242,202,250,5623
E02002131,Aldridge South,Walsall,West Midlands,1282,4490,469,572,454,571,6556,1254,4808,462,500,464,630,6864
E02002132,Bentley,Walsall,West Midlands,1557,3906,396,263,193,325,5083,1484,4144,354,299,199,292,5288
E02002133,Walsall North East,Walsall,West Midlands,1197,4504,344,338,246,338,5770,1268,4689,389,348,254,379,6059
E02002134,Willenhall Park,Walsall,West Midlands,2027,5779,342,307,251,305,6984,2209,6283,372,308,258,318,7539
E02002135,Walsall West,Walsall,West Midlands,2221,5242,269,204,143,181,6039,2185,5812,302,215,172,206,6707
E02002136,Willenhall Town,Walsall,West Midlands,1823,5274,333,277,217,241,6342,1781,5462,358,300,219,237,6576
E02002137,Streetly North,Walsall,West Midlands,940,3447,339,394,393,637,5210,995,3613,351,378,381,635,5358
E02002138,Walsall East,Walsall,West Midlands,1413,4159,282,292,166,333,5232,1364,4234,279,268,221,332,5334
E02002139,Walsall Central,Walsall,West Midlands,2482,7501,324,247,172,334,8578,2651,8048,382,284,180,316,9210
E02002140,Pleck,Walsall,West Midlands,2345,5402,301,265,193,320,6481,2381,6323,327,316,201,311,7478
E02002141,Streetly South,Walsall,West Midlands,1190,3814,329,410,370,475,5398,1192,4010,312,359,362,512,5555
E02002142,Darlaston East,Walsall,West Midlands,1954,4578,253,234,125,220,5410,1950,5144,296,250,143,212,6045
E02002143,Palfrey,Walsall,West Midlands,3167,6597,282,230,230,255,7594,3222,7697,319,265,206,273,8760
E02002144,Walsall South East,Walsall,West Midlands,1222,3849,428,385,367,532,5561,1210,4199,446,447,347,549,5988
E02002145,Darlaston Central,Walsall,West Midlands,2245,4905,305,230,198,218,5856,2232,5516,343,255,194,258,6566
E02002146,The Delves,Walsall,West Midlands,1565,4111,304,211,163,272,5061,1565,4552,294,241,182,276,5545
E02002147,Darlaston West,Walsall,West Midlands,2225,5393,322,299,264,326,6604,2306,5825,331,329,219,362,7066
E02002148,Pheasey & Sutton Road,Walsall,West Midlands,2047,6891,534,525,512,887,9349,2093,7260,495,528,495,875,9653
E02002149,Bushbury,Wolverhampton,West Midlands,1880,5769,533,551,463,605,7921,2013,6659,571,531,435,631,8827
E02002150,Fordhouses,Wolverhampton,West Midlands,1177,3530,285,227,183,262,4487,1249,3977,291,232,169,286,4955
E02002151,Pendeford,Wolverhampton,West Midlands,1227,3674,311,247,141,168,4541,1171,3911,321,251,163,174,4820
E02002152,Bushbury Hill,Wolverhampton,West Midlands,1695,3735,232,216,151,282,4616,1636,4387,249,220,163,308,5327
E02002153,Ashmore Park,Wolverhampton,West Midlands,1327,4363,313,361,335,576,5948,1398,4864,349,337,319,582,6451
E02002154,Oxley Park,Wolverhampton,West Midlands,1538,4034,261,209,140,245,4889,1749,4899,286,235,148,229,5797
E02002155,Low Hill,Wolverhampton,West Midlands,2021,3629,217,156,143,162,4307,2148,4602,237,190,140,240,5409
E02002156,Wood End,Wolverhampton,West Midlands,1572,5121,387,360,270,436,6574,1716,5660,459,377,310,481,7287
E02002157,Tettenhall North,Wolverhampton,West Midlands,1438,4645,385,359,282,493,6164,1477,5306,384,375,304,496,6865
E02002158,Wednesfield North East,Wolverhampton,West Midlands,1350,4196,401,382,374,590,5943,1475,4836,383,404,325,600,6548
E02002159,Park Lane,Wolverhampton,West Midlands,1766,4024,192,169,118,149,4652,1809,4846,213,186,121,167,5533
E02002160,Wednesfield Town,Wolverhampton,West Midlands,1546,4622,379,329,291,336,5957,1575,5160,390,371,303,362,6586
E02002161,Whitmore Reans & Dunstall Hill,Wolverhampton,West Midlands,1918,4685,198,156,118,164,5321,2054,5637,241,171,125,167,6341
E02002162,Tettenhall South,Wolverhampton,West Midlands,1227,4152,463,473,478,903,6469,1259,4544,493,488,467,919,6911
E02002163,Heath Town,Wolverhampton,West Midlands,3235,8415,413,304,249,401,9782,3229,9167,430,313,241,318,10469
E02002164,Waterloo Road,Wolverhampton,West Midlands,1638,5817,159,113,89,160,6338,1806,6855,161,118,98,150,7382
E02002165,West Park,Wolverhampton,West Midlands,1364,5798,293,186,172,352,6801,1427,6212,335,244,157,322,7270
E02002166,East Park,Wolverhampton,West Midlands,2216,5879,416,386,358,408,7447,2351,6926,421,389,356,451,8543
E02002167,Castlecroft,Wolverhampton,West Midlands,1085,3832,413,403,335,471,5454,1101,4123,432,413,343,456,5767
E02002168,Wolverhampton Central,Wolverhampton,West Midlands,2663,8755,339,223,215,320,9852,2939,9895,397,270,183,365,11110
E02002169,Compton & Merryhill North,Wolverhampton,West Midlands,1447,4926,612,597,409,743,7287,1507,5481,610,603,430,746,7870
E02002170,Bilston North West,Wolverhampton,West Midlands,1281,3894,286,261,206,331,4978,1412,4375,319,285,211,322,5512
E02002171,Bilston North East,Wolverhampton,West Midlands,1572,4413,395,382,304,379,5873,1796,5190,394,404,290,374,6652
E02002174,Bradmore,Wolverhampton,West Midlands,1366,4711,441,427,269,437,6285,1353,5221,439,437,294,420,6811
E02002175,Bilston Lunt & Loxdale,Wolverhampton,West Midlands,1786,4625,347,304,226,291,5793,1901,5533,376,347,223,340,6819
E02002176,Merryhill South,Wolverhampton,West Midlands,1469,4500,412,406,295,365,5978,1497,5123,429,431,328,355,6666
E02002177,Ettingshall,Wolverhampton,West Midlands,2681,6760,427,288,274,333,8082,2928,8008,425,346,265,358,9402
E02002178,Goldthorn Park,Wolverhampton,West Midlands,1472,4900,447,397,341,593,6678,1519,5657,547,445,316,568,7533
E02002179,Upper Penn,Wolverhampton,West Midlands,1144,3696,344,366,240,412,5058,1209,4166,375,361,255,447,5604
E02002180,Ettingshall Park,Wolverhampton,West Midlands,1285,3788,286,299,267,504,5144,1266,4208,323,319,262,481,5593
E02002181,Bradley,Wolverhampton,West Midlands,1974,5139,358,286,220,298,6301,2077,5607,335,328,241,311,6822
E02002182,Woodcross,Wolverhampton,West Midlands,1321,3952,369,253,217,324,5115,1349,4506,373,312,212,339,5742
E02006894,Blakenhall,Wolverhampton,West Midlands,3822,9013,524,407,372,503,10819,4071,11473,616,480,327,581,13477
E02002652,Kingswood,"Kingston upon Hull, City of",Yorkshire and the Humber,3927,9985,442,293,142,159,11021,4342,11319,493,389,181,177,12559
E02002653,Bransholme Central,"Kingston upon Hull, City of",Yorkshire and the Humber,1989,4824,351,315,239,289,6018,2066,5464,342,360,231,319,6716
E02002654,Orchard Park,"Kingston upon Hull, City of",Yorkshire and the Humber,2542,4721,263,219,114,238,5555,2573,5408,272,221,125,234,6260
E02002655,Bransholme East,"Kingston upon Hull, City of",Yorkshire and the Humber,2170,5350,342,374,236,238,6540,2150,5994,363,401,242,278,7278
E02002656,Haworth Park,"Kingston upon Hull, City of",Yorkshire and the Humber,597,2781,357,408,331,479,4356,603,2881,382,436,301,518,4518
E02002657,Bransholme West,"Kingston upon Hull, City of",Yorkshire and the Humber,1309,4197,520,521,295,334,5867,1262,4625,540,541,331,383,6420
E02002658,Sutton North,"Kingston upon Hull, City of",Yorkshire and the Humber,953,3942,465,385,228,383,5403,937,4021,491,428,252,443,5635
E02002659,Greenwood,"Kingston upon Hull, City of",Yorkshire and the Humber,2736,6678,432,354,239,425,8128,2771,7547,492,390,249,403,9081
E02002660,Bilton Grange,"Kingston upon Hull, City of",Yorkshire and the Humber,1397,4016,420,369,208,299,5312,1455,4593,426,411,237,366,6033
E02002661,Longhill,"Kingston upon Hull, City of",Yorkshire and the Humber,1858,4800,413,380,236,543,6372,1865,5381,479,398,269,449,6976
E02002662,Ings,"Kingston upon Hull, City of",Yorkshire and the Humber,1230,4040,366,402,285,492,5585,1352,4642,444,447,285,482,6300
E02002663,University & Newland North,"Kingston upon Hull, City of",Yorkshire and the Humber,820,5456,226,219,115,130,6146,826,6056,249,223,144,144,6816
E02002664,Sutton South,"Kingston upon Hull, City of",Yorkshire and the Humber,1261,4317,405,475,249,312,5758,1242,4736,427,493,293,346,6295
E02002665,Bricknell East,"Kingston upon Hull, City of",Yorkshire and the Humber,1583,4913,430,417,275,390,6425,1566,5273,450,442,304,391,6860
E02002666,Newland South,"Kingston upon Hull, City of",Yorkshire and the Humber,1066,7209,224,185,119,219,7956,1226,7384,265,191,138,193,8171
E02002667,Stoneferry & Sutton Fields,"Kingston upon Hull, City of",Yorkshire and the Humber,1278,4666,394,325,186,250,5821,1324,4908,387,350,215,277,6137
E02002668,Southcoates East,"Kingston upon Hull, City of",Yorkshire and the Humber,2113,4893,402,370,268,378,6311,2175,5578,411,399,257,370,7015
E02002669,Newland Avenues,"Kingston upon Hull, City of",Yorkshire and the Humber,1154,6192,284,202,125,159,6962,1254,6653,345,250,152,168,7568
E02002670,Bricknell West,"Kingston upon Hull, City of",Yorkshire and the Humber,1524,4768,361,426,247,474,6276,1482,5047,397,421,283,457,6605
E02002671,Southcoates Central & Docks,"Kingston upon Hull, City of",Yorkshire and the Humber,1650,5985,350,310,213,311,7169,1707,6794,380,324,212,325,8035
E02002672,Greatfield,"Kingston upon Hull, City of",Yorkshire and the Humber,2105,4316,269,248,151,276,5260,2166,4921,299,252,144,277,5893
E02002673,Southcoates West,"Kingston upon Hull, City of",Yorkshire and the Humber,1368,4856,341,324,226,282,6029,1426,5129,377,370,221,304,6401
E02002674,Derringham,"Kingston upon Hull, City of",Yorkshire and the Humber,1151,4164,330,331,218,275,5318,1135,4377,344,346,225,312,5604
E02002675,Sculcoates,"Kingston upon Hull, City of",Yorkshire and the Humber,1830,6400,352,260,165,200,7377,1859,7212,366,299,165,216,8258
E02002676,Chanterlands Avenue,"Kingston upon Hull, City of",Yorkshire and the Humber,1246,5080,300,271,174,249,6074,1273,5543,309,291,186,258,6587
E02002677,Drypool & Victoria Dock,"Kingston upon Hull, City of",Yorkshire and the Humber,1408,5761,377,342,187,278,6945,1382,5910,382,369,218,255,7134
E02002678,Newington,"Kingston upon Hull, City of",Yorkshire and the Humber,1643,5421,288,256,189,232,6386,1716,6186,323,297,184,237,7227
E02002679,East Ella,"Kingston upon Hull, City of",Yorkshire and the Humber,1416,4438,452,389,301,442,6022,1394,4852,495,452,300,437,6536
E02002680,Hull City Centre,"Kingston upon Hull, City of",Yorkshire and the Humber,1348,7300,323,314,191,316,8444,1413,7593,356,312,190,288,8739
E02002681,Boulevard & St Andrew's Quay,"Kingston upon Hull, City of",Yorkshire and the Humber,1966,6081,274,263,154,230,7002,2135,7360,373,246,185,251,8415
E02002682,Gipsyville,"Kingston upon Hull, City of",Yorkshire and the Humber,2131,6032,447,343,252,268,7342,2403,7177,481,406,257,291,8612
E02006813,Anlaby Park & Pickering,"Kingston upon Hull, City of",Yorkshire and the Humber,1470,4634,427,423,306,569,6359,1597,5257,456,491,322,545,7071
E02002684,Bridlington North & Bempton,East Riding of Yorkshire,Yorkshire and the Humber,1250,4675,991,1153,843,1032,8694,1282,4990,989,1180,930,1048,9137
E02002685,Bridlington East & Flamborough,East Riding of Yorkshire,Yorkshire and the Humber,1064,3857,720,879,605,726,6787,1047,4058,709,845,650,772,7034
E02002686,Bridlington West,East Riding of Yorkshire,Yorkshire and the Humber,1793,4361,513,572,359,547,6352,1762,4536,471,564,388,562,6521
E02002687,Bridlington Central,East Riding of Yorkshire,Yorkshire and the Humber,973,3361,445,483,301,416,5006,938,3619,432,439,358,445,5293
E02002688,Bridlington Hilderthorpe,East Riding of Yorkshire,Yorkshire and the Humber,868,3346,377,358,253,331,4665,936,3685,379,363,266,311,5004
E02002689,"Burton Agnes, Rudston & Langtoft",East Riding of Yorkshire,Yorkshire and the Humber,763,3155,482,494,316,458,4905,773,3253,514,498,367,450,5082
E02002691,Driffield West & Huggate,East Riding of Yorkshire,Yorkshire and the Humber,1361,4467,606,681,485,590,6829,1301,4677,614,687,514,613,7105
E02002692,Stamford Bridge & Sutton Upon Derwent,East Riding of Yorkshire,Yorkshire and the Humber,1430,5426,629,666,424,504,7649,1517,5740,593,681,482,580,8076
E02002693,"Skipsea, Beeford & Brandesburton",East Riding of Yorkshire,Yorkshire and the Humber,1037,4034,614,656,384,431,6119,1030,4248,622,652,468,479,6469
E02002694,Pocklington,East Riding of Yorkshire,Yorkshire and the Humber,1995,7031,789,883,596,830,10129,1991,7894,833,933,665,796,11121
E02002695,Hornsea,East Riding of Yorkshire,Yorkshire and the Humber,1133,4288,773,785,582,744,7172,1127,4533,736,866,607,801,7543
E02002696,"Cherry Burton, Leconfield & Middleton",East Riding of Yorkshire,Yorkshire and the Humber,905,3493,432,424,279,374,5002,870,3991,406,453,310,350,5510
E02002697,Leven & Tickton,East Riding of Yorkshire,Yorkshire and the Humber,1208,4271,611,672,405,511,6470,1154,4468,598,681,470,569,6786
E02002698,Market Weighton,East Riding of Yorkshire,Yorkshire and the Humber,1564,4906,538,617,380,500,6941,1516,5020,487,615,414,510,7046
E02002699,Molescroft,East Riding of Yorkshire,Yorkshire and the Humber,1649,5523,623,677,531,731,8085,1611,5922,635,734,566,796,8653
E02002700,Beverley North,East Riding of Yorkshire,Yorkshire and the Humber,1399,3722,315,327,217,332,4913,1230,3883,322,306,230,330,5071
E02002701,"Holme, Melbourne & Bubwith",East Riding of Yorkshire,Yorkshire and the Humber,1376,5000,644,638,324,442,7048,1378,5374,694,677,421,458,7624
E02002702,Beverley South,East Riding of Yorkshire,Yorkshire and the Humber,1314,6127,664,682,469,804,8746,1204,6101,715,714,503,821,8854
E02002703,"Walkington, Bishop Burton & Woodmansey",East Riding of Yorkshire,Yorkshire and the Humber,1454,5327,633,581,386,583,7510,1288,5765,660,617,429,586,8057
E02002704,Aldbrough & Sproatley,East Riding of Yorkshire,Yorkshire and the Humber,978,4013,622,681,392,441,6149,993,4247,664,744,425,478,6558
E02002705,Cottingham West,East Riding of Yorkshire,Yorkshire and the Humber,864,3505,496,554,381,620,5556,1067,4625,502,581,391,632,6731
E02002706,Cottingham East,East Riding of Yorkshire,Yorkshire and the Humber,1187,4166,484,464,323,539,5976,1173,4617,444,500,351,604,6516
E02002707,"South Cave, Newbald & Little Weighton",East Riding of Yorkshire,Yorkshire and the Humber,1008,4500,466,561,327,469,6323,989,5139,457,510,388,501,6995
E02002708,Cottingham South & North Ella,East Riding of Yorkshire,Yorkshire and the Humber,916,3640,463,500,341,758,5702,754,3196,429,512,359,729,5225
E02002709,Gilberdyke & North Cave,East Riding of Yorkshire,Yorkshire and the Humber,1249,4802,523,544,326,476,6671,1182,4750,519,542,361,492,6664
E02002710,Willerby,East Riding of Yorkshire,Yorkshire and the Humber,1300,4288,422,483,351,603,6147,1153,4469,408,458,374,587,6296
E02002711,Kirk Ella,East Riding of Yorkshire,Yorkshire and the Humber,1118,4063,573,656,428,792,6512,1198,4389,565,661,449,768,6832
E02002712,Hedon & Preston,East Riding of Yorkshire,Yorkshire and the Humber,1061,4306,601,651,416,575,6549,997,4261,547,664,444,601,6517
E02002714,Withernsea West & Keyingham,East Riding of Yorkshire,Yorkshire and the Humber,1194,4433,673,657,419,447,6629,1202,4669,634,673,447,507,6930
E02002715,Brough,East Riding of Yorkshire,Yorkshire and the Humber,2788,8319,613,656,468,659,10715,2656,8740,592,676,507,701,11216
E02002716,Burstwick & Thorngumbald,East Riding of Yorkshire,Yorkshire and the Humber,1453,4935,576,633,441,523,7108,1360,5117,560,648,431,589,7345
E02002717,Hessle East & Anlaby South,East Riding of Yorkshire,Yorkshire and the Humber,1459,4844,432,420,298,503,6497,1384,5040,441,415,281,469,6646
E02002718,North Ferriby & Swanland,East Riding of Yorkshire,Yorkshire and the Humber,1362,4251,595,653,430,668,6597,1324,4650,512,644,486,673,6965
E02002719,Hessle West,East Riding of Yorkshire,Yorkshire and the Humber,1054,3741,399,350,260,531,5281,1107,4088,392,364,263,584,5691
E02002720,Howden South & Goole North,East Riding of Yorkshire,Yorkshire and the Humber,1206,4586,504,477,307,486,6360,1172,4771,459,495,341,530,6596
E02002721,"Howden North, Eastrington & Swinefleet",East Riding of Yorkshire,Yorkshire and the Humber,964,3889,458,412,274,420,5453,1005,4193,465,434,304,431,5827
E02002722,Withernsea East & Patrington,East Riding of Yorkshire,Yorkshire and the Humber,1538,4655,752,714,471,569,7161,1436,5153,774,833,497,562,7819
E02002723,Goole West,East Riding of Yorkshire,Yorkshire and the Humber,1634,5452,434,445,344,535,7210,1530,5673,431,475,366,509,7454
E02002724,Goole East,East Riding of Yorkshire,Yorkshire and the Humber,2258,6134,444,389,237,296,7500,2108,6453,444,420,253,323,7893
E02002725,Snaith,East Riding of Yorkshire,Yorkshire and the Humber,1080,4052,446,481,292,358,5629,1087,4253,478,456,312,416,5915
E02006814,Anlaby Common,East Riding of Yorkshire,Yorkshire and the Humber,1467,4797,519,551,335,467,6669,1337,4960,478,554,354,478,6824
E02006891,Driffield East & Nafferton,East Riding of Yorkshire,Yorkshire and the Humber,1203,4495,549,579,359,517,6499,1203,4761,570,589,440,552,6912
E02006892,Driffield Central,East Riding of Yorkshire,Yorkshire and the Humber,1093,3621,415,445,320,487,5288,979,3649,352,457,356,561,5375
E02002726,Immingham & Habrough,North East Lincolnshire,Yorkshire and the Humber,2064,6190,613,601,476,544,8424,2025,6715,635,622,452,583,9007
E02002727,Grimsby East Marsh & Port,North East Lincolnshire,Yorkshire and the Humber,1081,3592,252,218,118,255,4435,1138,3792,250,213,135,204,4594
E02002728,Grimsby West Marsh,North East Lincolnshire,Yorkshire and the Humber,1685,5033,283,266,178,245,6005,1699,5495,326,289,158,228,6496
E02002729,Great Coates & The Willows,North East Lincolnshire,Yorkshire and the Humber,1039,3544,346,403,220,251,4764,1021,3624,377,386,248,258,4893
E02002730,Sidney Park,North East Lincolnshire,Yorkshire and the Humber,1971,4761,255,251,115,196,5578,1846,5047,287,246,151,157,5888
E02002731,New Clee,North East Lincolnshire,Yorkshire and the Humber,1586,3886,222,158,86,126,4478,1529,4036,192,158,101,117,4604
E02002732,"Laceby, Healing & Stallingborough",North East Lincolnshire,Yorkshire and the Humber,1459,4668,489,475,306,497,6435,1401,4972,508,473,368,490,6811
E02002733,Littlefield North,North East Lincolnshire,Yorkshire and the Humber,976,3654,297,284,216,321,4772,973,3799,312,310,203,359,4983
E02002734,Yarborough,North East Lincolnshire,Yorkshire and the Humber,1094,3322,262,300,219,317,4420,1094,3455,275,295,226,358,4609
E02002735,Cleethorpes North,North East Lincolnshire,Yorkshire and the Humber,958,3227,270,207,133,250,4087,909,3433,276,238,163,297,4407
E02002736,Holme Hill,North East Lincolnshire,Yorkshire and the Humber,1449,4011,180,126,100,128,4545,1435,4203,202,165,91,116,4777
E02002737,Weelsby & Old Clee,North East Lincolnshire,Yorkshire and the Humber,1351,4358,406,340,245,454,5803,1305,4741,450,370,237,431,6229
E02002738,Laceby Acres & Wybers Wood,North East Lincolnshire,Yorkshire and the Humber,1398,4180,451,447,222,283,5583,1333,4396,439,460,281,311,5887
E02002739,Cleethorpes Beacon Hill,North East Lincolnshire,Yorkshire and the Humber,1085,3445,369,290,241,398,4743,1073,3654,385,349,226,375,4989
E02002740,Littlefield South & Grange,North East Lincolnshire,Yorkshire and the Humber,1204,3295,307,250,179,309,4340,1137,3546,278,277,177,296,4574
E02002741,Wellow,North East Lincolnshire,Yorkshire and the Humber,1739,5503,445,441,286,593,7268,1762,5844,481,447,294,507,7573
E02002742,Cleethorpes Haverstoe,North East Lincolnshire,Yorkshire and the Humber,868,3157,414,434,298,421,4724,785,3147,373,436,299,408,4663
E02002743,Cleethorpes West,North East Lincolnshire,Yorkshire and the Humber,753,2767,408,544,391,678,4788,759,2931,403,535,355,615,4839
E02002744,Nunsthorpe,North East Lincolnshire,Yorkshire and the Humber,2014,4249,378,259,131,203,5220,1969,4713,346,302,154,222,5737
E02002745,Humberston,North East Lincolnshire,Yorkshire and the Humber,911,3900,512,692,527,675,6306,855,4084,488,654,577,705,6508
E02002746,Scartho,North East Lincolnshire,Yorkshire and the Humber,1853,5686,516,556,464,688,7910,1798,5890,523,552,455,700,8120
E02002747,New Waltham,North East Lincolnshire,Yorkshire and the Humber,1373,4915,519,610,492,638,7174,1465,5478,526,630,521,731,7886
E02002748,Waltham & East Ravendale,North East Lincolnshire,Yorkshire and the Humber,1124,4314,630,607,449,726,6726,1109,4607,626,628,468,754,7083
E02002749,Barton upon Humber,North Lincolnshire,Yorkshire and the Humber,2043,7071,779,702,494,581,9627,2027,7347,794,736,518,642,10037
E02002750,"Goxhill, Barrow & New Holland",North Lincolnshire,Yorkshire and the Humber,1085,3750,463,431,261,318,5223,1043,3918,429,473,294,345,5459
E02002751,Winterton & Winteringham,North Lincolnshire,Yorkshire and the Humber,1181,3740,408,511,304,331,5294,1091,3924,415,482,326,348,5495
E02002752,"Barnetby, Ulceby & Killingholme",North Lincolnshire,Yorkshire and the Humber,1260,4261,510,444,275,347,5837,1245,4376,492,456,308,330,5962
E02002753,"Burton upon Stather, Alkborough & Gunness",North Lincolnshire,Yorkshire and the Humber,1254,4990,609,635,482,690,7406,1229,5066,588,643,521,723,7541
E02002754,Crowle & Keadby,North Lincolnshire,Yorkshire and the Humber,1457,5146,520,517,317,455,6955,1407,5179,527,546,368,446,7066
E02002755,Scunthorpe North,North Lincolnshire,Yorkshire and the Humber,1506,5288,357,256,208,284,6393,1636,5797,310,298,211,364,6980
E02002756,Scunthorpe Central & Crosby,North Lincolnshire,Yorkshire and the Humber,2209,6520,294,217,141,237,7409,2274,7972,329,259,152,260,8972
E02002757,Scunthorpe Berkeley,North Lincolnshire,Yorkshire and the Humber,1353,3955,298,268,232,364,5117,1299,4268,280,295,259,366,5468
E02002758,Scunthorpe Frodingham,North Lincolnshire,Yorkshire and the Humber,1317,4065,299,219,168,212,4963,1356,4297,333,250,178,215,5273
E02002759,Brigg & South Ferriby,North Lincolnshire,Yorkshire and the Humber,1487,5531,712,714,448,653,8058,1484,5874,676,771,497,708,8526
E02002760,Scunthorpe Central Park,North Lincolnshire,Yorkshire and the Humber,1037,3586,399,356,212,343,4896,1006,3708,408,385,229,345,5075
E02002761,Broughton & Appleby,North Lincolnshire,Yorkshire and the Humber,1057,3965,411,430,309,417,5532,937,3992,397,438,336,406,5569
E02002762,Scunthorpe Lincoln Gardens,North Lincolnshire,Yorkshire and the Humber,1363,4038,356,299,209,436,5338,1242,4238,385,301,211,436,5571
E02002763,Scunthorpe Lakeside,North Lincolnshire,Yorkshire and the Humber,2189,5470,332,299,201,328,6630,2103,5676,364,309,240,311,6900
E02002764,Scunthorpe Westcliff,North Lincolnshire,Yorkshire and the Humber,1577,3569,255,233,177,226,4460,1552,3963,245,250,186,229,4873
E02002765,Scunthorpe Ashby,North Lincolnshire,Yorkshire and the Humber,1369,3738,318,355,213,376,5000,1224,3942,345,317,229,368,5201
E02002766,Scunthorpe Bottesford,North Lincolnshire,Yorkshire and the Humber,1809,5194,560,516,403,567,7240,1783,5503,492,567,424,603,7589
E02002767,Scunthorpe Yaddlethorpe,North Lincolnshire,Yorkshire and the Humber,955,3807,507,497,364,472,5647,935,3916,488,507,362,505,5778
E02002768,Epworth & Bracon,North Lincolnshire,Yorkshire and the Humber,1294,4524,582,519,313,454,6392,1233,4616,523,552,381,455,6527
E02002769,Messingham & Scawby,North Lincolnshire,Yorkshire and the Humber,838,3178,415,487,360,446,4886,778,3255,416,457,412,468,5008
E02002770,Kirton in Lindsey & Hibaldstow,North Lincolnshire,Yorkshire and the Humber,1186,4162,498,483,332,396,5871,1133,4284,520,509,373,463,6149
E02002771,"Westwoodside, Haxey & Owston Ferry",North Lincolnshire,Yorkshire and the Humber,1126,4136,558,606,394,472,6166,1023,4314,522,607,397,479,6319
E02002772,Strensall,York,Yorkshire and the Humber,1397,4244,383,387,235,325,5574,1363,4354,403,413,281,370,5821
E02002773,Haxby,York,Yorkshire and the Humber,888,2917,493,542,360,544,4856,855,3190,447,569,408,529,5143
E02002774,Wigginton,York,Yorkshire and the Humber,982,3252,475,488,306,596,5117,991,3589,472,497,363,585,5506
E02002775,New Earswick,York,Yorkshire and the Humber,909,3159,341,440,319,584,4843,942,3407,367,434,344,593,5145
E02002776,Huntington,York,Yorkshire and the Humber,1102,4194,346,452,296,482,5770,1047,4312,372,443,342,481,5950
E02002777,Clifton Without & Skelton,York,Yorkshire and the Humber,1593,5757,362,344,226,226,6915,1651,6207,431,381,262,365,7646
E02002778,Rawcliffe & Clifton South,York,Yorkshire and the Humber,1272,5231,470,460,349,625,7135,1108,5601,441,481,353,566,7442
E02002779,Heworth North & Stockton,York,Yorkshire and the Humber,1471,5835,578,642,443,754,8252,1448,6262,580,657,484,692,8675
E02002780,Clifton North,York,Yorkshire and the Humber,1413,6278,263,263,199,253,7256,1411,6297,299,271,168,243,7278
E02002781,Heworth South & The Groves,York,Yorkshire and the Humber,1496,8781,321,273,214,359,9948,1379,7812,324,286,190,308,8920
E02002782,"Poppleton, Rufforth & Askham",York,Yorkshire and the Humber,1110,3543,365,431,317,608,5264,1063,3793,380,435,332,619,5559
E02002783,Acomb,York,Yorkshire and the Humber,1962,6476,551,535,360,585,8507,1900,6862,552,552,385,565,8916
E02002784,York City Centre,York,Yorkshire and the Humber,1114,10863,430,388,286,394,12361,1032,10908,482,437,305,378,12510
E02002785,Osbaldwick,York,Yorkshire and the Humber,1294,5467,379,394,293,578,7111,1268,5317,344,395,317,546,6919
E02002786,Tang Hall,York,Yorkshire and the Humber,1567,8843,285,258,177,214,9777,1474,7692,277,293,172,231,8665
E02002787,Holgate West,York,Yorkshire and the Humber,1655,6027,422,423,287,555,7714,1508,6331,436,433,291,505,7996
E02002788,Holgate East,York,Yorkshire and the Humber,1534,6396,343,343,211,262,7555,1324,6455,372,388,232,241,7688
E02002789,"Westfield, Chapelfields & Foxwood",York,Yorkshire and the Humber,2028,5799,394,392,213,403,7201,2052,6491,393,392,237,348,7861
E02002790,Fulford Road & Clementhorpe,York,Yorkshire and the Humber,1661,10056,389,379,255,427,11506,1515,10104,405,418,302,428,11657
E02002791,"Dunnington, Elvington & Wheldrake",York,Yorkshire and the Humber,1224,3503,373,505,350,524,5255,1112,3856,408,492,384,590,5730
E02002792,South Bank & Dringhouses,York,Yorkshire and the Humber,1318,5013,382,342,283,463,6483,1328,5441,395,363,299,485,6983
E02002793,Woodthorpe & Acomb Park,York,Yorkshire and the Humber,1490,5618,590,631,435,578,7852,1462,5968,564,657,417,576,8182
E02002794,"Fulford, Heslington & University",York,Yorkshire and the Humber,877,7362,303,347,269,432,8713,972,11215,294,339,264,414,12526
E02002795,Bishopthorpe & Copmanthorpe,York,Yorkshire and the Humber,1465,4447,628,733,460,563,6831,1451,4854,638,735,502,628,7357
E02005742,Ingleton & High Bentham,Craven,Yorkshire and the Humber,1024,4238,552,616,443,566,6415,1031,4341,619,598,480,565,6603
E02005743,"Grassington, Upper Wharfedale & Gargrave",Craven,Yorkshire and the Humber,587,2687,453,454,340,540,4474,548,2809,426,444,382,554,4615
E02005744,"Settle, Hellifield & Horton",Craven,Yorkshire and the Humber,1010,4441,644,675,505,695,6960,998,4619,629,709,523,720,7200
E02005745,Skipton North & Barden Fell,Craven,Yorkshire and the Humber,849,2893,389,457,304,409,4452,822,3105,412,452,336,409,4714
E02005746,Skipton Town & East,Craven,Yorkshire and the Humber,1186,3841,500,426,330,478,5575,1062,4224,488,453,331,464,5960
E02005747,Skipton South,Craven,Yorkshire and the Humber,1238,4344,363,343,236,395,5681,1232,4722,379,397,266,392,6156
E02005748,"Carleton, Cowling & Cononley",Craven,Yorkshire and the Humber,1259,4516,559,478,324,466,6343,1309,4789,582,543,349,425,6688
E02005749,Sutton & Crosshills,Craven,Yorkshire and the Humber,1733,5681,660,710,507,798,8356,1678,6008,676,688,555,738,8665
E02005750,Great Ayton & Stokesley,Hambleton,Yorkshire and the Humber,1121,4332,527,642,437,660,6598,1139,4559,515,619,524,708,6925
E02005751,Rudby & Ingleby,Hambleton,Yorkshire and the Humber,1133,4550,715,871,667,728,7531,1059,4911,690,821,719,786,7927
E02005752,"Brompton, Appleton & Thimbleby",Hambleton,Yorkshire and the Humber,964,3833,564,577,330,381,5685,993,4158,544,555,367,395,6019
E02005753,Northallerton,Hambleton,Yorkshire and the Humber,2460,7918,781,789,591,947,11026,2368,8072,821,823,578,980,11274
E02005754,Northallerton South & Leeming Bar,Hambleton,Yorkshire and the Humber,1069,4074,662,660,451,658,6505,981,4170,624,695,501,650,6640
E02005755,Bedale & Snape,Hambleton,Yorkshire and the Humber,1025,4011,462,440,345,545,5803,984,3976,454,479,332,566,5807
E02005756,"Leeming, Pickhill & Thornton",Hambleton,Yorkshire and the Humber,1242,4216,475,424,273,283,5671,988,4035,444,427,287,308,5501
E02005757,Thirsk North,Hambleton,Yorkshire and the Humber,1307,5167,557,566,423,670,7383,1214,5178,596,580,437,667,7458
E02005758,Thirsk South & Coxwold,Hambleton,Yorkshire and the Humber,1693,5233,599,585,407,569,7393,1655,5341,573,621,435,606,7576
E02005759,Easingwold & Stillington,Hambleton,Yorkshire and the Humber,1443,5119,682,711,502,775,7789,1319,5193,648,727,555,807,7930
E02005760,"Linton, Tollerton & Raskelf",Hambleton,Yorkshire and the Humber,1195,4256,358,413,215,316,5558,981,3944,373,415,233,320,5285
E02005761,"Masham, Kirkby Malzeard & North Stainley",Harrogate,Yorkshire and the Humber,963,3039,427,427,289,349,4531,878,3364,407,471,322,379,4943
E02005762,Ripon North & West,Harrogate,Yorkshire and the Humber,1093,3598,314,393,253,500,5058,1026,3372,314,406,283,476,4851
E02005763,"Dishforth, Baldersby & Markington",Harrogate,Yorkshire and the Humber,1180,3658,401,472,332,376,5239,1100,4660,439,456,354,382,6291
E02005764,Ripon South & East,Harrogate,Yorkshire and the Humber,1847,5790,608,688,525,795,8406,1689,6391,610,663,557,827,9048
E02005765,Boroughbridge & Marton-cum-Grafton,Harrogate,Yorkshire and the Humber,1020,3766,461,481,357,525,5590,1100,4334,497,495,368,547,6241
E02005766,Pateley Bridge & Nidd Valley,Harrogate,Yorkshire and the Humber,933,3440,489,508,267,420,5124,904,3742,471,530,338,416,5497
E02005767,Knaresborough North,Harrogate,Yorkshire and the Humber,1264,3940,477,540,333,524,5814,1324,4596,509,530,366,513,6514
E02005768,Killinghall & Hampsthwaite,Harrogate,Yorkshire and the Humber,1287,4401,329,378,218,347,5673,1317,5272,388,379,263,327,6629
E02005769,Knaresborough Central,Harrogate,Yorkshire and the Humber,1205,3997,413,424,351,547,5732,1135,4510,430,453,343,545,6281
E02005770,Bilton,Harrogate,Yorkshire and the Humber,1581,5336,530,569,407,606,7448,1534,5897,544,594,434,577,8046
E02005771,Saltergate,Harrogate,Yorkshire and the Humber,1543,4712,344,368,218,304,5946,1569,5265,409,367,239,314,6594
E02005772,Knaresborough South & Follifoot,Harrogate,Yorkshire and the Humber,922,3136,478,508,327,468,4917,943,3718,478,536,375,466,5573
E02005773,Harrogate East,Harrogate,Yorkshire and the Humber,1705,5777,404,400,247,447,7275,1560,6488,469,444,260,483,8144
E02005774,Starbeck,Harrogate,Yorkshire and the Humber,1727,5618,488,452,335,672,7565,1565,6305,488,498,337,604,8232
E02005775,Central Harrogate,Harrogate,Yorkshire and the Humber,1287,6641,464,442,335,606,8488,1186,7536,508,485,361,622,9512
E02005776,"Ouseburn, Hammerton & Tockwith",Harrogate,Yorkshire and the Humber,1885,5952,527,568,341,451,7839,1900,6858,556,573,400,435,8822
E02005777,Hookstone,Harrogate,Yorkshire and the Humber,1631,4721,496,550,340,683,6790,1586,5209,482,537,377,645,7250
E02005778,"Menwith, Beckwithshaw & Denton Moor",Harrogate,Yorkshire and the Humber,970,3432,418,439,313,387,4989,992,4013,412,447,370,454,5696
E02005779,Stray,Harrogate,Yorkshire and the Humber,1189,4519,414,463,355,787,6538,1118,4948,441,472,367,703,6931
E02005780,Harrogate West & Pannal,Harrogate,Yorkshire and the Humber,2113,5862,625,635,527,978,8627,2128,6814,593,686,542,983,9618
E02005781,"Spofforth, Burn Bridge & Huby",Harrogate,Yorkshire and the Humber,1076,3156,371,426,355,513,4821,1107,3497,401,453,359,478,5188
E02005782,North Richmondshire,Richmondshire,Yorkshire and the Humber,931,4518,592,623,413,551,6697,978,4587,648,636,464,571,6906
E02005783,Richmond Town,Richmondshire,Yorkshire and the Humber,1289,4776,627,582,447,657,7089,1171,4811,604,602,487,662,7166
E02005784,Catterick & Brompton-on-Swale,Richmondshire,Yorkshire and the Humber,929,3925,340,407,216,371,5259,966,3285,335,389,250,355,4614
E02005785,Catterick Garrison & Colburn,Richmondshire,Yorkshire and the Humber,3897,11822,375,316,237,309,13059,3291,12320,375,338,230,317,13580
E02005786,Upper Dales,Richmondshire,Yorkshire and the Humber,622,3474,511,598,334,428,5345,658,3486,526,580,371,436,5399
E02005787,"Leyburn, Middleham & Tunstall",Richmondshire,Yorkshire and the Humber,1137,4929,692,719,500,636,7476,1149,5022,722,779,516,695,7734
E02005788,Kirkbymoorside & Moors,Ryedale,Yorkshire and the Humber,944,3606,575,562,378,495,5616,810,3538,518,603,382,527,5568
E02005789,Pickering & Thornton Dale,Ryedale,Yorkshire and the Humber,1468,5719,906,966,653,1004,9248,1399,5859,901,1000,740,1041,9541
E02005790,Helmsley & Ampleforth,Ryedale,Yorkshire and the Humber,1041,3924,491,453,390,595,5853,1068,4409,528,504,441,632,6514
E02005791,Rillington & Sherburn,Ryedale,Yorkshire and the Humber,1182,4138,529,469,333,321,5790,1147,4383,515,464,326,355,6043
E02005794,"Sheriff Hutton, Slingsby & Swinton",Ryedale,Yorkshire and the Humber,1406,5681,769,754,504,639,8347,1358,5591,742,742,538,628,8241
E02006870,Malton & Norton,Ryedale,Yorkshire and the Humber,2623,8693,802,794,584,989,11862,2647,9301,798,834,638,956,12527
E02005795,Whitby West,Scarborough,Yorkshire and the Humber,936,3935,559,545,347,633,6019,870,4161,540,550,396,591,6238
E02005796,Esk Valley & Runswick Coast,Scarborough,Yorkshire and the Humber,895,3659,642,583,327,479,5690,854,3941,607,600,347,475,5970
E02005797,Whitby South & East,Scarborough,Yorkshire and the Humber,1039,3656,483,470,253,287,5149,1037,3876,460,503,310,316,5465
E02005798,"Burniston, Sleights & Fylingdales",Scarborough,Yorkshire and the Humber,1100,4382,761,813,560,682,7198,1096,4656,748,807,575,653,7439
E02005799,Newby & Scalby,Scarborough,Yorkshire and the Humber,1556,4638,699,806,597,897,7637,1474,5110,700,839,592,979,8220
E02005800,Scarborough Town & North Bay,Scarborough,Yorkshire and the Humber,1201,5043,488,427,264,357,6579,1151,5404,478,412,283,371,6948
E02005801,Barrowcliff & Northstead,Scarborough,Yorkshire and the Humber,1232,3118,271,345,217,345,4296,1197,3546,269,326,230,329,4700
E02005802,Scarborough Central,Scarborough,Yorkshire and the Humber,1662,5038,404,316,244,301,6303,1529,5427,354,346,245,329,6701
E02005803,Falsgrave,Scarborough,Yorkshire and the Humber,1537,5209,633,588,411,812,7653,1449,5672,624,657,477,744,8174
E02005804,Ramshill & South Cliff,Scarborough,Yorkshire and the Humber,735,5041,606,573,375,751,7346,741,5597,600,589,385,701,7872
E02005805,Wheatcroft & Cayton,Scarborough,Yorkshire and the Humber,1080,3959,562,683,502,612,6318,1076,4430,566,667,560,604,6827
E02005806,"Eastfield, Crossgates & Seamer",Scarborough,Yorkshire and the Humber,1814,4412,369,381,291,343,5796,2000,5129,377,414,269,336,6525
E02005807,Ayton & Snainton,Scarborough,Yorkshire and the Humber,1047,3421,509,574,353,482,5339,1010,3750,554,571,396,495,5766
E02005808,Filey & Hummanby,Scarborough,Yorkshire and the Humber,1588,5884,1047,1174,887,1020,10012,1580,6359,1025,1133,928,1162,10607
E02005809,Tadcaster,Selby,Yorkshire and the Humber,1329,4515,438,496,334,447,6230,1249,4529,435,487,382,486,6319
E02005810,"Church Fenton, Appleton & Wistow",Selby,Yorkshire and the Humber,1935,5720,547,537,315,424,7543,1747,5979,557,575,412,381,7904
E02005811,Barlby & Riccall,Selby,Yorkshire and the Humber,1699,5750,688,596,395,503,7932,1759,6292,666,655,438,518,8569
E02005812,Sherburn in Elmet & South Milford,Selby,Yorkshire and the Humber,2131,6723,564,537,296,449,8569,2188,7276,544,584,344,480,9228
E02005813,Selby Town,Selby,Yorkshire and the Humber,2849,8791,516,428,305,566,10606,2878,9414,489,487,299,490,11179
E02005814,Selby West,Selby,Yorkshire and the Humber,1076,3783,413,474,349,514,5533,1202,4273,424,472,371,490,6030
E02005815,"Selby South, Brayton & Barlow",Selby,Yorkshire and the Humber,1423,4984,595,624,373,472,7048,1415,5354,593,630,450,551,7578
E02005816,"Carlton, Hemingbrough & Osgodby",Selby,Yorkshire and the Humber,1462,5425,561,554,337,368,7245,1389,5450,577,565,355,395,7342
E02005817,"Hambleton, Monk Fryston & Byram",Selby,Yorkshire and the Humber,1283,4429,496,470,318,359,6072,1266,4537,509,519,343,390,6298
E02005818,"Eggborough, Kellington & Smeaton",Selby,Yorkshire and the Humber,1517,5282,528,538,347,443,7138,1485,5504,536,547,399,413,7399
E02001509,Royston West,Barnsley,Yorkshire and the Humber,1249,4113,379,401,244,372,5509,1312,4434,397,394,287,341,5853
E02001510,Royston East & Carlton,Barnsley,Yorkshire and the Humber,1137,3812,330,312,234,224,4912,1149,3932,329,344,237,261,5103
E02001511,Shafton & Upper Cudworth,Barnsley,Yorkshire and the Humber,1113,3680,408,360,284,370,5102,1069,3829,456,358,286,366,5295
E02001512,Mapplewell & Staincross,Barnsley,Yorkshire and the Humber,1340,4869,458,501,355,601,6784,1422,5247,465,536,376,531,7155
E02001513,Darton & Kexborough,Barnsley,Yorkshire and the Humber,1224,4636,530,551,406,379,6502,1190,4739,486,492,406,408,6531
E02001514,Grimethorpe & Brierley,Barnsley,Yorkshire and the Humber,1628,4881,386,349,224,293,6133,1746,5265,370,362,223,288,6508
E02001515,Athersley,Barnsley,Yorkshire and the Humber,2351,6000,532,464,262,381,7639,2307,6481,527,483,270,346,8107
E02001516,Cudworth Village,Barnsley,Yorkshire and the Humber,1263,3954,278,252,162,214,4860,1337,4229,299,263,192,250,5233
E02001517,Monk Bretton,Barnsley,Yorkshire and the Humber,1290,5003,523,525,360,472,6883,1300,5110,537,521,410,494,7072
E02001518,Honeywell,Barnsley,Yorkshire and the Humber,1941,6798,516,514,347,488,8663,1809,7080,534,526,342,460,8942
E02001519,Lundwood,Barnsley,Yorkshire and the Humber,1778,5005,375,335,240,323,6278,1787,5257,369,338,240,312,6516
E02001520,Wilthorpe & Barugh Green,Barnsley,Yorkshire and the Humber,1810,6798,662,793,558,837,9648,1850,7363,736,806,599,850,10354
E02001521,Barnsley Town & Park Road,Barnsley,Yorkshire and the Humber,2191,9039,499,463,250,364,10615,2217,9427,505,444,301,346,11023
E02001522,Thurnscoe,Barnsley,Yorkshire and the Humber,1825,5542,482,489,312,440,7265,1973,6127,509,463,353,420,7872
E02001523,Ardsley & Stairfoot,Barnsley,Yorkshire and the Humber,1171,4692,340,394,271,358,6055,1064,4681,362,338,297,361,6039
E02001524,"Silkstone, Hoylandswaine & Cawthorne",Barnsley,Yorkshire and the Humber,926,3465,444,550,334,424,5217,920,3646,468,511,425,421,5471
E02001525,Worsbrough Common,Barnsley,Yorkshire and the Humber,1313,4520,346,304,236,299,5705,1321,4946,327,267,224,296,6060
E02001526,Kendray,Barnsley,Yorkshire and the Humber,1497,3846,311,269,200,239,4865,1552,4176,278,296,217,201,5168
E02001527,Dodworth,Barnsley,Yorkshire and the Humber,1029,3693,383,385,263,371,5095,1000,3748,354,412,300,342,5156
E02001528,Darfield & Great Houghton,Barnsley,Yorkshire and the Humber,1996,6405,648,636,422,573,8684,2034,6892,678,669,463,575,9277
E02001529,Worsbrough,Barnsley,Yorkshire and the Humber,1764,5684,566,527,394,586,7757,1741,6134,555,514,413,614,8230
E02001530,Goldthorpe,Barnsley,Yorkshire and the Humber,1416,4375,301,252,195,204,5327,1498,4898,335,253,214,240,5940
E02001531,Wombwell North,Barnsley,Yorkshire and the Humber,1390,5031,433,372,271,324,6431,1394,5159,385,421,295,336,6596
E02001532,Penistone,Barnsley,Yorkshire and the Humber,2152,6429,643,604,410,514,8600,2139,6748,635,648,403,514,8948
E02001533,Bolton-upon-Dearne,Barnsley,Yorkshire and the Humber,1567,4827,440,360,230,326,6183,1625,5080,400,411,241,307,6439
E02001534,Wombwell South,Barnsley,Yorkshire and the Humber,1960,6254,454,466,289,442,7905,1867,6376,454,432,268,418,7948
E02001535,"Ingbirchworth, Dunford Bridge & Thurgoland",Barnsley,Yorkshire and the Humber,1114,3848,473,455,322,348,5446,1019,3959,461,459,349,379,5607
E02001536,Birdwell,Barnsley,Yorkshire and the Humber,1388,5100,515,553,426,592,7186,1347,5349,515,522,443,594,7423
E02001537,Elsecar,Barnsley,Yorkshire and the Humber,1617,5487,461,397,259,342,6946,1523,5625,472,421,295,323,7136
E02001538,Hoyland,Barnsley,Yorkshire and the Humber,1580,4898,462,494,374,423,6651,1483,5082,503,433,395,425,6838
E02001539,Moorends,Doncaster,Yorkshire and the Humber,1567,3833,278,299,175,230,4815,1548,4308,299,298,217,236,5358
E02001540,"Askern, Campsall & Norton",Doncaster,Yorkshire and the Humber,2414,6962,721,629,424,578,9314,2329,7749,700,663,466,631,10209
E02001541,Thorne,Doncaster,Yorkshire and the Humber,2035,6800,649,666,473,654,9242,2026,7438,687,671,539,719,10054
E02001542,Stainforth,Doncaster,Yorkshire and the Humber,1705,4615,440,394,273,376,6098,1820,4986,404,428,277,374,6469
E02001543,Carcroft,Doncaster,Yorkshire and the Humber,1560,4743,456,468,305,497,6469,1608,5057,513,470,346,438,6824
E02001544,Hatfield West,Doncaster,Yorkshire and the Humber,1813,5061,393,471,332,405,6662,1744,5358,396,453,374,439,7020
E02001545,Kirk Sandall & Barnby Dun,Doncaster,Yorkshire and the Humber,1350,4699,713,595,387,598,6992,1305,4934,624,678,431,603,7270
E02001546,Hatfield East,Doncaster,Yorkshire and the Humber,1089,6113,502,514,367,527,8023,1069,6172,514,497,371,568,8122
E02001547,Adwick le Street & Woodlands,Doncaster,Yorkshire and the Humber,2567,6743,482,475,255,400,8355,2510,7145,516,472,291,436,8860
E02001548,Bentley & Toll Bar,Doncaster,Yorkshire and the Humber,1824,5118,345,339,243,284,6329,1917,5616,359,318,255,304,6852
E02001549,Edenthorpe & Mere Lane,Doncaster,Yorkshire and the Humber,1209,3709,392,319,243,337,5000,1184,4007,398,373,265,369,5412
E02001550,Scawthorpe,Doncaster,Yorkshire and the Humber,1538,4854,376,323,260,404,6217,1591,5205,411,367,251,375,6609
E02001551,Bentley Rise,Doncaster,Yorkshire and the Humber,1168,3850,343,273,193,234,4893,1062,3923,329,322,180,250,5004
E02001552,Armthorpe North,Doncaster,Yorkshire and the Humber,1640,4955,362,323,222,354,6216,1585,5160,346,349,243,361,6459
E02001553,Wheatley Hills,Doncaster,Yorkshire and the Humber,2152,6371,545,459,322,490,8187,2206,7014,522,497,316,480,8829
E02001554,Cusworth,Doncaster,Yorkshire and the Humber,1028,3620,340,341,268,423,4992,963,3894,341,325,287,407,5254
E02001555,Armthorpe South,Doncaster,Yorkshire and the Humber,758,3059,433,382,294,363,4531,753,3151,459,433,302,378,4723
E02001556,Intake,Doncaster,Yorkshire and the Humber,2051,6033,408,394,254,404,7493,2029,6562,420,418,243,382,8025
E02001557,Belle Vue & Town Fields,Doncaster,Yorkshire and the Humber,1609,7233,492,346,245,395,8711,1684,8056,521,391,256,453,9677
E02001558,"Cadeby, Hickleton & Hampole",Doncaster,Yorkshire and the Humber,838,3445,442,509,384,415,5195,787,3647,456,490,389,471,5453
E02001559,Sprotbrough,Doncaster,Yorkshire and the Humber,1374,4524,376,541,326,479,6246,1286,4792,420,481,379,541,6613
E02001560,Central Doncaster & Hyde Park,Doncaster,Yorkshire and the Humber,2710,9538,369,318,220,267,10712,2847,10750,376,326,203,247,11902
E02001561,Hexthorpe & Balby North,Doncaster,Yorkshire and the Humber,1333,4496,255,201,176,275,5403,1309,4745,264,194,165,203,5571
E02001562,Cantley Park,Doncaster,Yorkshire and the Humber,1095,3462,342,317,229,434,4784,1092,3661,372,320,235,398,4986
E02001563,Bessacarr Bawtry Road,Doncaster,Yorkshire and the Humber,1447,4548,550,499,368,650,6615,1415,4799,526,550,391,678,6944
E02001564,"Old Cantley, Auckley & Finningley",Doncaster,Yorkshire and the Humber,1404,4499,626,616,394,448,6583,1341,4922,592,630,446,518,7108
E02001565,Bessacarr Grange & Lakeside,Doncaster,Yorkshire and the Humber,1167,4382,553,510,315,455,6215,1242,4830,537,550,379,471,6767
E02001566,Balby Carr,Doncaster,Yorkshire and the Humber,2040,6424,279,264,129,209,7305,1987,6492,311,252,163,190,7408
E02001567,Balby South,Doncaster,Yorkshire and the Humber,1899,5368,495,451,276,469,7059,1873,5845,518,479,299,456,7597
E02001568,Mexborough East,Doncaster,Yorkshire and the Humber,1313,3960,343,366,263,261,5193,1406,4273,356,383,257,286,5555
E02001569,Mexborough West,Doncaster,Yorkshire and the Humber,1789,5697,422,372,296,379,7166,1673,5774,452,389,329,395,7339
E02001570,Conisbrough North,Doncaster,Yorkshire and the Humber,1358,4289,381,376,260,374,5680,1375,4480,392,413,252,361,5898
E02001571,"Warmsworth, Braithwell & Stainton",Doncaster,Yorkshire and the Humber,1054,3701,361,393,303,352,5110,942,3735,363,389,302,362,5151
E02001572,Edlington,Doncaster,Yorkshire and the Humber,1609,4625,379,339,225,308,5876,1643,5161,383,359,220,342,6465
E02001573,Conisbrough South,Doncaster,Yorkshire and the Humber,1668,4731,392,325,251,384,6083,1637,5136,408,367,222,412,6545
E02001574,Rossington,Doncaster,Yorkshire and the Humber,1004,3686,397,461,233,304,5081,991,3773,404,434,276,326,5213
E02001575,New Rossington,Doncaster,Yorkshire and the Humber,1798,4560,308,331,223,351,5773,1750,5056,333,334,231,342,6296
E02001576,"Bawtry, Austerfield & Hayfield",Doncaster,Yorkshire and the Humber,1355,4237,327,368,230,311,5473,1377,4527,342,353,258,326,5806
E02001577,Tickhill & Wadworth,Doncaster,Yorkshire and the Humber,923,3347,514,614,451,618,5544,851,3555,483,598,505,622,5763
E02001578,Brampton & West Melton,Rotherham,Yorkshire and the Humber,2645,7339,517,388,295,389,8928,2580,7653,581,454,295,362,9345
E02001579,Wath upon Dearne,Rotherham,Yorkshire and the Humber,1904,5890,553,490,385,569,7887,1887,6202,544,541,394,582,8263
E02001580,Swinton North,Rotherham,Yorkshire and the Humber,1343,4941,510,586,383,549,6969,1425,5321,489,565,414,520,7309
E02001581,Swinton South,Rotherham,Yorkshire and the Humber,1179,3553,386,330,223,285,4777,1259,3935,409,362,208,283,5197
E02001582,Rawmarsh North West,Rotherham,Yorkshire and the Humber,1472,4763,404,386,318,393,6264,1362,4999,403,401,323,390,6516
E02001583,Rawmarsh North East,Rotherham,Yorkshire and the Humber,1194,3524,279,257,176,247,4483,1180,3631,289,256,180,232,4588
E02001584,Thorpe Hesley,Rotherham,Yorkshire and the Humber,976,4205,502,485,315,340,5847,916,4288,506,489,335,358,5976
E02001585,Rawmarsh South,Rotherham,Yorkshire and the Humber,1315,4044,319,282,199,275,5119,1255,4099,323,301,210,281,5214
E02001586,Greasborough,Rotherham,Yorkshire and the Humber,1082,4945,458,496,381,492,6772,1097,5282,432,459,399,491,7063
E02001587,Thrybergh & Hooton Roberts,Rotherham,Yorkshire and the Humber,1079,3496,322,328,235,290,4671,1088,3800,319,319,247,275,4960
E02001588,Kimberworth Park,Rotherham,Yorkshire and the Humber,1545,4366,347,287,201,412,5613,1477,4760,355,307,187,379,5988
E02001589,Ravenfield & Bramley North,Rotherham,Yorkshire and the Humber,1505,4807,464,483,301,380,6435,1399,4905,479,485,332,397,6598
E02001590,East Herringthorpe,Rotherham,Yorkshire and the Humber,2009,4681,299,262,211,221,5674,1920,5094,308,270,199,204,6075
E02001591,Eastwood & East Dene,Rotherham,Yorkshire and the Humber,2170,5411,344,263,188,273,6479,2167,5935,367,292,197,284,7075
E02001592,Kimberworth,Rotherham,Yorkshire and the Humber,1508,5337,495,551,403,412,7198,1453,5537,523,540,383,442,7425
E02001593,Masbrough & Bradgate,Rotherham,Yorkshire and the Humber,1777,5095,260,227,123,197,5902,1949,5680,285,219,144,188,6516
E02001594,Rotherham Central,Rotherham,Yorkshire and the Humber,1907,5491,255,218,161,318,6443,2254,6287,258,212,164,319,7240
E02001595,Maltby West & Hellaby,Rotherham,Yorkshire and the Humber,1347,5171,521,445,346,482,6965,1284,5339,528,497,383,493,7240
E02001596,Wickersley North,Rotherham,Yorkshire and the Humber,1397,4680,553,596,453,696,6978,1429,5058,550,569,479,642,7298
E02001597,Maltby East,Rotherham,Yorkshire and the Humber,2077,5719,491,449,291,407,7357,2130,6088,512,460,318,413,7791
E02001598,Herringthorpe,Rotherham,Yorkshire and the Humber,1819,5602,544,559,393,646,7744,1830,6032,552,550,447,703,8284
E02001599,Wickersley South & Bramley South,Rotherham,Yorkshire and the Humber,1037,3817,390,414,311,426,5358,1103,4224,403,415,336,444,5822
E02001600,Rotherham South,Rotherham,Yorkshire and the Humber,2220,6691,584,579,434,739,9027,2241,7279,589,581,454,686,9589
E02001601,Whiston,Rotherham,Yorkshire and the Humber,785,2890,328,301,244,320,4083,756,3124,307,314,236,340,4321
E02001602,Brinsworth,Rotherham,Yorkshire and the Humber,1608,5401,449,579,416,503,7348,1614,5645,438,553,448,544,7628
E02001603,Thurcroft,Rotherham,Yorkshire and the Humber,1559,4341,393,407,245,339,5725,1535,4635,402,418,252,336,6043
E02001604,"Catcliffe, Treeton & Waverley",Rotherham,Yorkshire and the Humber,2207,6872,403,431,269,360,8335,2409,7423,395,424,320,337,8899
E02001605,Laughton & Throapham,Rotherham,Yorkshire and the Humber,1398,4792,434,399,281,428,6334,1276,4777,439,401,308,402,6327
E02001606,Dinnington,Rotherham,Yorkshire and the Humber,1591,4749,448,529,330,417,6473,1561,5193,458,498,373,460,6982
E02001607,Aston,Rotherham,Yorkshire and the Humber,1809,5156,526,589,403,464,7138,1779,5558,538,565,412,515,7588
E02001608,Swallownest & Wales,Rotherham,Yorkshire and the Humber,1344,4097,378,427,290,269,5461,1356,4410,380,429,324,323,5866
E02001609,Anston & Woodsetts,Rotherham,Yorkshire and the Humber,1298,4701,585,733,525,544,7088,1368,5083,558,693,601,564,7499
E02001610,"Kiveton, Todwick & Harthill",Rotherham,Yorkshire and the Humber,1487,4952,484,614,411,482,6943,1414,5082,458,565,485,517,7107
E02001611,Stocksbridge,Sheffield,Yorkshire and the Humber,1314,4492,453,507,342,544,6338,1269,4806,434,533,412,557,6742
E02001612,Deepcar & Bolsterstone,Sheffield,Yorkshire and the Humber,926,3567,338,377,278,296,4856,899,3672,341,388,310,296,5007
E02001613,High Green & Burncross,Sheffield,Yorkshire and the Humber,1791,6019,621,726,445,577,8388,1791,6377,683,716,488,588,8852
E02001614,Chapeltown,Sheffield,Yorkshire and the Humber,1671,6467,693,735,507,652,9054,1666,6944,721,754,585,758,9762
E02001615,Grenoside & Ecclesfield North,Sheffield,Yorkshire and the Humber,932,4097,523,592,459,589,6260,925,4374,531,615,506,614,6640
E02001616,Ecclesfield South,Sheffield,Yorkshire and the Humber,1288,4416,364,428,343,454,6005,1276,4542,339,434,336,480,6131
E02001617,Shiregreen North,Sheffield,Yorkshire and the Humber,1563,3596,216,160,134,206,4312,1633,4004,194,154,140,227,4719
E02001618,Oughtibridge & Bradfield,Sheffield,Yorkshire and the Humber,1840,6073,530,557,397,456,8013,1856,6546,536,581,439,483,8585
E02001619,Parson Cross,Sheffield,Yorkshire and the Humber,2237,5872,434,442,327,427,7502,2349,6725,462,405,290,443,8325
E02001620,Shiregreen South,Sheffield,Yorkshire and the Humber,1760,4205,247,283,202,255,5192,1709,4662,283,243,221,234,5643
E02001621,Sheffield Lane Top & Longley Park,Sheffield,Yorkshire and the Humber,1441,3786,206,224,168,239,4623,1524,4093,225,214,172,229,4933
E02001622,Southey Green West,Sheffield,Yorkshire and the Humber,1933,5463,379,342,266,484,6934,2008,5828,403,359,283,453,7326
E02001623,Firth Park,Sheffield,Yorkshire and the Humber,2203,5056,334,298,204,377,6269,2174,5753,363,337,230,382,7065
E02001624,Brightside & Wincobank,Sheffield,Yorkshire and the Humber,2096,6262,396,418,344,379,7799,1950,6633,458,388,377,402,8258
E02001625,Southey Green East,Sheffield,Yorkshire and the Humber,1968,4754,300,305,229,301,5889,1981,5143,318,327,226,320,6334
E02001626,Wadsley & Marlcliffe,Sheffield,Yorkshire and the Humber,1073,3690,271,319,222,275,4777,1040,3975,286,314,214,329,5118
E02001627,"Hillsborough, Owlerton & Wadsley Bridge",Sheffield,Yorkshire and the Humber,1047,4222,246,233,139,218,5058,1026,4538,286,230,142,207,5403
E02001628,Tinsley & Carbrook,Sheffield,Yorkshire and the Humber,2014,4263,227,162,173,261,5086,2172,4952,236,198,145,226,5757
E02001629,Shirecliffe & Parkwood Springs,Sheffield,Yorkshire and the Humber,1586,4311,257,211,234,361,5374,1632,4619,269,235,215,366,5704
E02001630,Crabtree & Fir Vale,Sheffield,Yorkshire and the Humber,2854,5999,300,187,165,379,7030,2894,7201,316,217,186,384,8304
E02001631,Malin Bridge & Wisewood,Sheffield,Yorkshire and the Humber,1377,4952,327,353,273,431,6336,1322,5331,353,370,320,417,6791
E02001632,Burngreave & Grimesthorpe,Sheffield,Yorkshire and the Humber,4759,9070,286,206,163,327,10052,4252,10118,329,222,175,354,11198
E02001633,Upper Stannington & Loxley,Sheffield,Yorkshire and the Humber,1158,4277,485,548,407,603,6320,1220,4677,498,533,429,591,6728
E02001634,Walkley,Sheffield,Yorkshire and the Humber,1273,6627,446,363,258,389,8083,1323,6758,455,398,276,378,8265
E02001635,Lower Stannington,Sheffield,Yorkshire and the Humber,1073,3574,297,360,347,469,5047,1024,3811,337,336,330,477,5291
E02001636,"Upperthorpe, Netherthorpe & Langsett",Sheffield,Yorkshire and the Humber,1896,8062,369,337,248,413,9429,1904,9187,335,339,239,392,10492
E02001637,Darnall,Sheffield,Yorkshire and the Humber,2626,5182,211,169,152,203,5917,2851,6428,237,169,153,256,7243
E02001638,Springvale & Steel Bank,Sheffield,Yorkshire and the Humber,514,5098,148,137,67,117,5567,509,4898,133,152,84,116,5383
E02001639,Crookes,Sheffield,Yorkshire and the Humber,928,4327,203,238,197,340,5305,923,4170,219,244,183,350,5166
E02001640,Broomhill & Lower Crookesmoor,Sheffield,Yorkshire and the Humber,759,6599,245,152,138,245,7379,775,6650,247,195,138,271,7501
E02001642,Littledale & Handsworth North,Sheffield,Yorkshire and the Humber,2057,6616,414,410,341,460,8241,2060,6918,439,457,367,522,8703
E02001643,Sandygate & Crosspool,Sheffield,Yorkshire and the Humber,1170,3592,399,407,297,445,5140,1204,3896,418,412,310,489,5525
E02001646,Broomhall,Sheffield,Yorkshire and the Humber,778,7582,218,218,128,241,8387,686,7263,239,216,140,246,8104
E02001647,Handsworth South,Sheffield,Yorkshire and the Humber,1159,3661,315,366,304,442,5088,1132,3901,327,339,318,407,5292
E02001648,Endcliffe & Ranmoor,Sheffield,Yorkshire and the Humber,1093,7737,323,385,178,374,8997,1027,8336,352,352,248,311,9599
E02001649,Woodthorpe,Sheffield,Yorkshire and the Humber,2470,6432,394,337,284,280,7727,2631,7529,443,356,276,256,8860
E02001650,Sharrow,Sheffield,Yorkshire and the Humber,1319,8374,172,107,103,182,8938,1209,9138,187,139,104,201,9769
E02001651,Fulwood & Lodge Moor,Sheffield,Yorkshire and the Humber,1502,4266,543,557,405,605,6376,1550,4991,526,606,448,614,7185
E02001652,Highfield & Lowfield,Sheffield,Yorkshire and the Humber,1715,10872,192,139,132,222,11557,1555,12292,222,160,126,199,12999
E02001653,Norfolk Park,Sheffield,Yorkshire and the Humber,1436,5192,232,239,208,253,6124,1546,5651,241,242,223,229,6586
E02001654,Woodhouse Mill,Sheffield,Yorkshire and the Humber,1081,3812,273,319,310,482,5196,1129,3996,279,314,285,530,5404
E02001655,Richmond & Stradbroke,Sheffield,Yorkshire and the Humber,1620,4738,373,409,259,326,6105,1594,5000,378,419,283,338,6418
E02001656,Brincliffe & Sharrow Vale,Sheffield,Yorkshire and the Humber,1275,5929,313,258,181,281,6962,1349,5963,336,290,194,280,7063
E02001657,Ecclesall & Greystones,Sheffield,Yorkshire and the Humber,2015,5642,428,419,253,402,7144,1975,6104,448,444,279,384,7659
E02001658,Arbourthorne,Sheffield,Yorkshire and the Humber,1308,3498,197,186,158,202,4241,1389,3670,224,192,164,180,4430
E02001659,Woodhouse West,Sheffield,Yorkshire and the Humber,972,3851,302,321,192,383,5049,982,3937,325,312,196,347,5117
E02001660,Nether Edge,Sheffield,Yorkshire and the Humber,1873,7000,439,359,210,403,8411,1845,7539,485,428,266,418,9136
E02001661,Heeley & Newfield Green,Sheffield,Yorkshire and the Humber,1571,5307,309,360,250,406,6632,1621,5499,331,320,241,373,6764
E02001662,Intake,Sheffield,Yorkshire and the Humber,1262,4482,380,434,332,554,6182,1250,4623,426,418,362,577,6406
E02001663,Meersbrook,Sheffield,Yorkshire and the Humber,1432,5402,251,235,135,236,6259,1362,5579,347,231,158,262,6577
E02001664,Gleadless,Sheffield,Yorkshire and the Humber,1040,3829,369,379,298,449,5324,1024,3935,377,393,291,445,5441
E02001665,Bents Green & Millhouses,Sheffield,Yorkshire and the Humber,1827,5265,618,656,459,794,7792,1903,6019,629,709,471,750,8578
E02001666,Beighton,Sheffield,Yorkshire and the Humber,1167,3819,273,273,202,249,4816,1144,4027,267,288,210,248,5040
E02001669,Woodseats,Sheffield,Yorkshire and the Humber,1285,5180,292,308,200,321,6301,1269,5320,334,303,246,352,6555
E02001670,Herdings & Gleadless Valley,Sheffield,Yorkshire and the Humber,1446,3889,253,257,179,353,4931,1412,4000,235,234,182,295,4946
E02001671,Hackenthorpe,Sheffield,Yorkshire and the Humber,708,3460,386,451,295,376,4968,708,3589,436,422,365,410,5222
E02001672,Charnock & Basegreen,Sheffield,Yorkshire and the Humber,990,3589,308,360,281,547,5085,988,3823,336,330,261,435,5185
E02001673,Sothall,Sheffield,Yorkshire and the Humber,923,3451,278,239,142,237,4347,922,3620,314,274,167,223,4598
E02001674,Norton & Norton Lees,Sheffield,Yorkshire and the Humber,1356,4886,578,600,473,722,7259,1507,5474,598,601,500,732,7905
E02001675,Westfield & Waterthorpe,Sheffield,Yorkshire and the Humber,1432,5093,550,638,437,520,7238,1336,5305,585,632,456,517,7495
E02001676,Beauchief,Sheffield,Yorkshire and the Humber,982,3323,375,360,289,450,4797,961,3667,410,386,288,469,5220
E02001678,Dore & Whirlow,Sheffield,Yorkshire and the Humber,1884,5593,685,717,537,879,8411,1943,6048,683,734,624,967,9056
E02001679,Greenhill & Lowedges,Sheffield,Yorkshire and the Humber,1453,3964,284,305,199,346,5098,1380,4058,305,310,238,333,5244
E02001680,Batemoor & Jordanthorpe,Sheffield,Yorkshire and the Humber,1472,3943,260,244,198,332,4977,1379,4201,249,256,187,310,5203
E02001681,Totley & Bradway,Sheffield,Yorkshire and the Humber,1374,4259,517,513,408,573,6270,1397,4532,463,534,402,572,6503
E02006803,Mosborough & Halfway,Sheffield,Yorkshire and the Humber,1473,5692,534,490,329,417,7462,1537,5916,533,526,374,484,7833
E02006843,Cathedral & Kelham,Sheffield,Yorkshire and the Humber,653,20409,29,30,25,25,20518,616,18465,65,41,17,21,18609
E02006844,Devonshire Quarter,Sheffield,Yorkshire and the Humber,766,10213,76,56,36,76,10457,788,11398,95,65,34,83,11675
E02006868,Park Hill & Wybourn,Sheffield,Yorkshire and the Humber,2578,9408,456,361,356,405,10986,2290,9995,457,416,317,431,11616
E02006869,Birley,Sheffield,Yorkshire and the Humber,1986,6982,488,559,387,647,9063,1980,7408,520,546,417,616,9507
E02002183,Addingham & Ilkley Moor,Bradford,Yorkshire and the Humber,771,2821,430,536,365,565,4717,741,3198,442,516,425,643,5224
E02002184,Ilkley & Ben Rhydding,Bradford,Yorkshire and the Humber,2292,7011,754,842,669,1399,10675,2186,7859,809,868,680,1434,11650
E02002185,Burley-in-Wharfedale,Bradford,Yorkshire and the Humber,1161,3318,397,350,245,397,4707,1128,3624,353,388,260,399,5024
E02002186,Steeton & Silsden,Bradford,Yorkshire and the Humber,2340,7753,843,902,562,917,10977,2246,8491,880,935,634,920,11860
E02002187,Menston & Burley Moor,Bradford,Yorkshire and the Humber,1126,3318,373,410,261,487,4849,1199,3835,417,407,300,459,5418
E02002188,Riddlesden & East Morton,Bradford,Yorkshire and the Humber,1531,4575,455,477,263,398,6168,1439,4911,444,511,277,416,6559
E02002189,Keighley Utley,Bradford,Yorkshire and the Humber,1738,3989,320,275,183,360,5127,1766,4675,383,272,200,381,5911
E02002190,Keighley Central & East,Bradford,Yorkshire and the Humber,2990,7385,546,332,242,409,8914,3085,8518,609,382,250,396,10155
E02002191,Keighley Oakworth Road & West Lane,Bradford,Yorkshire and the Humber,2622,5901,347,250,241,300,7039,2720,6874,355,292,219,296,8036
E02002192,Crossflatts & Eldwick,Bradford,Yorkshire and the Humber,1570,5243,619,641,434,669,7606,1475,5663,704,693,495,709,8264
E02002193,Keighley South,Bradford,Yorkshire and the Humber,1377,3762,297,294,215,240,4808,1395,4303,299,324,233,233,5392
E02002194,Keighley Exley Head,Bradford,Yorkshire and the Humber,1523,4417,410,415,264,349,5855,1505,4845,392,455,265,365,6322
E02002195,Baildon North,Bradford,Yorkshire and the Humber,1098,3564,430,512,292,410,5208,1005,3893,442,552,344,452,5683
E02002196,Oakworth & Laycock,Bradford,Yorkshire and the Humber,1221,3983,377,329,181,242,5112,1250,4193,367,370,197,265,5392
E02002197,Bingley Town,Bradford,Yorkshire and the Humber,1538,5539,450,490,288,589,7356,1558,5811,426,485,320,589,7631
E02002198,Baildon South,Bradford,Yorkshire and the Humber,1422,4797,541,474,319,486,6617,1492,5224,508,555,338,527,7152
E02002199,Thackley & Esholt,Bradford,Yorkshire and the Humber,1112,4289,386,396,260,331,5662,1180,4643,426,387,262,378,6096
E02002200,Saltaire & Baildon West,Bradford,Yorkshire and the Humber,1614,5311,513,479,359,559,7221,1628,5827,518,539,384,598,7866
E02002201,Idle,Bradford,Yorkshire and the Humber,2447,7720,609,577,314,500,9720,2419,8219,652,594,376,505,10346
E02002202,Shipley Town,Bradford,Yorkshire and the Humber,1247,5037,298,249,213,332,6129,1257,5266,308,318,211,333,6436
E02002203,Windhill,Bradford,Yorkshire and the Humber,1685,4724,390,332,198,298,5942,1644,5240,407,361,211,269,6488
E02002204,"Cottingley, Harden & Wilsden",Bradford,Yorkshire and the Humber,1987,6686,776,792,545,749,9548,1933,7177,746,840,519,775,10057
E02002205,Haworth & Oxenhope,Bradford,Yorkshire and the Humber,1611,6128,671,709,360,443,8311,1485,6263,683,718,390,495,8549
E02002206,Wrose & Bolton Woods,Bradford,Yorkshire and the Humber,1809,5176,456,355,317,443,6747,1838,5685,458,390,300,430,7263
E02002207,Frizinghall & Heaton Grove,Bradford,Yorkshire and the Humber,1979,4780,257,198,131,263,5629,2014,5663,293,234,132,261,6583
E02002208,Eccleshill,Bradford,Yorkshire and the Humber,1855,4799,381,337,257,412,6186,1937,5460,360,370,259,398,6847
E02002209,Ravenscliffe,Bradford,Yorkshire and the Humber,2196,4145,218,196,99,162,4820,2174,4793,231,200,109,132,5465
E02002210,Bolton Road & Kings Road,Bradford,Yorkshire and the Humber,1863,4783,334,288,221,301,5927,1880,5259,348,334,194,382,6517
E02002211,Heaton Highgate,Bradford,Yorkshire and the Humber,1891,4588,296,195,148,237,5464,1961,5522,305,243,152,245,6467
E02002212,Chellow Heights,Bradford,Yorkshire and the Humber,2655,5028,201,131,102,257,5719,3030,6252,228,137,98,226,6941
E02002213,Cullingworth & Denholme,Bradford,Yorkshire and the Humber,1385,4468,454,431,277,329,5959,1396,4789,499,463,319,347,6417
E02002214,Haigh Fold,Bradford,Yorkshire and the Humber,1482,3750,264,209,131,243,4597,1630,4237,292,235,153,239,5156
E02002215,Toller Lane & Infirmary,Bradford,Yorkshire and the Humber,2732,6772,374,172,147,263,7728,2941,7950,431,211,136,258,8986
E02002216,Manningham & Lister Park,Bradford,Yorkshire and the Humber,2371,6110,343,201,120,223,6997,2716,7526,386,243,138,286,8579
E02002217,Undercliffe,Bradford,Yorkshire and the Humber,3060,6153,301,188,138,273,7053,3045,7090,326,243,146,280,8085
E02002218,Allerton,Bradford,Yorkshire and the Humber,2731,6004,363,408,226,323,7324,2744,6639,378,418,229,362,8026
E02002219,Girlington,Bradford,Yorkshire and the Humber,2569,5126,213,116,79,153,5687,2817,6299,237,139,91,161,6927
E02002220,Thornbury,Bradford,Yorkshire and the Humber,2833,5680,236,160,112,151,6339,3021,7148,325,201,85,176,7935
E02002221,Central Bradford & Barkerend West,Bradford,Yorkshire and the Humber,4377,11167,297,154,135,223,11976,4553,13637,369,212,129,244,14591
E02002222,Fairweather Green,Bradford,Yorkshire and the Humber,2577,5275,270,235,184,340,6304,2633,5921,332,278,179,368,7078
E02002223,Brown Royd,Bradford,Yorkshire and the Humber,2277,5115,235,121,80,138,5689,2613,6510,253,165,91,149,7168
E02002224,Barkerend East,Bradford,Yorkshire and the Humber,3467,6626,229,122,127,208,7312,3536,8205,287,182,110,257,9041
E02002225,Thornton,Bradford,Yorkshire and the Humber,1600,5048,504,419,311,373,6655,1722,5634,503,484,287,378,7286
E02002226,Shearbridge & University,Bradford,Yorkshire and the Humber,3485,10779,295,139,155,253,11621,3870,16027,367,217,130,308,17049
E02002227,Broomfields & East Bowling,Bradford,Yorkshire and the Humber,1824,4241,159,140,95,146,4781,1858,4976,218,137,98,124,5553
E02002228,Laisterdyke & Bowling,Bradford,Yorkshire and the Humber,2138,4687,268,252,140,256,5603,2074,5198,295,254,153,222,6122
E02002229,Clayton,Bradford,Yorkshire and the Humber,1662,4718,402,322,254,340,6036,1627,5257,443,407,254,363,6724
E02002230,Holme Top,Bradford,Yorkshire and the Humber,2787,6272,280,112,72,157,6893,2715,7222,258,162,90,154,7886
E02002231,Scholemoor,Bradford,Yorkshire and the Humber,3432,8148,520,379,290,408,9745,3417,9118,576,456,259,441,10850
E02002232,Great Horton & Brackenhill,Bradford,Yorkshire and the Humber,2119,4506,249,185,126,238,5304,2316,5327,261,210,118,222,6138
E02002233,Canterbury,Bradford,Yorkshire and the Humber,3363,5766,216,148,121,179,6430,3324,7029,273,175,116,151,7744
E02002234,Holme Wood,Bradford,Yorkshire and the Humber,2559,4821,256,215,162,207,5661,2471,5405,296,223,152,204,6280
E02002235,Bowling Park,Bradford,Yorkshire and the Humber,2251,4615,234,181,121,175,5326,2154,5306,252,180,109,177,6024
E02002236,Wibsey St Enoch's,Bradford,Yorkshire and the Humber,1493,3705,254,271,143,320,4693,1547,4172,302,270,179,310,5233
E02002237,Horton Bank,Bradford,Yorkshire and the Humber,2280,5236,318,302,192,353,6401,2276,5686,368,320,193,347,6914
E02002238,Bankfoot,Bradford,Yorkshire and the Humber,1593,3824,279,230,150,226,4709,1631,4269,281,262,159,222,5193
E02002239,Bierley & Tong,Bradford,Yorkshire and the Humber,2731,7014,425,427,203,319,8388,2646,7508,464,420,238,317,8947
E02002240,Queensbury,Bradford,Yorkshire and the Humber,2116,7040,610,495,328,426,8899,2188,7711,615,589,347,474,9736
E02002241,Buttershaw,Bradford,Yorkshire and the Humber,2987,7274,594,455,319,505,9147,3065,8250,558,537,320,472,10137
E02002242,Low Moor,Bradford,Yorkshire and the Humber,1390,4766,479,455,312,441,6453,1424,5072,513,495,332,486,6898
E02002243,Wyke,Bradford,Yorkshire and the Humber,1971,5688,474,521,310,400,7393,2009,6328,512,542,354,420,8156
E02002244,Illingworth & Ogden,Calderdale,Yorkshire and the Humber,1128,3652,395,417,285,341,5090,1120,4084,365,402,277,320,5448
E02002245,Mixenden,Calderdale,Yorkshire and the Humber,1343,3341,249,231,123,141,4085,1439,3668,222,235,144,146,4415
E02002246,Northowram & Shelf,Calderdale,Yorkshire and the Humber,1545,5723,650,611,438,614,8036,1545,6151,639,654,485,585,8514
E02002247,Hebden Bridge,Calderdale,Yorkshire and the Humber,1570,5784,637,585,300,367,7673,1474,6278,637,621,326,367,8229
E02002248,Wheatley & Ovenden West,Calderdale,Yorkshire and the Humber,1703,4935,363,350,234,242,6124,1775,5500,361,401,241,284,6787
E02002249,Ovenden East,Calderdale,Yorkshire and the Humber,1331,3554,208,236,146,155,4299,1479,4038,230,240,164,199,4871
E02002250,Mytholmroyd & Cragg Vale,Calderdale,Yorkshire and the Humber,1436,5177,592,570,356,430,7125,1404,5640,550,566,374,468,7598
E02002251,Central Halifax & Boothtown,Calderdale,Yorkshire and the Humber,1412,5828,398,359,254,478,7317,1464,6247,415,383,266,429,7740
E02002252,Norton Tower & Mount Tabor,Calderdale,Yorkshire and the Humber,1437,3953,392,396,256,353,5350,1407,4250,368,391,283,361,5653
E02002253,Pellon West & Highroad Well,Calderdale,Yorkshire and the Humber,2568,5376,249,186,153,305,6269,2641,5936,263,198,162,216,6775
E02002254,Hipperholme,Calderdale,Yorkshire and the Humber,1116,3777,374,384,249,382,5166,1098,3964,385,398,278,398,5423
E02002255,Pellon East,Calderdale,Yorkshire and the Humber,2215,5067,235,139,127,306,5874,2344,6291,281,183,153,381,7289
E02002256,Todmorden West & Cornholme,Calderdale,Yorkshire and the Humber,1856,5852,541,534,333,438,7698,1874,6199,557,561,379,420,8116
E02002257,King Cross,Calderdale,Yorkshire and the Humber,1919,4382,178,112,117,123,4912,1995,4885,231,138,98,130,5482
E02002258,Clifton & Bailiff Bridge,Calderdale,Yorkshire and the Humber,1647,5792,538,467,318,456,7571,1603,5723,506,508,346,452,7535
E02002259,Savile Park,Calderdale,Yorkshire and the Humber,1418,4321,349,360,230,443,5703,1409,4702,374,359,246,451,6132
E02002260,Sowerby Bridge,Calderdale,Yorkshire and the Humber,1610,5974,561,521,323,380,7759,1548,6004,484,546,342,370,7746
E02002261,Southowram & Siddal,Calderdale,Yorkshire and the Humber,1561,5135,460,447,281,420,6743,1544,5439,452,449,298,357,6995
E02002262,Brighouse,Calderdale,Yorkshire and the Humber,1248,4892,411,503,382,515,6703,1191,4950,417,488,373,556,6784
E02002263,Sowerby & Luddendenfoot,Calderdale,Yorkshire and the Humber,1259,3941,431,412,228,239,5251,1307,4415,417,389,245,249,5715
E02002264,Skircoat Green,Calderdale,Yorkshire and the Humber,1295,4154,368,416,357,495,5790,1282,4369,376,437,342,495,6019
E02002265,Todmorden East & Walsden,Calderdale,Yorkshire and the Humber,960,3490,368,352,223,311,4744,956,3613,352,384,229,298,4876
E02002266,Rastrick East,Calderdale,Yorkshire and the Humber,901,3463,363,394,299,367,4886,923,3655,351,379,317,364,5066
E02002267,Rastrick West,Calderdale,Yorkshire and the Humber,1429,4799,473,534,330,369,6505,1401,5124,467,532,362,410,6895
E02002268,Elland,Calderdale,Yorkshire and the Humber,2067,6541,503,546,381,587,8558,2006,6739,520,544,397,574,8774
E02002269,Greetland & Stainland,Calderdale,Yorkshire and the Humber,1750,5898,585,552,348,389,7772,1712,6127,562,576,390,407,8062
E02002270,"Ripponden, Rishworth & Barkisland",Calderdale,Yorkshire and the Humber,1670,5505,499,478,313,263,7058,1583,5775,535,484,359,340,7493
E02002271,Birkenshaw,Kirklees,Yorkshire and the Humber,1410,4291,366,411,299,506,5873,1412,4622,377,454,314,485,6252
E02002272,Birstall,Kirklees,Yorkshire and the Humber,1971,5911,481,540,362,424,7718,2003,6315,462,534,361,441,8113
E02002273,Scholes & Hunsworth,Kirklees,Yorkshire and the Humber,1247,4160,381,388,270,347,5546,1120,4100,367,399,263,336,5465
E02002274,Gomersal,Kirklees,Yorkshire and the Humber,1442,4344,382,429,274,389,5818,1308,4362,376,373,275,364,5750
E02002275,Cleckheaton,Kirklees,Yorkshire and the Humber,1549,5315,450,468,330,490,7053,1608,5753,439,496,337,510,7535
E02002276,"Wilton Park, Carlinghow & Brookroyd",Kirklees,Yorkshire and the Humber,1614,4441,399,431,279,386,5936,1694,4889,365,406,290,286,6236
E02002277,Upper Batley & Soothill,Kirklees,Yorkshire and the Humber,1603,4234,258,290,212,301,5295,1503,4519,252,281,209,303,5564
E02002278,Hightown & Hartshead Moor,Kirklees,Yorkshire and the Humber,1433,4066,365,414,234,289,5368,1379,4242,340,401,280,271,5534
E02002279,"Liversedge, Littletown & Millbridge",Kirklees,Yorkshire and the Humber,1235,3849,329,312,238,280,5008,1282,4151,330,330,213,275,5299
E02002280,Batley Central,Kirklees,Yorkshire and the Humber,1790,4319,289,209,171,218,5206,1613,4605,290,222,148,182,5447
E02002281,Heckmondwike North,Kirklees,Yorkshire and the Humber,2678,7109,539,490,333,560,9031,2732,7615,514,503,347,525,9504
E02002282,Staincliffe & Healey,Kirklees,Yorkshire and the Humber,2025,4788,280,214,154,204,5640,1958,5145,273,218,148,193,5977
E02002283,Batley Carr & Mount Pleasant,Kirklees,Yorkshire and the Humber,1670,5046,287,222,167,193,5915,1612,5350,361,235,131,183,6260
E02002284,Shaw Cross & Hanging Heaton,Kirklees,Yorkshire and the Humber,1120,3766,364,320,221,342,5013,1146,3957,337,302,235,314,5145
E02002285,"Heckmondwike Town, Norristhorpe & Roberttown",Kirklees,Yorkshire and the Humber,1457,4886,517,515,319,468,6705,1409,5083,457,508,346,447,6841
E02002286,Dewsbury Moor Upper,Kirklees,Yorkshire and the Humber,1701,4108,265,211,122,174,4880,1681,4375,274,229,107,178,5163
E02002287,Dewsbury Central & Westborough,Kirklees,Yorkshire and the Humber,1697,4886,271,223,131,255,5766,1692,5304,255,203,149,248,6159
E02002288,Earlsheaton & Chickenley,Kirklees,Yorkshire and the Humber,2187,6068,425,436,272,425,7626,2251,6661,441,420,282,408,8212
E02002289,Dewsbury Moor Lower & Westtown,Kirklees,Yorkshire and the Humber,2107,4378,182,125,101,119,4905,2135,5012,192,156,100,154,5614
E02002290,Northorpe & Crossley,Kirklees,Yorkshire and the Humber,1116,3630,391,489,342,419,5271,1055,3729,396,439,370,439,5373
E02002291,Battyeford,Kirklees,Yorkshire and the Humber,1275,3814,390,482,291,352,5329,1222,4074,376,403,338,354,5545
E02002292,Bradley & North Fixby,Kirklees,Yorkshire and the Humber,1032,3437,395,303,239,346,4720,936,3476,390,336,233,333,4768
E02002293,Ravensthorpe,Kirklees,Yorkshire and the Humber,2831,5739,244,154,122,162,6421,2787,6680,244,189,108,154,7375
E02002294,Dewsbury Savile Town & Thornhill Lees,Kirklees,Yorkshire and the Humber,2853,7001,436,265,190,260,8152,2755,7940,467,289,215,301,9212
E02002295,Deighton & Brackenhall,Kirklees,Yorkshire and the Humber,1958,4512,266,225,181,197,5381,2016,5014,277,215,179,213,5898
E02002296,Mirfield Central & Hopton,Kirklees,Yorkshire and the Humber,1143,4055,336,509,318,591,5809,1078,4172,378,470,377,553,5950
E02002297,Cowcliffe & South Fixby,Kirklees,Yorkshire and the Humber,1284,4118,377,452,236,396,5579,1304,4570,415,424,276,366,6051
E02002298,Thornhill,Kirklees,Yorkshire and the Humber,1245,4055,400,396,269,380,5500,1233,4302,404,398,253,380,5737
E02002299,Huddersfield Leeds Road & Fartown,Kirklees,Yorkshire and the Humber,1732,5179,178,145,129,206,5837,1773,6300,210,161,122,226,7019
E02002300,North Lindley & Birchencliffe,Kirklees,Yorkshire and the Humber,1620,4697,439,413,349,539,6437,1694,5141,428,419,354,547,6889
E02002301,Birkby,Kirklees,Yorkshire and the Humber,2168,5531,254,153,141,229,6308,2334,6333,281,167,115,242,7138
E02002302,Kirkheaton,Kirklees,Yorkshire and the Humber,1150,3813,342,426,256,291,5128,1146,3893,339,436,265,349,5282
E02002303,Oakes & South Lindley,Kirklees,Yorkshire and the Humber,1227,4035,309,326,235,463,5368,1314,4341,326,322,235,394,5618
E02002304,Edgerton & Marsh,Kirklees,Yorkshire and the Humber,1026,4916,281,221,181,278,5877,1029,5408,274,256,198,284,6420
E02002305,Rawthorpe,Kirklees,Yorkshire and the Humber,1379,4030,266,196,143,238,4873,1357,4293,260,209,149,241,5152
E02002306,"Scapegoat Hill, Outlane & West Golcar",Kirklees,Yorkshire and the Humber,1000,3805,400,370,221,326,5122,1020,4059,400,372,247,348,5426
E02002307,Dalton Long Lane,Kirklees,Yorkshire and the Humber,1041,3633,327,345,233,325,4863,1094,3768,306,311,239,304,4928
E02002308,Longwood & Quarmby,Kirklees,Yorkshire and the Humber,1195,4084,347,299,232,293,5255,1237,4343,333,301,231,276,5484
E02002309,Paddock & Greenhead,Kirklees,Yorkshire and the Humber,1469,4661,248,252,128,304,5593,1478,5177,262,237,178,258,6112
E02002310,Moldgreen & Ravensknowle Park,Kirklees,Yorkshire and the Humber,1084,3792,299,314,193,306,4904,1081,3886,271,282,206,318,4963
E02002311,Golcar,Kirklees,Yorkshire and the Humber,1321,4066,361,345,169,280,5221,1268,4204,362,369,210,282,5427
E02002312,"Aspley, Longley & University",Kirklees,Yorkshire and the Humber,1314,8856,252,195,147,189,9639,1295,9523,276,207,155,202,10363
E02002313,Lockwood,Kirklees,Yorkshire and the Humber,2309,5392,186,150,138,176,6042,2235,6230,249,158,140,215,6992
E02002314,Almondbury & Waterloo,Kirklees,Yorkshire and the Humber,1029,3432,336,376,291,437,4872,1039,3495,353,386,310,431,4975
E02002315,Cowlersley & Milnsbridge,Kirklees,Yorkshire and the Humber,1350,4555,280,261,155,228,5479,1240,4507,289,282,163,213,5454
E02002316,"Lepton, Grange Moor & Flockton",Kirklees,Yorkshire and the Humber,1146,3733,433,494,298,401,5359,1076,4083,370,494,302,425,5674
E02002317,Crosland Moor,Kirklees,Yorkshire and the Humber,1933,4422,295,239,253,340,5549,1850,4868,341,269,212,323,6013
E02002318,"Primrose Hill, Newsome & Berry Brow",Kirklees,Yorkshire and the Humber,1094,3922,359,394,283,353,5311,1092,4152,309,415,261,362,5499
E02002319,Slaithwaite & Linthwaite,Kirklees,Yorkshire and the Humber,1352,4209,362,321,224,317,5433,1331,4572,345,359,235,304,5815
E02002320,Netherton & South Crosland,Kirklees,Yorkshire and the Humber,933,3605,485,442,286,422,5240,900,3737,431,461,323,436,5388
E02002321,Kirkburton & Farnley Tyas,Kirklees,Yorkshire and the Humber,1102,4382,445,444,268,316,5855,1061,4815,450,457,315,337,6374
E02002322,Marsden & Pole Moor,Kirklees,Yorkshire and the Humber,1122,3918,442,417,251,279,5307,1147,4058,416,442,281,310,5507
E02002323,Honley & Brockholes,Kirklees,Yorkshire and the Humber,1528,4905,548,579,385,512,6929,1394,4998,496,619,396,521,7030
E02002324,Emley & Skelmanthorpe,Kirklees,Yorkshire and the Humber,1155,3857,438,538,355,383,5571,1106,3988,422,539,386,391,5726
E02002325,Meltham,Kirklees,Yorkshire and the Humber,1678,5232,520,620,382,520,7274,1615,5599,500,608,391,529,7627
E02002326,Shelley & Shepley,Kirklees,Yorkshire and the Humber,1214,3695,348,435,253,313,5044,1109,3857,364,395,302,293,5211
E02002327,"Denby Dale, Cumberworth & Clayton West",Kirklees,Yorkshire and the Humber,1864,5806,635,663,437,585,8126,1696,6021,628,659,493,615,8416
E02002328,Upperthong & Holmbridge,Kirklees,Yorkshire and the Humber,1178,4193,514,450,313,428,5898,1151,4519,491,474,340,431,6255
E02002329,"Holmfirth, New Mill & Hepworth",Kirklees,Yorkshire and the Humber,2272,7350,863,812,440,486,9951,2130,7965,802,854,540,479,10640
E02002330,Wetherby West,Leeds,Yorkshire and the Humber,1050,3520,476,629,385,512,5522,1110,4130,511,607,468,537,6253
E02002331,Wetherby East & Thorp Arch,Leeds,Yorkshire and the Humber,989,4159,369,461,356,695,6040,1030,5060,397,464,407,737,7065
E02002332,Otley North,Leeds,Yorkshire and the Humber,1136,3482,445,407,293,380,5007,1238,4073,414,445,325,384,5641
E02002333,Otley South,Leeds,Yorkshire and the Humber,1206,4408,538,531,390,564,6431,1213,4919,541,590,394,583,7027
E02002334,Boston Spa & Bramham,Leeds,Yorkshire and the Humber,1352,3800,449,554,413,542,5758,1409,4422,476,539,465,557,6459
E02002335,"Collingham, Rigton & Harewood",Leeds,Yorkshire and the Humber,1339,4193,500,569,394,505,6161,1327,4637,512,573,458,560,6740
E02002336,Bramhope & Pool-in-Wharfedale,Leeds,Yorkshire and the Humber,1263,3710,385,453,293,492,5333,1288,4277,394,479,351,522,6023
E02002337,Guiseley North & West,Leeds,Yorkshire and the Humber,1429,4490,359,450,250,410,5959,1418,4824,415,493,312,433,6477
E02002338,Guiseley East & South,Leeds,Yorkshire and the Humber,1370,3974,344,399,291,439,5447,1434,4486,383,437,306,469,6081
E02002339,Yeadon West,Leeds,Yorkshire and the Humber,1030,3284,311,274,183,269,4321,1054,3659,307,316,206,321,4809
E02002340,Yeadon East,Leeds,Yorkshire and the Humber,928,3220,376,387,280,363,4626,899,3636,405,425,302,416,5184
E02002341,Alwoodley,Leeds,Yorkshire and the Humber,1413,3963,480,479,316,567,5805,1509,4530,466,498,357,571,6422
E02002342,Cookridge & Holt Park,Leeds,Yorkshire and the Humber,1049,3113,339,378,244,456,4530,1093,3688,360,385,268,446,5147
E02002343,Yeadon South,Leeds,Yorkshire and the Humber,1159,3482,332,286,184,274,4558,1155,3937,324,338,225,269,5093
E02002344,Primley Park & Wigton Moor,Leeds,Yorkshire and the Humber,1395,4416,454,448,304,549,6171,1555,5154,406,510,318,589,6977
E02002345,Adel,Leeds,Yorkshire and the Humber,1079,3145,389,392,225,405,4556,1144,3870,395,418,242,399,5324
E02002346,Tinshill,Leeds,Yorkshire and the Humber,1197,3609,294,288,166,288,4645,1284,4181,303,299,188,308,5279
E02002347,Moor Allerton,Leeds,Yorkshire and the Humber,1560,3729,278,292,136,283,4718,1624,4311,295,275,159,272,5312
E02002348,Lawnswood & Ireland Wood,Leeds,Yorkshire and the Humber,1254,3767,332,286,199,378,4962,1293,4303,358,333,214,384,5592
E02002349,Roundhay Park & Slaid Hill,Leeds,Yorkshire and the Humber,1074,3589,305,283,175,326,4678,1164,4128,317,310,223,334,5312
E02002350,Horsforth West,Leeds,Yorkshire and the Humber,1170,3410,305,370,295,484,4864,1223,3978,282,374,315,510,5459
E02002351,"Scarcroft, Shadwell & Scholes",Leeds,Yorkshire and the Humber,900,3012,380,367,277,410,4446,1004,3422,355,401,289,429,4896
E02002352,Moortown,Leeds,Yorkshire and the Humber,1438,4627,444,334,236,337,5978,1546,5357,419,383,288,434,6881
E02002353,Roundhay West,Leeds,Yorkshire and the Humber,1323,3707,297,218,120,274,4616,1382,4387,335,260,162,221,5365
E02002354,Carr Manor,Leeds,Yorkshire and the Humber,1568,4757,363,309,273,432,6134,1742,5647,399,346,261,458,7111
E02002356,Horsforth South & Rawdon,Leeds,Yorkshire and the Humber,1779,5081,394,424,266,380,6545,1966,5927,409,467,303,426,7532
E02002357,Horsforth East,Leeds,Yorkshire and the Humber,1560,4936,368,376,228,447,6355,1639,5423,372,389,259,425,6868
E02002358,Whinmoor,Leeds,Yorkshire and the Humber,1623,4632,463,423,308,352,6178,1794,5432,498,480,276,397,7083
E02002359,"Aberford, Barwick & Thorner",Leeds,Yorkshire and the Humber,1081,3719,391,457,333,468,5368,1064,4038,397,461,359,485,5740
E02002360,Meanwood,Leeds,Yorkshire and the Humber,1320,4403,274,226,162,311,5376,1301,4874,273,252,190,304,5893
E02002361,Gledhow,Leeds,Yorkshire and the Humber,1318,3669,292,192,121,294,4568,1377,4252,272,226,128,241,5119
E02002362,Hawksworth & West Park,Leeds,Yorkshire and the Humber,1628,5013,335,275,192,301,6116,1634,5823,335,303,195,270,6926
E02002363,Chapel Allerton North,Leeds,Yorkshire and the Humber,886,4825,272,244,151,340,5832,1001,5648,323,303,206,311,6791
E02002364,Seacroft North & Monkswood,Leeds,Yorkshire and the Humber,1192,3537,267,230,161,321,4516,1276,4160,297,290,148,351,5246
E02002366,Lady Wood & Oakwood,Leeds,Yorkshire and the Humber,1754,4848,355,346,254,510,6313,1959,5821,368,374,287,507,7357
E02002367,Meanwood South & Sugarwell,Leeds,Yorkshire and the Humber,1554,3928,196,172,120,203,4619,1575,5013,204,215,128,233,5793
E02002368,Calverley & Farsley North,Leeds,Yorkshire and the Humber,1732,4988,425,449,295,392,6549,1768,5566,430,466,314,438,7214
E02002369,Hollin Park & Fearnville,Leeds,Yorkshire and the Humber,1855,4517,268,244,179,282,5490,1991,5564,295,249,207,257,6572
E02002370,Swarcliffe,Leeds,Yorkshire and the Humber,1795,4246,285,303,155,268,5257,1871,4713,278,293,204,271,5759
E02002371,Chapel Allerton South & Chapeltown,Leeds,Yorkshire and the Humber,2397,6797,330,180,213,298,7818,2551,8853,413,263,202,411,10142
E02002373,Headingley,Leeds,Yorkshire and the Humber,346,8736,113,114,67,143,9173,346,7225,138,118,81,126,7688
E02002374,Kirkstall,Leeds,Yorkshire and the Humber,1067,4876,280,228,157,227,5768,1273,6005,269,245,162,216,6897
E02002375,Bramley Fall,Leeds,Yorkshire and the Humber,1399,4219,252,155,109,137,4872,1537,5050,271,193,108,146,5768
E02002376,Gipton North,Leeds,Yorkshire and the Humber,2418,4777,160,147,116,170,5370,2447,6057,196,171,119,222,6765
E02002377,Harehills North,Leeds,Yorkshire and the Humber,2335,5023,174,102,96,133,5528,2689,7581,224,152,83,151,8191
E02002379,Seacroft South,Leeds,Yorkshire and the Humber,1629,3316,183,178,118,134,3929,1702,4203,190,186,106,136,4821
E02002380,Bramley Park North,Leeds,Yorkshire and the Humber,848,3276,305,259,176,297,4313,945,3753,318,307,179,288,4845
E02002381,Rodley & Stanningley Park,Leeds,Yorkshire and the Humber,1030,4095,313,238,160,215,5021,1120,4343,305,301,153,234,5336
E02002382,Harehills South,Leeds,Yorkshire and the Humber,3024,5210,116,78,61,90,5555,3472,7293,161,86,71,145,7756
E02002383,Hyde Park,Leeds,Yorkshire and the Humber,495,7763,86,51,37,35,7972,485,6915,79,59,31,43,7127
E02002384,Woodhouse & Little London,Leeds,Yorkshire and the Humber,2169,10430,227,180,88,160,11085,2616,16227,243,195,127,169,16961
E02002385,Burley,Leeds,Yorkshire and the Humber,873,7405,155,121,95,108,7884,862,8517,153,136,82,133,9021
E02002386,Cross Gates East & Manston,Leeds,Yorkshire and the Humber,1364,4924,563,595,446,647,7175,1400,5569,572,651,478,740,8010
E02002387,Bramley Park South,Leeds,Yorkshire and the Humber,1209,3726,193,199,151,220,4489,1305,4345,232,213,155,216,5161
E02002388,Bramley East,Leeds,Yorkshire and the Humber,1716,4981,257,264,130,268,5900,1864,5829,272,271,152,275,6799
E02002389,Gipton South & Killingbeck Park,Leeds,Yorkshire and the Humber,1949,4303,273,240,192,317,5325,2106,5129,290,272,180,270,6141
E02002390,Cross Gates West & Killingbeck,Leeds,Yorkshire and the Humber,1252,4066,303,268,186,270,5093,1298,4736,325,289,188,257,5795
E02002391,"Farsley South, Stanningley & Pudsey North West",Leeds,Yorkshire and the Humber,1379,4846,340,306,207,334,6033,1410,5369,407,398,235,346,6755
E02002392,University & Little Woodhouse,Leeds,Yorkshire and the Humber,585,10640,87,65,39,52,10883,643,14719,90,69,36,59,14973
E02002393,Lincoln Green & St James,Leeds,Yorkshire and the Humber,2502,6186,174,139,88,143,6730,2749,7799,231,166,102,170,8468
E02002394,Burmantofts,Leeds,Yorkshire and the Humber,2515,5130,201,192,131,152,5806,2569,6340,214,189,133,141,7017
E02002395,New Pudsey,Leeds,Yorkshire and the Humber,1485,4192,305,271,221,368,5357,1673,4787,351,313,210,373,6034
E02002396,Bramley South & Upper Armley,Leeds,Yorkshire and the Humber,1513,5944,362,335,236,385,7262,1592,6618,391,382,229,399,8019
E02002397,Pudsey North East,Leeds,Yorkshire and the Humber,1473,4699,377,375,242,328,6021,1478,5173,388,379,253,351,6544
E02002398,Temple Newsam & Graveleythorpe,Leeds,Yorkshire and the Humber,1112,4211,451,468,374,562,6066,1117,4761,457,477,364,605,6664
E02002399,Osmondthorpe & Neville Hill,Leeds,Yorkshire and the Humber,1493,3836,250,211,128,203,4628,1647,4583,270,246,122,193,5414
E02002400,Armley & New Wortley,Leeds,Yorkshire and the Humber,1909,6105,245,219,132,199,6900,2031,8236,255,206,150,218,9065
E02002401,Halton Moor,Leeds,Yorkshire and the Humber,1887,3879,253,214,156,181,4683,1982,4612,246,243,146,200,5447
E02002402,"Colton, Austhorpe & Whitkirk",Leeds,Yorkshire and the Humber,843,3469,291,317,209,298,4584,890,3930,311,335,241,405,5222
E02002403,Garforth West,Leeds,Yorkshire and the Humber,951,3513,327,414,280,500,5034,948,3944,289,444,336,574,5587
E02002404,East End Park & Richmond Hill,Leeds,Yorkshire and the Humber,1997,8046,256,237,139,133,8811,2030,8261,304,223,145,178,9111
E02002405,Pudsey South West,Leeds,Yorkshire and the Humber,1884,5152,403,407,319,538,6819,1935,5797,438,400,349,545,7529
E02002406,Garforth East,Leeds,Yorkshire and the Humber,1212,3907,440,524,364,422,5657,1270,4543,401,550,425,430,6349
E02002407,Farnley East,Leeds,Yorkshire and the Humber,1616,4103,200,176,158,234,4871,1643,4612,227,189,148,224,5400
E02002408,Pudsey South East,Leeds,Yorkshire and the Humber,1349,4489,386,382,236,370,5863,1384,5070,402,380,293,409,6554
E02002409,Farnley West & Gamble Hill,Leeds,Yorkshire and the Humber,1185,3669,280,267,207,277,4700,1270,4320,302,299,201,287,5409
E02002410,Wortley,Leeds,Yorkshire and the Humber,1192,4300,336,295,217,311,5459,1209,4818,353,324,231,338,6064
E02002411,Holbeck,Leeds,Yorkshire and the Humber,1865,6285,198,181,98,188,6950,2008,7297,205,174,87,197,7960
E02002412,New Farnley & Lower Wortley,Leeds,Yorkshire and the Humber,1399,4488,313,298,209,297,5605,1452,5096,318,316,202,288,6220
E02002414,Beeston Hill & Hunslet Moor,Leeds,Yorkshire and the Humber,1802,4308,164,195,133,215,5015,1875,5320,207,177,127,183,6014
E02002415,Cross Flats Park & Garnets,Leeds,Yorkshire and the Humber,2106,5049,171,80,67,85,5452,2428,7431,208,97,52,90,7878
E02002416,"Garforth South, Swillington & Little Preston",Leeds,Yorkshire and the Humber,1188,3817,382,527,387,483,5596,1215,4190,384,479,438,510,6001
E02002417,"Kippax East, Micklefield & Allerton Bywater",Leeds,Yorkshire and the Humber,1279,3964,358,422,294,354,5392,1377,4392,365,415,328,403,5903
E02002418,Kippax West,Leeds,Yorkshire and the Humber,1277,4271,394,413,277,271,5626,1302,4650,388,416,299,305,6058
E02002419,Beeston West & Cottingley,Leeds,Yorkshire and the Humber,2007,5179,298,287,172,310,6246,1966,5955,351,303,193,291,7093
E02002420,Beeston East,Leeds,Yorkshire and the Humber,2014,5412,307,289,212,314,6534,2124,6419,324,296,226,325,7590
E02002421,Belle Isle North,Leeds,Yorkshire and the Humber,1522,3759,244,184,137,195,4519,1630,4566,243,214,119,214,5356
E02002422,Churwell,Leeds,Yorkshire and the Humber,1068,3793,368,343,245,307,5056,1093,4175,317,393,264,346,5495
E02002423,Belle Isle South,Leeds,Yorkshire and the Humber,1311,3501,305,223,169,211,4409,1367,4041,302,269,178,229,5019
E02002424,Morley North & Gildersome East,Leeds,Yorkshire and the Humber,1414,4802,345,405,223,333,6108,1440,5106,352,407,267,359,6491
E02002425,Drighlington & Gildersome West,Leeds,Yorkshire and the Humber,1511,4955,471,533,380,492,6831,1533,5479,498,571,411,510,7469
E02002426,Woodlesford & Oulton,Leeds,Yorkshire and the Humber,1439,4575,406,420,302,510,6213,1416,5021,411,402,331,517,6682
E02002427,Rothwell Inner,Leeds,Yorkshire and the Humber,1270,3921,378,404,324,419,5446,1247,4363,352,416,323,427,5881
E02002428,Middleton Town Street,Leeds,Yorkshire and the Humber,1794,4991,345,263,212,283,6094,1786,5556,354,295,204,269,6678
E02002429,Rothwell Outer,Leeds,Yorkshire and the Humber,1588,5107,423,447,319,401,6697,1701,5621,434,423,372,419,7269
E02002430,Middleton Park Avenue,Leeds,Yorkshire and the Humber,2167,4664,239,249,175,208,5535,2361,5633,242,247,166,229,6517
E02002431,Morley East,Leeds,Yorkshire and the Humber,1670,5501,331,333,190,239,6594,1727,6197,350,357,202,218,7324
E02002432,Methley,Leeds,Yorkshire and the Humber,1417,4355,370,411,259,356,5751,1407,4916,335,401,337,413,6402
E02002433,Morley Central,Leeds,Yorkshire and the Humber,1026,4232,318,303,222,334,5409,992,4703,319,355,224,321,5922
E02002434,"Robin Hood, Lofthouse & Middleton Lane",Leeds,Yorkshire and the Humber,2437,6639,304,328,166,192,7629,2312,6949,332,346,215,284,8126
E02002435,Morley Bruntcliffe & Woodkirk,Leeds,Yorkshire and the Humber,1478,4667,359,370,294,390,6080,1618,5481,377,411,312,377,6958
E02002436,Tingley East & East Ardsley,Leeds,Yorkshire and the Humber,1332,4110,312,344,223,275,5264,1341,4561,353,328,269,306,5817
E02002437,Tingley West & West Ardsley,Leeds,Yorkshire and the Humber,1094,3847,331,319,197,260,4954,1129,4285,393,353,209,270,5510
E02006852,Far Headingley & Weetwood,Leeds,Yorkshire and the Humber,1686,8302,482,428,263,459,9934,1787,9438,504,510,305,471,11228
E02006861,Hyde Park Corner & Woodhouse Cliff,Leeds,Yorkshire and the Humber,674,12650,124,148,84,213,13219,677,13560,173,139,99,274,14245
E02006875,Leeds City Centre,Leeds,Yorkshire and the Humber,227,13252,37,34,29,18,13370,334,12728,46,34,19,12,12839
E02006876,"Leeds Dock, Hunslet & Stourton",Leeds,Yorkshire and the Humber,1157,6511,230,149,157,210,7257,1293,6872,238,222,143,254,7729
E02002438,Ferry Fryston,Wakefield,Yorkshire and the Humber,2136,5194,416,383,240,315,6548,2138,5812,423,385,253,320,7193
E02002439,Castleford Town,Wakefield,Yorkshire and the Humber,1448,5537,403,383,256,425,7004,1455,6195,416,439,287,402,7739
E02002440,Airedale,Wakefield,Yorkshire and the Humber,1676,4789,447,405,279,377,6297,1641,5196,440,430,300,381,6747
E02002441,Castleford West,Wakefield,Yorkshire and the Humber,1804,5914,390,448,342,449,7543,1901,6515,397,457,392,443,8204
E02002442,Glasshoughton,Wakefield,Yorkshire and the Humber,1211,4836,389,343,215,309,6092,1195,4929,379,339,266,278,6191
E02002443,Outwood East,Wakefield,Yorkshire and the Humber,1146,4123,310,320,190,200,5143,1086,4190,342,312,226,196,5266
E02002444,"Stanley, Moorhouse & Bottomboat",Wakefield,Yorkshire and the Humber,1126,4014,362,325,237,251,5189,1210,4375,380,333,249,245,5582
E02002445,Outwood West,Wakefield,Yorkshire and the Humber,1432,4742,434,498,342,472,6488,1577,5356,420,529,350,518,7173
E02002446,Altofts,Wakefield,Yorkshire and the Humber,881,3644,354,374,294,343,5009,888,3808,360,386,306,377,5237
E02002447,Knottingley,Wakefield,Yorkshire and the Humber,1186,3847,316,346,228,352,5089,1202,4004,332,342,235,350,5263
E02002448,Ferrybridge & West Knottingley,Wakefield,Yorkshire and the Humber,1673,4905,427,374,269,413,6388,1700,5269,439,390,264,383,6745
E02002449,Pontefract North East,Wakefield,Yorkshire and the Humber,1889,5730,430,416,324,405,7305,1912,6435,442,438,335,425,8075
E02002450,Normanton East,Wakefield,Yorkshire and the Humber,1388,4681,376,372,247,275,5951,1464,5283,412,406,237,295,6633
E02002451,Wrenthorpe & Kirkhamgate,Wakefield,Yorkshire and the Humber,1250,4545,534,506,356,541,6482,1302,4867,523,552,393,476,6811
E02002452,Pontefract North West,Wakefield,Yorkshire and the Humber,1532,5551,425,419,295,372,7062,1628,6136,435,428,278,420,7697
E02002453,Normanton West,Wakefield,Yorkshire and the Humber,1907,6240,482,489,317,353,7881,2029,7141,504,509,326,392,8872
E02002454,Wakefield Central,Wakefield,Yorkshire and the Humber,1513,6076,335,237,185,357,7190,1895,7808,371,292,186,364,9021
E02002455,Pontefract South East,Wakefield,Yorkshire and the Humber,1522,3800,302,283,205,279,4869,1503,4325,304,317,200,289,5435
E02002456,Wakefield St John's,Wakefield,Yorkshire and the Humber,1422,5584,331,324,211,184,6634,1443,5849,316,304,221,219,6909
E02002457,Eastmoor,Wakefield,Yorkshire and the Humber,1785,5033,388,366,190,313,6290,1905,5822,414,371,217,304,7128
E02002458,Ossett North,Wakefield,Yorkshire and the Humber,1751,5423,573,549,359,478,7382,1620,5652,495,577,388,472,7584
E02002459,Alverthorpe & Flanshaw,Wakefield,Yorkshire and the Humber,2079,6263,425,388,257,319,7652,2212,7142,428,417,279,369,8635
E02002460,Pontefract South West,Wakefield,Yorkshire and the Humber,1176,3994,499,514,322,596,5925,1214,4510,532,531,370,621,6564
E02002461,Streethouse & Sharlston Common,Wakefield,Yorkshire and the Humber,2387,7209,542,511,383,458,9103,2354,7641,536,521,406,491,9595
E02002462,Ossett West,Wakefield,Yorkshire and the Humber,1350,4493,456,477,338,401,6165,1310,4767,474,498,345,404,6488
E02002463,Lupset,Wakefield,Yorkshire and the Humber,2736,6104,359,388,270,403,7524,2666,6825,384,373,270,375,8227
E02002464,Featherstone,Wakefield,Yorkshire and the Humber,1785,5309,448,416,321,414,6908,1853,6026,440,434,334,384,7618
E02002465,Thornes,Wakefield,Yorkshire and the Humber,820,3798,401,373,284,392,5248,851,4101,421,400,328,419,5669
E02002466,Ossett South East & Horbury Bridge,Wakefield,Yorkshire and the Humber,1713,5448,554,631,384,525,7542,1622,5681,548,599,465,537,7830
E02002467,Agbrigg & Belle Isle,Wakefield,Yorkshire and the Humber,1954,6100,325,286,145,223,7079,2020,7169,354,311,175,217,8226
E02002468,Horbury,Wakefield,Yorkshire and the Humber,1090,3729,387,412,229,389,5146,1048,3902,374,427,271,351,5325
E02002469,Crofton,Wakefield,Yorkshire and the Humber,1207,3840,380,439,293,279,5231,1185,4249,391,430,317,297,5684
E02002470,Sandal,Wakefield,Yorkshire and the Humber,876,3305,434,573,424,559,5295,846,3464,452,533,439,598,5486
E02002471,Ackworth & Darrington,Wakefield,Yorkshire and the Humber,1893,6686,711,705,512,676,9290,1949,7296,747,722,571,668,10004
E02002472,Netherton & Middlestown,Wakefield,Yorkshire and the Humber,858,3690,384,414,259,306,5053,846,3891,408,403,293,327,5322
E02002473,Durkar & Crigglestone,Wakefield,Yorkshire and the Humber,1107,3969,438,445,321,367,5540,1012,4243,493,437,330,362,5865
E02002474,Kettlethorpe & Chapelthorpe,Wakefield,Yorkshire and the Humber,1419,4127,334,324,192,317,5294,1439,4578,349,358,218,298,5801
E02002475,"Walton, Woolley & Bretton",Wakefield,Yorkshire and the Humber,1148,3623,439,443,311,407,5223,1033,3657,465,496,333,450,5401
E02002476,Kinsley & Fitzwilliam,Wakefield,Yorkshire and the Humber,1470,3926,296,276,198,266,4962,1493,4445,283,283,207,249,5467
E02002477,Ryhill & South Hiendley,Wakefield,Yorkshire and the Humber,1259,3942,412,326,246,371,5297,1229,4039,387,376,244,298,5344
E02002478,Upton,Wakefield,Yorkshire and the Humber,1322,3933,298,284,211,249,4975,1280,4275,303,292,204,225,5299
E02002479,Hemsworth Town,Wakefield,Yorkshire and the Humber,1411,5077,520,504,416,449,6966,1404,5319,547,489,441,463,7259
E02002480,Moorthorpe,Wakefield,Yorkshire and the Humber,917,3551,386,325,307,312,4881,934,3905,408,329,280,338,5260
E02002481,South Elmsall,Wakefield,Yorkshire and the Humber,1502,4559,322,311,239,380,5811,1511,5029,380,321,232,374,6336
E02002482,South Kirkby,Wakefield,Yorkshire and the Humber,1648,4348,337,344,235,297,5561,1731,4764,352,311,241,303,5971
