MSOA,MSOAn,LTLAn,RGNn,ONS_00_16,ONS_16_64,ONS_65_69,ONS_70_74,ONS_75_79,ONS_80_99,ONS_16_99,P_00_16,P_16_64,P_65_69,P_70_74,P_75_79,P_80_99,P_16_99,V_16_64,V_65_69,V_70_74,V_75_79,V_80_99,V_16_99,S_16_64,S_65_69,S_70_74,S_75_79,S_80_99,S_16_99
E02002796,Allestree North,Derby,East Midlands,1164,3312,366,461,317,427,4883,1124,3681,399,445,364,468,5357,913,390,427,352,456,2538,0.248030426514534,0.977443609022556,0.959550561797753,0.967032967032967,0.974358974358974,0.473772633936905
E02002797,Allestree South,Derby,East Midlands,1121,3860,442,559,444,912,6217,1087,4234,437,540,478,893,6582,1025,407,522,469,873,3296,0.242087860179499,0.931350114416476,0.966666666666667,0.981171548117155,0.977603583426652,0.500759647523549
E02002798,Oakwood,Derby,East Midlands,1570,6365,517,488,240,387,7997,1634,7080,570,531,323,384,8888,1770,530,508,309,371,3488,0.25,0.929824561403509,0.95668549905838,0.956656346749226,0.966145833333333,0.392439243924392
E02002799,Breadsall Hilltop,Derby,East Midlands,1390,3738,208,211,163,247,4567,1434,4367,223,227,166,252,5235,1041,197,204,157,238,1837,0.238378749713762,0.883408071748879,0.898678414096916,0.945783132530121,0.944444444444444,0.35090735434575
E02002800,Darley Abbey,Derby,East Midlands,1286,4189,370,394,278,559,5790,1208,4457,367,392,305,545,6066,985,329,375,293,520,2502,0.221000673098497,0.896457765667575,0.956632653061224,0.960655737704918,0.954128440366972,0.412462908011869
E02002801,Chaddesden North,Derby,East Midlands,1508,4419,351,394,304,497,5965,1428,4916,337,410,321,485,6469,1269,310,396,306,467,2748,0.258136696501221,0.919881305637982,0.965853658536585,0.953271028037383,0.962886597938144,0.42479517699799
E02002802,Chaddesden West,Derby,East Midlands,2028,4920,296,246,209,283,5954,2032,5808,313,271,203,265,6860,1323,257,239,183,252,2254,0.227789256198347,0.821086261980831,0.881918819188192,0.901477832512315,0.950943396226415,0.328571428571429
E02002803,Little Chester,Derby,East Midlands,857,6740,252,217,171,235,7615,818,8066,310,231,166,200,8973,988,250,205,146,181,1770,0.122489461939003,0.806451612903226,0.887445887445887,0.879518072289157,0.905,0.197258441992645
E02002804,Mackworth,Derby,East Midlands,2088,5173,349,354,240,519,6635,2081,5779,384,386,251,435,7235,1464,330,356,235,410,2795,0.253331026129088,0.859375,0.922279792746114,0.936254980079681,0.942528735632184,0.386316516931583
E02002805,Spondon North,Derby,East Midlands,823,2949,362,510,371,465,4657,845,3272,352,453,397,515,4989,872,327,437,384,498,2518,0.266503667481663,0.928977272727273,0.964679911699779,0.967254408060453,0.966990291262136,0.504710362798156
E02002806,New Zealand,Derby,East Midlands,941,4854,168,133,109,140,5404,913,5475,173,169,92,131,6040,812,140,148,82,120,1302,0.148310502283105,0.809248554913295,0.875739644970414,0.891304347826087,0.916030534351145,0.215562913907285
E02002807,Chaddesden Park,Derby,East Midlands,1777,5186,418,557,311,426,6898,1832,5882,457,520,353,458,7670,1394,423,495,338,442,3092,0.236994219653179,0.925601750547046,0.951923076923077,0.957507082152975,0.965065502183406,0.403129074315515
E02002808,Cathedral Quarter & California,Derby,East Midlands,1926,10221,227,242,153,287,11130,1958,11645,306,248,166,247,12612,1562,231,202,139,214,2348,0.134134821811936,0.754901960784314,0.814516129032258,0.837349397590361,0.866396761133603,0.186171899777989
E02002809,Spondon South,Derby,East Midlands,1305,3979,318,357,306,416,5376,1381,4573,333,372,333,486,6097,1117,315,349,315,468,2564,0.244259785698666,0.945945945945946,0.938172043010753,0.945945945945946,0.962962962962963,0.420534689191406
E02002810,Mickleover North,Derby,East Midlands,1547,4771,563,563,357,631,6885,1662,5412,554,567,407,633,7573,1485,520,544,394,619,3562,0.274390243902439,0.938628158844765,0.959435626102293,0.968058968058968,0.977883096366509,0.470355209296184
E02002811,New Normanton,Derby,East Midlands,2837,7650,309,161,138,238,8496,3340,9758,392,224,137,250,10761,1040,210,151,108,187,1696,0.106579217052675,0.535714285714286,0.674107142857143,0.788321167883212,0.748,0.157606170430257
E02002812,Littleover East,Derby,East Midlands,1405,4693,360,330,283,504,6170,1486,5283,417,366,286,488,6840,1391,366,332,260,457,2806,0.263297368919175,0.877697841726619,0.907103825136612,0.909090909090909,0.936475409836066,0.410233918128655
E02002813,Rose Hill & Castleward,Derby,East Midlands,3258,7597,335,212,143,306,8593,3591,9928,372,243,164,349,11056,1055,223,168,121,270,1837,0.106265108783239,0.599462365591398,0.691358024691358,0.737804878048781,0.773638968481375,0.166154124457308
E02002814,Mickleover South,Derby,East Midlands,1101,3911,514,525,332,617,5899,1117,4331,589,563,389,667,6539,1184,547,537,366,633,3267,0.27337797275456,0.928692699490662,0.953818827708703,0.940874035989717,0.949025487256372,0.49961767854412
E02002815,Normanton North & Peartree,Derby,East Midlands,2532,5458,206,164,151,278,6257,2784,7160,255,176,129,242,7962,813,155,118,101,192,1379,0.11354748603352,0.607843137254902,0.670454545454545,0.782945736434109,0.793388429752066,0.173197689022859
E02002816,Littleover West & Heatherton,Derby,East Midlands,2184,5866,450,354,265,384,7319,2142,6615,483,425,277,322,8122,1501,444,394,255,309,2903,0.226908541194256,0.919254658385093,0.927058823529412,0.92057761732852,0.959627329192547,0.357424279734056
E02002817,Normanton West,Derby,East Midlands,1229,3552,395,331,269,456,5003,1145,3956,402,362,261,435,5416,930,372,351,253,399,2305,0.235085945399393,0.925373134328358,0.969613259668508,0.969348659003831,0.917241379310345,0.425590841949778
E02002818,Normanton South,Derby,East Midlands,2417,5138,285,247,183,424,6277,2337,6062,306,251,186,347,7152,941,221,212,160,305,1839,0.15522929726163,0.722222222222222,0.844621513944223,0.860215053763441,0.878962536023055,0.257130872483222
E02002819,Wilmorton & Alvaston Village,Derby,East Midlands,1339,5265,369,378,202,373,6587,1293,5173,356,360,249,353,6491,1044,309,336,237,336,2262,0.201817127392229,0.867977528089888,0.933333333333333,0.951807228915663,0.951841359773371,0.348482514250501
E02002820,Alvaston & Crewton,Derby,East Midlands,2286,6113,365,354,243,331,7406,2202,6880,408,366,240,298,8192,1352,358,328,225,269,2532,0.196511627906977,0.877450980392157,0.896174863387978,0.9375,0.902684563758389,0.30908203125
E02002821,Allenton & Osmaston,Derby,East Midlands,3524,7435,328,300,212,353,8628,3449,8733,363,312,212,345,9965,1501,280,267,181,299,2528,0.171876789190427,0.771349862258953,0.855769230769231,0.85377358490566,0.866666666666667,0.253687907676869
E02002822,Sunny Hill,Derby,East Midlands,1337,3964,316,309,232,462,5283,1374,4551,326,320,238,450,5885,1030,269,285,229,417,2230,0.22632388486047,0.825153374233129,0.890625,0.96218487394958,0.926666666666667,0.37892948173322
E02002823,Boulton,Derby,East Midlands,1411,4266,349,437,421,455,5928,1481,4767,387,437,387,461,6439,1159,360,411,377,440,2747,0.243129851059366,0.930232558139535,0.940503432494279,0.974160206718346,0.954446854663775,0.426619040223637
E02002824,Sinfin,Derby,East Midlands,2462,5949,489,368,247,276,7329,2583,7139,535,448,295,313,8730,1252,455,396,270,273,2646,0.175374702339263,0.850467289719626,0.883928571428571,0.915254237288136,0.87220447284345,0.303092783505155
E02002825,Chellaston West & Shelton Lock,Derby,East Midlands,1852,4981,427,469,334,517,6728,1758,5428,430,498,350,560,7266,1311,394,471,323,514,3013,0.241525423728814,0.916279069767442,0.945783132530121,0.922857142857143,0.917857142857143,0.414671070740435
E02002826,Chellaston East,Derby,East Midlands,1453,4447,267,288,185,281,5468,1488,4894,296,311,198,291,5990,1181,273,290,187,281,2212,0.241315897016755,0.922297297297297,0.932475884244373,0.944444444444444,0.965635738831615,0.369282136894825
E02002827,Beaumont Park,Leicester,East Midlands,1486,4058,271,218,121,154,4822,1617,4753,323,232,155,150,5613,844,261,206,142,135,1588,0.177572059751736,0.808049535603715,0.887931034482759,0.916129032258065,0.9,0.282914662390878
E02002828,Rushey Mead North,Leicester,East Midlands,1486,4771,506,382,246,336,6241,1526,5637,552,439,293,387,7308,1271,465,393,259,350,2738,0.225474543196736,0.842391304347826,0.895216400911162,0.883959044368601,0.904392764857881,0.374657909140668
E02002829,Stocking Farm & Mowmacre,Leicester,East Midlands,3038,6896,355,338,198,461,8248,3125,8197,419,380,198,372,9566,1412,299,324,176,324,2535,0.17225814322313,0.713603818615752,0.852631578947369,0.888888888888889,0.870967741935484,0.265001045369015
E02002830,Bradgate Heights & Beaumont Leys,Leicester,East Midlands,2660,6303,448,279,168,221,7419,2929,7742,452,369,186,205,8954,1507,350,328,164,179,2528,0.194652544562129,0.774336283185841,0.888888888888889,0.881720430107527,0.873170731707317,0.282331918695555
E02002831,Rushey Mead South,Leicester,East Midlands,1431,4127,400,297,220,334,5378,1508,5212,403,343,210,356,6524,1052,337,298,190,310,2187,0.201841903300077,0.836228287841191,0.868804664723032,0.904761904761905,0.870786516853933,0.33522378908645
E02002832,Belgrave North West,Leicester,East Midlands,1780,5829,524,325,283,418,7379,2031,7925,559,469,278,452,9683,1309,443,408,247,401,2808,0.165173501577287,0.792486583184258,0.869936034115139,0.888489208633094,0.88716814159292,0.289992770835485
E02002833,Belgrave North East,Leicester,East Midlands,1709,5488,433,270,198,242,6631,1849,7095,506,330,188,267,8386,1036,411,290,170,227,2134,0.146018322762509,0.812252964426877,0.878787878787879,0.904255319148936,0.850187265917603,0.254471738611972
E02002834,Abbey Park,Leicester,East Midlands,2116,7469,460,453,283,475,9140,2266,8685,499,465,324,446,10419,1415,418,428,295,412,2968,0.162924582613702,0.837675350701403,0.920430107526882,0.910493827160494,0.923766816143498,0.284864190421346
E02002835,Hamilton & Humberstone,Leicester,East Midlands,3636,9249,539,371,226,372,10757,3897,10494,589,398,263,364,12108,2353,453,363,228,322,3719,0.2242233657328,0.769100169779287,0.912060301507538,0.866920152091255,0.884615384615385,0.307152296002643
E02002836,Belgrave South,Leicester,East Midlands,1807,6206,554,366,255,359,7740,2018,8427,605,457,272,413,10174,1307,481,391,230,363,2772,0.155096712946482,0.79504132231405,0.855579868708972,0.845588235294118,0.878934624697337,0.272459209750344
E02002837,Northfields & Merrydale,Leicester,East Midlands,2243,5494,289,193,123,135,6234,2601,7494,334,206,147,178,8359,850,222,159,118,145,1494,0.113424072591406,0.664670658682635,0.771844660194175,0.802721088435374,0.814606741573034,0.178729513099653
E02002838,New Parks & Stokeswood,Leicester,East Midlands,2337,4643,279,313,186,291,5712,2544,5894,298,307,206,238,6943,1087,225,275,182,215,1984,0.184424838819138,0.75503355704698,0.895765472312704,0.883495145631068,0.903361344537815,0.285755437130923
E02002839,Colchester Road,Leicester,East Midlands,1841,4698,368,322,247,387,6022,2026,5647,411,353,260,366,7037,1267,330,306,235,328,2466,0.224366920488755,0.802919708029197,0.86685552407932,0.903846153846154,0.896174863387978,0.350433423333807
E02002842,Newfoundpool,Leicester,East Midlands,2017,6084,180,114,84,106,6568,2094,6969,205,156,80,97,7507,771,149,132,66,87,1205,0.110632802410676,0.726829268292683,0.846153846153846,0.825,0.896907216494845,0.160516850939124
E02002843,Spinney Hill Road,Leicester,East Midlands,3649,9130,553,349,206,298,10536,3782,11935,667,413,242,323,13580,1060,430,319,179,221,2209,0.0888144113950566,0.644677661169415,0.772397094430993,0.739669421487603,0.68421052631579,0.162665684830633
E02002844,St Matthews & Highfields North,Leicester,East Midlands,3360,7108,372,285,216,285,8266,3391,8984,458,337,212,307,10298,987,285,241,159,216,1888,0.109861976847729,0.622270742358079,0.71513353115727,0.75,0.703583061889251,0.183336570207807
E02002845,North Evington & Rowlatts Hill,Leicester,East Midlands,2724,6750,430,339,223,396,8138,2882,8296,481,378,238,374,9767,1274,357,316,189,300,2436,0.153567984570878,0.742203742203742,0.835978835978836,0.794117647058824,0.802139037433155,0.249411282891369
E02002846,Dane Hills & Western Park,Leicester,East Midlands,1329,4493,388,362,225,356,5824,1385,5155,387,371,252,360,6525,1205,337,341,236,340,2459,0.233753637245393,0.870801033591731,0.919137466307278,0.936507936507937,0.944444444444444,0.376858237547893
E02002847,Crown Hills,Leicester,East Midlands,2474,6367,435,232,210,291,7535,2688,8613,493,299,209,322,9936,1124,371,251,179,263,2188,0.130500406362475,0.752535496957404,0.839464882943144,0.856459330143541,0.816770186335404,0.220209339774557
E02002848,Highfields South,Leicester,East Midlands,2861,7345,399,257,192,222,8415,3110,9674,431,336,188,259,10888,1079,301,252,149,199,1980,0.111536076080215,0.698375870069606,0.75,0.792553191489362,0.768339768339768,0.181851579720794
E02002849,West End & Westcotes,Leicester,East Midlands,1866,11873,293,223,200,283,12872,1882,12736,338,235,170,294,13773,1292,252,203,150,257,2154,0.10144472361809,0.745562130177515,0.863829787234043,0.882352941176471,0.874149659863946,0.156392942714006
E02002851,Evington,Leicester,East Midlands,1578,4932,498,379,322,609,6740,1740,5721,553,437,327,578,7616,1378,457,401,298,538,3072,0.240866981296976,0.826401446654611,0.917620137299771,0.91131498470948,0.930795847750865,0.403361344537815
E02002852,Braunstone Park West,Leicester,East Midlands,2149,4195,217,180,105,161,4858,2243,5320,227,226,120,148,6041,1075,167,198,109,135,1684,0.202067669172932,0.73568281938326,0.876106194690266,0.908333333333333,0.912162162162162,0.2787617944049
E02002853,Stoneygate North,Leicester,East Midlands,3066,8657,513,330,254,400,10154,3410,10859,637,398,265,416,12575,1676,492,336,234,344,3082,0.154342020443871,0.772370486656201,0.844221105527638,0.883018867924528,0.826923076923077,0.245089463220676
E02002854,Braunstone Park East,Leicester,East Midlands,1995,5209,293,246,177,347,6272,2146,6286,321,233,185,309,7334,1210,256,198,171,282,2117,0.192491250397709,0.797507788161994,0.849785407725322,0.924324324324324,0.912621359223301,0.288655576765749
E02002855,Rowley Fields & Faircharm,Leicester,East Midlands,1375,5985,242,190,128,159,6704,1481,6522,250,214,142,195,7323,1053,217,194,132,172,1768,0.161453541858326,0.868,0.906542056074766,0.929577464788732,0.882051282051282,0.241431107469616
E02002856,Clarendon Park & Stoneygate South,Leicester,East Midlands,1533,8696,403,378,275,506,10258,1500,9700,461,388,287,486,11322,1756,383,340,255,431,3165,0.181030927835052,0.830802603036876,0.876288659793815,0.888501742160279,0.886831275720165,0.279544250132485
E02002857,Aylestone North & Saffron Fields,Leicester,East Midlands,1327,4631,223,157,97,178,5286,1542,5259,240,179,123,155,5956,1063,197,161,109,136,1666,0.202129682449135,0.820833333333333,0.899441340782123,0.886178861788618,0.87741935483871,0.279717931497649
E02002858,Knighton,Leicester,East Midlands,1365,4127,388,382,281,488,5666,1313,4738,430,392,278,473,6311,1266,375,370,260,438,2709,0.26720135078092,0.872093023255814,0.943877551020408,0.935251798561151,0.92600422832981,0.429250514973855
E02002860,Aylestone South,Leicester,East Midlands,1573,4706,395,423,270,525,6319,1608,5460,418,452,292,494,7116,1347,373,410,275,443,2848,0.246703296703297,0.892344497607656,0.907079646017699,0.941780821917808,0.896761133603239,0.400224845418775
E02002861,Saffron Lane,Leicester,East Midlands,2121,4546,306,213,147,214,5426,2229,5864,298,227,146,216,6751,1301,236,209,127,193,2066,0.221862210095498,0.791946308724832,0.920704845814978,0.86986301369863,0.893518518518519,0.306028736483484
E02002862,Eyres Monsell,Leicester,East Midlands,1989,4781,315,366,209,370,6041,2186,5824,343,340,203,357,7067,1455,296,304,182,329,2566,0.249828296703297,0.862973760932945,0.894117647058824,0.896551724137931,0.92156862745098,0.363096080373567
E02006815,Thurnby Lodge,Leicester,East Midlands,2784,6056,462,395,273,623,7809,3095,7316,514,415,276,536,9057,1577,399,370,249,479,3074,0.215554948059049,0.776264591439689,0.891566265060241,0.902173913043478,0.89365671641791,0.339405984321519
E02006817,West Knighton,Leicester,East Midlands,1628,6092,308,244,222,334,7200,1700,7538,341,265,201,343,8688,1321,296,236,187,304,2344,0.175245423189175,0.868035190615836,0.890566037735849,0.930348258706468,0.886297376093295,0.269797421731123
E02006819,Kirby Frith,Leicester,East Midlands,2321,4810,281,278,158,255,5782,2532,5936,308,275,162,227,6908,1115,230,243,147,205,1940,0.18783692722372,0.746753246753247,0.883636363636364,0.907407407407407,0.903083700440529,0.280833815865663
E02006850,Leicester City South,Leicester,East Midlands,779,12423,121,90,63,127,12824,875,14394,136,102,71,90,14793,1215,88,74,61,73,1511,0.0844101709045436,0.647058823529412,0.725490196078431,0.859154929577465,0.811111111111111,0.102142905428243
E02006851,Leicester City Centre,Leicester,East Midlands,620,10823,46,39,23,24,10955,616,10313,103,64,23,29,10532,714,58,48,19,26,865,0.0692330068845147,0.563106796116505,0.75,0.826086956521739,0.896551724137931,0.0821306494492974
E02002863,"Market Overton, Cottesmore & Empingham",Rutland,East Midlands,1018,5114,485,495,333,385,6812,1338,5152,429,518,376,398,6873,643,405,493,363,383,2287,0.124805900621118,0.944055944055944,0.951737451737452,0.965425531914894,0.962311557788945,0.332751345846064
E02002864,"Oakham West, Langham & Whissendine",Rutland,East Midlands,1588,4557,510,471,369,516,6423,1503,4888,490,514,438,587,6917,750,435,494,425,559,2663,0.153436988543372,0.887755102040816,0.961089494163424,0.970319634703196,0.952299829642249,0.384993494289432
E02002865,Oakham East,Rutland,East Midlands,1305,4332,533,566,490,649,6570,1214,4542,525,598,470,729,6864,648,487,568,455,707,2865,0.142668428005284,0.927619047619048,0.949832775919733,0.968085106382979,0.969821673525377,0.417395104895105
E02002866,"Ketton, Ryhall & Luffenham",Rutland,East Midlands,1358,4197,515,624,357,583,6276,1134,4300,503,639,390,586,6418,669,407,611,371,555,2613,0.155581395348837,0.809145129224652,0.956181533646322,0.951282051282051,0.947098976109215,0.40713617949517
E02002867,"Uppingham, Lyddington & Braunston",Rutland,East Midlands,1492,4803,555,604,428,695,7085,1421,5319,563,604,469,657,7612,701,527,588,457,636,2909,0.131791690167325,0.936056838365897,0.973509933774834,0.974413646055437,0.968036529680365,0.382159747766684
E02002868,Rise Park & Top Valley West,Nottingham,East Midlands,1103,3236,343,451,274,337,4641,1113,3739,338,415,336,383,5211,946,301,386,313,354,2300,0.253008825889275,0.890532544378698,0.930120481927711,0.931547619047619,0.924281984334204,0.44137401650355
E02002869,Bulwell North,Nottingham,East Midlands,1868,4480,328,336,174,340,5658,1966,5281,331,331,202,309,6454,1108,268,289,183,267,2115,0.209808748343117,0.809667673716012,0.873111782477341,0.905940594059406,0.864077669902913,0.327703749612643
E02002871,Highbury Vale,Nottingham,East Midlands,1477,4757,408,383,280,418,6246,1567,5196,406,383,293,451,6729,1262,342,351,274,417,2646,0.242879137798306,0.842364532019704,0.91644908616188,0.935153583617747,0.924611973392461,0.393223361569327
E02002872,Bulwell West,Nottingham,East Midlands,2012,5466,416,433,190,273,6778,2177,6157,414,418,293,248,7530,1260,338,373,263,220,2454,0.20464511937632,0.816425120772947,0.892344497607656,0.897610921501707,0.887096774193548,0.32589641434263
E02002873,Bestwood,Nottingham,East Midlands,2469,6046,310,217,176,295,7044,2605,6997,306,249,162,303,8017,1422,256,215,140,274,2307,0.203229955695298,0.836601307189543,0.863453815261044,0.864197530864198,0.904290429042904,0.287763502557066
E02002874,North Sherwood,Nottingham,East Midlands,1746,5330,362,279,187,334,6492,1719,6740,327,308,225,328,7928,1270,269,267,204,303,2313,0.188427299703264,0.82262996941896,0.866883116883117,0.906666666666667,0.923780487804878,0.291750756811302
E02002875,Basford Park Lane,Nottingham,East Midlands,2072,5474,279,293,205,280,6531,2106,6128,342,261,208,285,7224,1202,278,222,179,234,2115,0.196148825065274,0.812865497076023,0.850574712643678,0.860576923076923,0.821052631578947,0.292774086378738
E02002876,Old Basford,Nottingham,East Midlands,1507,5412,390,306,249,312,6669,1511,5963,356,325,253,309,7206,1057,283,272,234,281,2127,0.177259768572866,0.794943820224719,0.836923076923077,0.924901185770751,0.909385113268608,0.295170691090758
E02002877,Sherwood Vale,Nottingham,East Midlands,1231,5010,429,359,253,448,6499,1259,5568,411,375,256,352,6962,1186,349,343,232,316,2426,0.213002873563218,0.849148418491484,0.914666666666667,0.90625,0.897727272727273,0.34846308532031
E02002878,Broxtowe & Cinderhill,Nottingham,East Midlands,3324,5738,238,174,118,131,6399,3255,6794,233,190,132,132,7481,1148,162,146,111,111,1678,0.168972622902561,0.695278969957082,0.768421052631579,0.840909090909091,0.840909090909091,0.224301563962037
E02002879,New Basford,Nottingham,East Midlands,2161,6733,277,234,171,165,7580,2266,7550,311,250,186,215,8512,1264,258,223,167,192,2104,0.167417218543046,0.829581993569132,0.892,0.897849462365591,0.893023255813954,0.24718045112782
E02002880,Aspley,Nottingham,East Midlands,2691,5580,204,246,173,164,6367,2688,6617,249,231,147,158,7402,1170,185,195,113,138,1801,0.176817288801572,0.742971887550201,0.844155844155844,0.768707482993197,0.873417721518987,0.243312618211294
E02002881,Bilborough North,Nottingham,East Midlands,1801,4190,272,222,139,239,5062,1801,4869,249,236,175,270,5799,1045,194,201,146,223,1809,0.214623125898542,0.779116465863454,0.851694915254237,0.834285714285714,0.825925925925926,0.311950336264873
E02002882,Mapperley Park,Nottingham,East Midlands,1346,6111,368,259,154,351,7243,1161,6382,375,312,162,317,7548,1128,323,274,145,283,2153,0.176747101222187,0.861333333333333,0.878205128205128,0.895061728395062,0.892744479495268,0.285241123476418
E02002883,Thorneywood,Nottingham,East Midlands,1735,5301,303,252,147,213,6216,1679,5790,313,263,168,202,6736,1031,250,233,149,178,1841,0.178065630397237,0.798722044728435,0.885931558935361,0.886904761904762,0.881188118811881,0.273307600950119
E02002884,Forest Fields,Nottingham,East Midlands,1441,5021,152,107,85,162,5527,1694,5913,182,132,78,156,6461,732,125,99,70,131,1157,0.123795027904617,0.686813186813187,0.75,0.897435897435897,0.83974358974359,0.17907444668008
E02002885,Hyson Green,Nottingham,East Midlands,2355,6355,180,135,105,70,6845,2736,8655,204,143,95,104,9201,707,109,98,70,77,1061,0.0816868861929521,0.534313725490196,0.685314685314685,0.736842105263158,0.740384615384615,0.115313552874688
E02002886,Bobbers Mill,Nottingham,East Midlands,2441,5946,383,329,245,425,7328,2589,7585,395,353,293,424,9050,1202,312,295,259,377,2445,0.158470665787739,0.789873417721519,0.835694050991501,0.883959044368601,0.889150943396226,0.270165745856354
E02002887,Beechdale,Nottingham,East Midlands,1303,3798,366,383,287,446,5280,1413,4444,325,384,303,406,5862,1066,247,338,273,376,2300,0.23987398739874,0.76,0.880208333333333,0.900990099009901,0.926108374384236,0.392357557147731
E02002888,St Ann's East,Nottingham,East Midlands,1856,4912,274,188,141,206,5721,1948,5921,302,208,139,210,6780,879,211,181,117,175,1563,0.148454652930248,0.698675496688742,0.870192307692308,0.841726618705036,0.833333333333333,0.230530973451327
E02002889,"Arboretum, Forest & Trent University",Nottingham,East Midlands,628,12034,140,80,52,86,12392,571,10616,133,94,46,75,10964,625,91,71,34,59,880,0.0588733986435569,0.68421052631579,0.75531914893617,0.739130434782609,0.786666666666667,0.0802626778547975
E02002890,St Ann's West,Nottingham,East Midlands,1395,11711,227,207,152,220,12517,1386,10660,242,213,151,189,11455,813,158,173,125,146,1415,0.0762664165103189,0.652892561983471,0.812206572769953,0.827814569536424,0.772486772486773,0.12352684417285
E02002891,Bakersfield,Nottingham,East Midlands,1860,5025,387,334,201,383,6330,1883,5772,396,347,238,377,7130,1107,324,313,214,330,2288,0.191787941787942,0.818181818181818,0.902017291066282,0.899159663865546,0.875331564986737,0.320897615708275
E02002892,Bilborough South,Nottingham,East Midlands,1404,3697,272,227,167,307,4670,1393,4512,269,285,174,290,5530,968,205,244,158,258,1833,0.214539007092199,0.762081784386617,0.856140350877193,0.908045977011494,0.889655172413793,0.331464737793852
E02002893,Radford,Nottingham,East Midlands,2084,13357,251,165,109,135,14017,2272,17042,266,174,110,142,17734,1329,162,126,84,114,1815,0.0779838047177561,0.609022556390977,0.724137931034483,0.763636363636364,0.802816901408451,0.102345776474569
E02002894,Wollaton Park,Nottingham,East Midlands,1525,4155,391,323,223,417,5509,1563,5028,387,357,232,424,6428,1143,343,328,218,391,2423,0.227326968973747,0.886304909560723,0.918767507002801,0.939655172413793,0.922169811320755,0.376944617299316
E02002895,The Park & Castle,Nottingham,East Midlands,543,7358,182,164,85,106,7895,549,8266,188,191,123,151,8919,1010,146,164,104,122,1546,0.122187273167191,0.776595744680851,0.858638743455497,0.845528455284553,0.80794701986755,0.173337818141047
E02002896,Sneinton,Nottingham,East Midlands,2594,7182,295,231,141,220,8069,2558,8481,305,253,146,195,9380,944,211,200,122,152,1629,0.111307628817356,0.691803278688525,0.790513833992095,0.835616438356164,0.77948717948718,0.173667377398721
E02002897,Wollaton Vale,Nottingham,East Midlands,1759,4412,473,504,350,675,6414,1715,4846,445,466,357,633,6747,1158,401,442,337,602,2940,0.238959966983079,0.901123595505618,0.948497854077253,0.943977591036415,0.951026856240126,0.435749221876389
E02002898,Lenton & Dunkirk,Nottingham,East Midlands,700,9730,160,89,83,152,10214,872,10996,169,127,90,154,11536,1523,123,105,73,130,1954,0.138504910876682,0.727810650887574,0.826771653543307,0.811111111111111,0.844155844155844,0.169382801664355
E02002899,"University Park, Lenton Abbey & Jubilee Campus",Nottingham,East Midlands,810,9432,235,184,136,222,10209,901,14714,198,195,153,224,15484,1434,157,172,139,193,2095,0.0974582030719043,0.792929292929293,0.882051282051282,0.908496732026144,0.861607142857143,0.135300955825368
E02002901,Wilford & Silverdale,Nottingham,East Midlands,1126,3812,341,303,216,369,5041,1107,4170,373,291,220,444,5498,996,336,274,213,411,2230,0.238848920863309,0.900804289544236,0.941580756013746,0.968181818181818,0.925675675675676,0.405602037104402
E02002902,Clifton North,Nottingham,East Midlands,1594,6314,423,271,187,477,7672,1668,7180,424,302,209,414,8529,1269,381,281,197,388,2516,0.176740947075209,0.898584905660377,0.93046357615894,0.942583732057416,0.93719806763285,0.294993551412827
E02002903,Clifton West,Nottingham,East Midlands,1299,3595,357,274,203,504,4933,1290,4012,388,299,197,476,5372,892,349,279,189,446,2155,0.222333000997009,0.899484536082474,0.933110367892977,0.959390862944162,0.936974789915966,0.401154132539092
E02002904,Clifton South,Nottingham,East Midlands,1342,3753,258,203,138,341,4693,1475,4410,312,231,158,341,5452,1053,277,216,145,299,1990,0.238775510204082,0.887820512820513,0.935064935064935,0.917721518987342,0.87683284457478,0.365003668378577
E02006834,Top Valley East,Nottingham,East Midlands,1603,4494,364,324,282,476,5940,1587,5107,338,337,244,464,6490,1069,278,295,222,414,2278,0.209320540434697,0.822485207100592,0.875370919881306,0.909836065573771,0.892241379310345,0.351001540832049
E02006904,City Centre & Trent Bridge,Nottingham,East Midlands,701,11252,143,82,56,38,11571,795,10179,157,112,68,68,10584,785,106,92,58,59,1100,0.0771195598781806,0.67515923566879,0.821428571428571,0.852941176470588,0.867647058823529,0.103930461073318
E02006905,Meadows,Nottingham,East Midlands,1626,5380,235,187,156,198,6156,1688,6115,277,217,146,206,6961,918,200,176,125,177,1596,0.150122649223222,0.72202166064982,0.811059907834101,0.856164383561644,0.859223300970874,0.22927740267203
E02004029,Alfreton,Amber Valley,East Midlands,1167,4427,459,363,235,321,5805,1279,4780,432,389,265,366,6232,1082,399,363,249,344,2437,0.226359832635983,0.923611111111111,0.933161953727506,0.939622641509434,0.939890710382514,0.39104621309371
E02004030,"Crich, Holloway & Wingfield",Amber Valley,East Midlands,831,3371,495,516,312,395,5089,855,3540,492,528,385,436,5381,725,453,511,373,423,2485,0.204802259887006,0.920731707317073,0.96780303030303,0.968831168831169,0.970183486238532,0.461810072477235
E02004031,Somercotes & Pye Bridge,Amber Valley,East Midlands,1674,4903,401,363,238,320,6225,1613,5007,367,384,254,277,6289,988,332,356,239,263,2178,0.197323746754544,0.904632152588556,0.927083333333333,0.940944881889764,0.949458483754513,0.346318969629512
E02004032,Swanwick & Leabrooks,Amber Valley,East Midlands,1219,5068,594,723,429,521,7335,1288,5127,566,675,479,518,7365,1142,525,652,466,498,3283,0.222742344450946,0.92756183745583,0.965925925925926,0.97286012526096,0.961389961389961,0.445756958587916
E02004033,"Ripley East, Riddings & Ironville",Amber Valley,East Midlands,1394,5744,543,488,335,530,7640,1416,5752,549,522,377,477,7677,1093,492,504,361,458,2908,0.190020862308762,0.896174863387978,0.96551724137931,0.957559681697613,0.960167714884696,0.378793799661326
E02004034,Ripley West,Amber Valley,East Midlands,1029,4133,516,643,499,497,6288,953,3933,529,589,464,454,5969,813,466,574,456,436,2745,0.206712433257056,0.880907372400756,0.974533106960951,0.982758620689655,0.960352422907489,0.459876026135031
E02004035,"Ambergate, Heage & Idridgehay",Amber Valley,East Midlands,911,3837,498,526,417,454,5732,829,3818,493,511,420,461,5703,777,466,491,412,444,2590,0.203509690937664,0.945233265720081,0.960861056751468,0.980952380952381,0.963123644251627,0.454146940206909
E02004036,Ripley South & Loscoe,Amber Valley,East Midlands,1903,6378,616,654,406,469,8523,1851,6511,528,702,486,528,8755,1337,470,668,468,502,3445,0.205344801105821,0.890151515151515,0.951566951566952,0.962962962962963,0.950757575757576,0.393489434608795
E02004037,Belper Far Laund,Amber Valley,East Midlands,1415,5055,446,482,342,403,6728,1353,5089,456,500,344,484,6873,1037,431,477,338,470,2753,0.203772843387699,0.945175438596491,0.954,0.982558139534884,0.971074380165289,0.400552888112906
E02004038,Belper Town,Amber Valley,East Midlands,1160,4914,464,495,310,528,6711,1069,4833,449,544,360,491,6677,983,419,514,346,470,2732,0.20339333747155,0.933184855233853,0.944852941176471,0.961111111111111,0.957230142566191,0.409165793020818
E02004039,Openwoodgate & Holbrook,Amber Valley,East Midlands,1291,5118,464,486,316,442,6826,1248,4916,482,484,350,409,6641,1087,449,469,345,395,2745,0.221114727420667,0.931535269709544,0.96900826446281,0.985714285714286,0.965770171149144,0.413341364252372
E02004040,Heanor Gate & Aldercar,Amber Valley,East Midlands,1737,6167,526,483,304,416,7896,1709,6300,521,516,352,386,8075,1167,458,499,342,370,2836,0.185238095238095,0.879078694817658,0.967054263565892,0.971590909090909,0.958549222797927,0.351207430340557
E02004041,Heanor East & Langley Mill,Amber Valley,East Midlands,1256,4742,449,422,270,292,6175,1240,4756,412,417,310,326,6221,869,378,391,303,311,2252,0.182716568544996,0.91747572815534,0.937649880095923,0.97741935483871,0.95398773006135,0.361999678508278
E02004043,Kilburn & Horsley,Amber Valley,East Midlands,1261,4380,494,502,345,429,6150,1223,4571,510,500,372,422,6375,1008,470,478,355,406,2717,0.22052067381317,0.92156862745098,0.956,0.954301075268817,0.962085308056872,0.426196078431373
E02004044,"Duffield, Quarndon & Kirk Langley",Amber Valley,East Midlands,1735,4870,476,537,429,639,6951,1779,5460,450,573,436,686,7605,1269,435,555,430,669,3358,0.232417582417582,0.966666666666667,0.968586387434555,0.986238532110092,0.975218658892128,0.44155161078238
E02006827,Heanor South & Shipley Park,Amber Valley,East Midlands,1561,5020,427,441,281,360,6529,1568,5289,412,429,299,390,6819,973,345,397,280,368,2363,0.183966723388164,0.837378640776699,0.925407925407925,0.936454849498328,0.943589743589744,0.346531749523391
E02004045,Clowne & Barlborough,Bolsover,East Midlands,1612,5976,629,658,396,523,8182,1569,6283,605,640,466,501,8495,1606,520,616,457,487,3686,0.25561037720834,0.859504132231405,0.9625,0.98068669527897,0.972055888223553,0.433902295467922
E02004046,Whitwell & Elmton,Bolsover,East Midlands,970,3807,449,446,245,390,5337,1042,3987,392,445,308,381,5513,1079,334,413,302,367,2495,0.27062954602458,0.852040816326531,0.928089887640449,0.980519480519481,0.963254593175853,0.452566660620352
E02004047,Creswell & Hodthorpe,Bolsover,East Midlands,1291,3838,343,324,235,261,5001,1237,3847,310,310,258,269,4994,907,252,294,249,259,1961,0.235768131011178,0.812903225806452,0.948387096774194,0.965116279069768,0.962825278810409,0.392671205446536
E02004048,Bolsover North & Shuttlewood,Bolsover,East Midlands,1389,4324,386,333,233,268,5544,1464,4677,397,367,246,323,6010,1014,303,349,235,304,2205,0.216805644644003,0.763224181360202,0.950953678474115,0.955284552845528,0.941176470588235,0.366888519134775
E02004049,Bolsover South & Glapwell,Bolsover,East Midlands,1191,4589,548,540,387,513,6577,1154,4795,537,556,424,541,6853,1213,446,528,402,513,3102,0.252971845672576,0.830540037243948,0.949640287769784,0.94811320754717,0.948243992606285,0.452648475120385
E02004050,Shirebrook North,Bolsover,East Midlands,1562,4972,326,343,304,379,6324,1558,5085,323,299,307,363,6377,1398,252,276,296,353,2575,0.274926253687316,0.780185758513932,0.923076923076923,0.964169381107492,0.972451790633609,0.403794887878313
E02004051,"Langwith, Shirebrook South & Pleasley",Bolsover,East Midlands,1767,6559,501,508,395,415,8378,1804,6823,505,506,418,407,8659,1780,417,475,398,385,3455,0.260882309834384,0.825742574257426,0.938735177865613,0.952153110047847,0.945945945945946,0.399006813719829
E02004052,"Tibshelf, Newton & Hardwick Park",Bolsover,East Midlands,1512,5252,481,462,353,441,6989,1539,5608,498,474,388,427,7395,1495,437,440,370,389,3131,0.266583452211127,0.877510040160643,0.928270042194093,0.95360824742268,0.911007025761124,0.423394185260311
E02004053,South Normanton West,Bolsover,East Midlands,1507,4972,411,402,282,300,6367,1500,5174,406,376,313,320,6589,1315,351,355,294,304,2619,0.254155392346347,0.864532019704434,0.944148936170213,0.939297124600639,0.95,0.397480649567461
E02004054,South Normanton Broadmeadows & Pinxton,Bolsover,East Midlands,1484,5796,506,493,351,432,7578,1442,5964,536,491,383,481,7855,1535,484,462,369,454,3304,0.257377598926895,0.902985074626866,0.940936863543788,0.963446475195822,0.943866943866944,0.42062380649268
E02004055,Old Whittington,Chesterfield,East Midlands,1156,4393,410,452,312,462,6029,1103,4380,418,414,343,435,5990,1012,371,384,315,410,2492,0.231050228310502,0.88755980861244,0.927536231884058,0.918367346938776,0.942528735632184,0.416026711185309
E02004056,Staveley & Norbriggs,Chesterfield,East Midlands,1733,4928,383,359,220,301,6191,1763,5132,412,362,267,324,6497,1170,372,338,251,315,2446,0.227981293842557,0.902912621359223,0.933701657458563,0.940074906367041,0.972222222222222,0.376481452978298
E02004057,"New Whittington, Hollingwood & Barrow Hill",Chesterfield,East Midlands,1577,5150,389,329,191,242,6301,1523,5185,390,324,220,231,6350,1365,352,309,211,221,2458,0.263259402121504,0.902564102564103,0.953703703703704,0.959090909090909,0.956709956709957,0.387086614173228
E02004058,Dunston,Chesterfield,East Midlands,1437,4753,424,430,316,402,6325,1445,5059,414,417,342,425,6657,1075,349,379,320,401,2524,0.212492587467879,0.842995169082126,0.908872901678657,0.935672514619883,0.943529411764706,0.379149767162386
E02004059,Brimington South & Tapton,Chesterfield,East Midlands,1015,4320,485,471,353,516,6145,1018,4457,460,478,384,509,6288,1293,411,456,376,480,3016,0.290105452097824,0.893478260869565,0.95397489539749,0.979166666666667,0.943025540275049,0.479643765903308
E02004060,Inkersall Green & Duckmanton,Chesterfield,East Midlands,1422,4467,487,487,363,402,6206,1443,4656,470,513,361,434,6434,1160,418,484,349,423,2834,0.24914089347079,0.88936170212766,0.943469785575049,0.966759002770083,0.974654377880184,0.44047248989742
E02004061,Newbold,Chesterfield,East Midlands,1190,4850,410,365,334,471,6430,1185,4923,418,392,320,479,6532,1102,373,367,307,455,2604,0.223847247613244,0.892344497607656,0.936224489795918,0.959375,0.949895615866388,0.398652786282915
E02004062,Loundsley Green & Holme Hall,Chesterfield,East Midlands,1179,4811,572,503,374,401,6661,1128,4812,559,573,350,428,6722,1127,495,540,324,414,2900,0.234206151288446,0.885509838998211,0.942408376963351,0.925714285714286,0.967289719626168,0.431419220470098
E02004063,Ashgate & Brockwell,Chesterfield,East Midlands,1233,4665,482,543,418,614,6722,1172,4693,517,543,448,609,6810,1100,461,514,427,579,3081,0.234391647134029,0.891682785299807,0.946593001841621,0.953125,0.950738916256158,0.452422907488987
E02004064,Central Chesterfield & Stonegravels,Chesterfield,East Midlands,1753,6680,378,300,197,355,7910,1742,6827,404,357,216,355,8159,1255,332,313,192,328,2420,0.183828914603779,0.821782178217822,0.876750700280112,0.888888888888889,0.923943661971831,0.296604976100012
E02004065,Brookside & Walton,Chesterfield,East Midlands,1153,4409,717,694,466,690,6976,1181,4664,677,701,542,692,7276,1239,637,672,520,660,3728,0.26565180102916,0.940915805022157,0.958630527817404,0.959409594095941,0.953757225433526,0.51236943375481
E02004066,Spital & Hasland,Chesterfield,East Midlands,1774,7304,637,698,489,704,9832,1864,7354,639,701,505,686,9885,1812,556,664,478,651,4161,0.246396518901278,0.870109546165884,0.947218259629101,0.946534653465346,0.948979591836735,0.420940819423369
E02004067,Boythorpe & Birdholme,Chesterfield,East Midlands,1235,4060,355,348,245,307,5315,1198,4174,362,347,259,322,5464,900,311,324,237,303,2075,0.215620507906085,0.859116022099448,0.93371757925072,0.915057915057915,0.940993788819876,0.379758418740849
E02004068,"Hathersage, Bradwell & Tideswell",Derbyshire Dales,East Midlands,1021,4272,577,509,435,548,6341,1023,4360,526,561,413,560,6420,756,473,547,401,545,2722,0.173394495412844,0.899239543726236,0.975044563279857,0.970944309927361,0.973214285714286,0.42398753894081
E02004069,"Bakewell North, Baslow & Calver",Derbyshire Dales,East Midlands,863,3436,511,578,417,521,5463,827,3657,504,599,463,575,5798,658,432,576,453,559,2678,0.179928903472792,0.857142857142857,0.961602671118531,0.978401727861771,0.972173913043478,0.461883408071749
E02004070,"Bakewell South, Youlgreave and Taddington",Derbyshire Dales,East Midlands,833,3300,525,549,381,605,5360,804,3415,520,532,406,598,5471,580,372,506,395,575,2428,0.169838945827233,0.715384615384615,0.951127819548872,0.972906403940887,0.961538461538461,0.443794553098154
E02004071,Darley Dale & Stanton,Derbyshire Dales,East Midlands,774,2885,359,399,251,361,4255,706,3051,346,412,296,390,4495,558,239,393,290,370,1850,0.182890855457227,0.690751445086705,0.953883495145631,0.97972972972973,0.948717948717949,0.411568409343715
E02004072,Matlock North,Derbyshire Dales,East Midlands,1471,5205,719,745,476,689,7834,1443,5584,687,768,590,770,8399,1074,526,738,571,742,3651,0.192335243553009,0.765647743813683,0.9609375,0.967796610169492,0.963636363636364,0.434694606500774
E02004073,"Matlock South, Cromford & Winster",Derbyshire Dales,East Midlands,1355,5324,739,703,440,632,7838,1356,5440,683,700,511,603,7937,1070,491,664,492,576,3293,0.196691176470588,0.718887262079063,0.948571428571429,0.962818003913894,0.955223880597015,0.414892276678846
E02004074,Wirksworth,Derbyshire Dales,East Midlands,943,3578,458,464,294,381,5175,894,3697,463,471,321,392,5344,943,417,449,314,382,2505,0.25507167974033,0.900647948164147,0.953290870488323,0.978193146417446,0.974489795918367,0.46875
E02004075,"Ashbourne North, Dovedale & Carsington",Derbyshire Dales,East Midlands,980,4287,544,554,400,450,6235,942,4395,552,598,461,459,6465,915,505,579,446,451,2896,0.208191126279863,0.914855072463768,0.968227424749164,0.967462039045553,0.982570806100218,0.447950502706883
E02004076,Ashbourne South,Derbyshire Dales,East Midlands,1398,4491,402,400,313,439,6045,1341,4706,388,423,327,506,6350,940,358,400,316,484,2498,0.199745006374841,0.922680412371134,0.945626477541371,0.966360856269113,0.956521739130435,0.393385826771654
E02004077,"Doveridge, Brailsford & Bradley",Derbyshire Dales,East Midlands,1197,5032,492,557,371,492,6944,1175,5285,530,547,415,504,7281,1051,506,519,406,480,2962,0.198864711447493,0.954716981132075,0.948811700182815,0.978313253012048,0.952380952380952,0.406812251064414
E02004078,Cotmanhay,Erewash,East Midlands,1502,4296,394,384,242,353,5669,1478,4502,356,421,266,338,5883,921,273,401,251,328,2174,0.204575744113727,0.76685393258427,0.95249406175772,0.943609022556391,0.970414201183432,0.369539350671426
E02004080,Ilkeston Town,Erewash,East Midlands,1793,6250,404,450,324,541,7969,1773,6538,490,462,332,515,8337,1264,398,431,312,483,2888,0.193331293973692,0.812244897959184,0.932900432900433,0.939759036144578,0.937864077669903,0.346407580664508
E02004081,"Breadsall, Little Eaton & Stanley Common",Erewash,East Midlands,998,3412,456,390,294,410,4962,925,3401,428,435,307,393,4964,864,401,417,300,382,2364,0.254042928550426,0.936915887850467,0.958620689655172,0.977198697068404,0.972010178117048,0.476228847703465
E02004082,West Hallam,Erewash,East Midlands,922,3553,440,449,315,534,5291,824,3674,447,479,336,492,5428,870,410,459,334,485,2558,0.236799129014698,0.917225950782998,0.958246346555324,0.994047619047619,0.985772357723577,0.471260132645542
E02004083,Hallam Fields & Greenwood Ave,Erewash,East Midlands,1543,5195,391,405,303,329,6623,1449,5360,359,374,326,314,6733,1054,311,358,319,306,2348,0.196641791044776,0.866295264623956,0.957219251336898,0.978527607361963,0.974522292993631,0.348730135155206
E02004084,Kirk Hallam,Erewash,East Midlands,1194,3641,292,330,280,445,4988,1151,3771,321,322,280,387,5081,804,264,298,271,378,2015,0.213206046141607,0.822429906542056,0.925465838509317,0.967857142857143,0.976744186046512,0.396575477268254
E02004085,Sandiacre & Stanton,Erewash,East Midlands,1694,5356,469,529,384,666,7404,1593,5470,479,517,407,630,7503,1319,426,489,387,596,3217,0.241133455210238,0.889352818371608,0.945841392649903,0.950859950859951,0.946031746031746,0.428761828601893
E02004086,Borrowash & Ockbrook,Erewash,East Midlands,1275,4267,417,506,354,529,6073,1195,4627,445,448,407,514,6441,1109,399,432,399,495,2834,0.239680138318565,0.896629213483146,0.964285714285714,0.98034398034398,0.963035019455253,0.439993789784195
E02004087,Long Eaton North,Erewash,East Midlands,1496,5028,389,367,237,382,6403,1522,5250,385,384,257,380,6656,1082,338,359,240,362,2381,0.206095238095238,0.877922077922078,0.934895833333333,0.933852140077821,0.952631578947368,0.357722355769231
E02004088,Long Eaton West,Erewash,East Midlands,1269,4764,485,528,313,434,6524,1192,4853,494,515,370,442,6674,1028,470,497,358,430,2783,0.211827735421389,0.951417004048583,0.96504854368932,0.967567567567568,0.972850678733032,0.416991309559485
E02004089,Long Eaton Town,Erewash,East Midlands,1329,4964,245,229,198,278,5914,1250,5054,271,259,188,262,6034,781,218,236,178,239,1652,0.154531064503364,0.804428044280443,0.911196911196911,0.946808510638298,0.912213740458015,0.273781902552204
E02004090,Breaston & Draycott,Erewash,East Midlands,968,3707,352,415,302,483,5259,909,3737,398,424,316,427,5302,942,371,410,295,413,2431,0.252073856034252,0.9321608040201,0.966981132075472,0.933544303797468,0.967213114754098,0.45850622406639
E02004091,Long Eaton South,Erewash,East Midlands,1552,5923,510,510,405,491,7839,1502,6195,502,552,406,471,8126,1184,446,522,390,455,2997,0.191121872477805,0.888446215139442,0.945652173913043,0.960591133004926,0.966029723991507,0.368816145705144
E02004092,Sawley,Erewash,East Midlands,1859,6084,492,555,432,505,8068,1739,6078,505,527,464,522,8096,1151,454,492,439,500,3036,0.18937150378414,0.899009900990099,0.933586337760911,0.946120689655172,0.957854406130268,0.375
E02006828,Shipley,Erewash,East Midlands,1256,4562,363,377,184,249,5735,1228,4796,367,403,235,244,6045,971,314,379,223,235,2122,0.202460383653044,0.85558583106267,0.940446650124069,0.948936170212766,0.963114754098361,0.351033912324235
E02004093,Hadfield East & Tintwistle,High Peak,East Midlands,1136,4100,362,307,199,254,5222,1126,4321,390,342,210,241,5504,680,320,325,202,226,1753,0.15737097894006,0.82051282051282,0.950292397660819,0.961904761904762,0.937759336099585,0.318495639534884
E02004094,Hadfield West & Gamesley,High Peak,East Midlands,1529,4585,359,357,274,262,5837,1502,4737,339,350,243,289,5958,701,254,337,237,271,1800,0.147983956090353,0.749262536873156,0.962857142857143,0.975308641975309,0.937716262975779,0.302114803625378
E02004095,Glossop,High Peak,East Midlands,1710,6602,588,547,349,393,8479,1683,6907,536,581,365,457,8846,1096,407,542,353,435,2833,0.158679600405386,0.759328358208955,0.932874354561102,0.967123287671233,0.951859956236324,0.320257743612932
E02004096,"Dinting, Simmondley & Charlesworth",High Peak,East Midlands,1639,5677,681,667,438,555,8018,1633,6204,679,661,510,529,8583,1047,589,640,500,503,3279,0.168762088974855,0.867452135493373,0.968229954614221,0.980392156862745,0.950850661625709,0.382034253757428
E02004097,New Mills West & Furness Vale,High Peak,East Midlands,1162,4979,503,565,310,341,6698,1083,5015,483,516,368,337,6719,903,398,492,353,322,2468,0.180059820538385,0.824016563146998,0.953488372093023,0.959239130434783,0.955489614243323,0.367316564965025
E02004098,New Mills East & Hayfield,High Peak,East Midlands,1253,4371,475,473,331,363,6013,1246,4857,484,499,327,361,6528,1012,395,477,312,353,2549,0.208359069384394,0.816115702479339,0.955911823647295,0.954128440366972,0.977839335180055,0.39047181372549
E02004100,Whaley Bridge & Chinley,High Peak,East Midlands,1268,4797,545,509,340,474,6665,1379,5254,591,546,402,477,7270,1023,495,517,392,461,2888,0.194708793300343,0.83756345177665,0.946886446886447,0.975124378109453,0.966457023060797,0.397248968363136
E02004102,Buxton North,High Peak,East Midlands,1076,5438,534,460,334,616,7382,932,5320,515,514,382,660,7391,1153,291,482,365,617,2908,0.216729323308271,0.56504854368932,0.937743190661479,0.955497382198953,0.934848484848485,0.393451495061561
E02004103,Buxton South & East,High Peak,East Midlands,1574,4386,332,313,239,314,5584,1545,4625,355,310,245,323,5858,1178,201,288,232,307,2206,0.254702702702703,0.566197183098592,0.929032258064516,0.946938775510204,0.95046439628483,0.376579037214066
E02004104,Buxton Burbage & Harpur Hill,High Peak,East Midlands,1286,4476,450,448,343,374,6091,1269,4617,457,452,337,403,6266,1149,310,433,326,386,2604,0.248862897985705,0.678336980306346,0.957964601769912,0.967359050445104,0.957816377171216,0.415576125119694
E02006872,Chapel-en-le-Frith & Hope Valley,High Peak,East Midlands,2167,7691,881,912,599,794,10877,2027,7922,858,897,671,814,11162,1536,745,863,652,783,4579,0.193890431709164,0.868298368298368,0.962095875139353,0.971684053651267,0.961916461916462,0.410231141372514
E02004105,Killamarsh,North East Derbyshire,East Midlands,1530,6063,605,578,303,421,7970,1570,6183,618,620,363,408,8192,1545,582,599,348,395,3469,0.249878699660359,0.941747572815534,0.966129032258065,0.958677685950413,0.968137254901961,0.4234619140625
E02004106,Eckington West & Coal Aston,North East Derbyshire,East Midlands,913,3704,538,600,463,529,5834,862,3883,518,624,484,606,6115,1007,436,598,470,587,3098,0.259335565284574,0.841698841698842,0.958333333333333,0.971074380165289,0.968646864686469,0.506623058053966
E02004108,Dronfield Town & Unstone,North East Derbyshire,East Midlands,1258,4434,400,494,395,573,6296,1224,4660,377,427,403,578,6445,1149,344,411,391,547,2842,0.24656652360515,0.912466843501326,0.962529274004684,0.970223325062035,0.94636678200692,0.440961986035687
E02004109,Dronfield Woodhouse & Holmesfield,North East Derbyshire,East Midlands,1056,3450,515,643,447,602,5657,1066,3714,485,620,522,622,5963,947,445,605,504,600,3101,0.254981152396338,0.917525773195876,0.975806451612903,0.96551724137931,0.964630225080386,0.520040248197216
E02004110,Dronfield South & Gosforth Lane,North East Derbyshire,East Midlands,1288,4103,513,581,434,462,6093,1307,4409,531,517,483,533,6473,1089,487,501,473,521,3071,0.246994783397596,0.91713747645951,0.969052224371373,0.979296066252588,0.977485928705441,0.47443225706782
E02004111,Arkwright Town & Temple Normanton,North East Derbyshire,East Midlands,859,3420,375,420,279,362,4856,851,3386,377,400,311,382,4856,994,336,377,294,360,2361,0.293561724748966,0.891246684350133,0.9425,0.945337620578778,0.942408376963351,0.486202635914333
E02004112,Wingerworth & Holymoorside,North East Derbyshire,East Midlands,826,3440,535,655,444,569,5643,779,3502,500,616,497,608,5723,913,449,589,475,584,3010,0.26070816676185,0.898,0.956168831168831,0.955734406438632,0.960526315789474,0.525947929407653
E02004113,Grassmoor & Holmewood,North East Derbyshire,East Midlands,1991,6170,530,472,328,459,7959,1984,6297,538,488,381,451,8155,1642,438,464,372,436,3352,0.260759091630935,0.814126394052045,0.950819672131147,0.976377952755906,0.966740576496674,0.411036174126303
E02004114,Ashover & New Tupton,North East Derbyshire,East Midlands,1074,4370,578,668,502,559,6677,1157,4671,594,629,537,638,7069,1093,503,592,516,614,3318,0.23399700278313,0.846801346801347,0.941176470588235,0.960893854748603,0.962382445141066,0.469373320130146
E02004115,North Wingfield & Pilsley,North East Derbyshire,East Midlands,1372,5801,583,574,436,472,7866,1264,5490,573,539,435,472,7509,1522,467,522,418,456,3385,0.277231329690346,0.815008726003491,0.968460111317254,0.960919540229885,0.966101694915254,0.450792382474364
E02004116,Clay Cross,North East Derbyshire,East Midlands,1464,4964,482,489,341,433,6709,1539,5309,463,485,397,461,7115,1351,366,454,379,433,2983,0.254473535505745,0.790496760259179,0.936082474226804,0.954659949622166,0.939262472885033,0.419255094869993
E02004117,"Stonebroom, Shirland & Wessington",North East Derbyshire,East Midlands,1411,4553,530,526,391,451,6451,1440,4855,526,537,408,469,6795,1116,464,515,393,456,2944,0.229866117404737,0.88212927756654,0.95903165735568,0.963235294117647,0.97228144989339,0.433259749816041
E02006804,Eckington East & Renishaw,North East Derbyshire,East Midlands,1563,5202,429,426,307,482,6846,1503,5394,424,422,328,472,7040,1271,308,404,313,450,2746,0.235632183908046,0.726415094339623,0.957345971563981,0.954268292682927,0.953389830508475,0.390056818181818
E02004118,Hatton & Burnaston,South Derbyshire,East Midlands,1211,4746,389,357,240,361,6093,1353,5024,407,393,268,361,6453,1345,382,372,257,347,2703,0.267714968152866,0.938574938574938,0.946564885496183,0.958955223880597,0.961218836565097,0.418874941887494
E02004119,Hilton & Etwall,South Derbyshire,East Midlands,2575,7639,483,478,369,451,9420,2471,7618,487,487,388,472,9452,1961,460,472,374,458,3725,0.257416644788658,0.944558521560575,0.969199178644764,0.963917525773196,0.970338983050847,0.39409648751587
E02004120,"Willington North, Findern & Stenson Fields",South Derbyshire,East Midlands,1953,6285,607,464,286,374,8016,2136,7003,624,539,335,360,8861,1603,575,514,323,341,3356,0.228901899186063,0.921474358974359,0.953617810760668,0.964179104477612,0.947222222222222,0.378738291389234
E02004121,Aston-on-Trent & Barrow-upon-Trent,South Derbyshire,East Midlands,1526,5160,435,491,315,456,6857,1747,5754,455,471,392,504,7576,1438,418,450,375,478,3159,0.249913103927702,0.918681318681319,0.955414012738854,0.956632653061224,0.948412698412698,0.416974656810982
E02004122,Willington South & Repton,South Derbyshire,East Midlands,1195,4246,466,499,277,378,5866,1185,4362,441,448,336,354,5941,925,415,434,327,348,2449,0.21205868867492,0.941043083900227,0.96875,0.973214285714286,0.983050847457627,0.412220164955395
E02004123,"Melbourne, Ticknall & Hartshorne",South Derbyshire,East Midlands,1132,4160,455,408,285,452,5760,1099,4189,490,427,313,470,5889,1014,452,408,305,456,2635,0.242062544760086,0.922448979591837,0.955503512880562,0.97444089456869,0.970212765957447,0.447444387841739
E02004124,Swadlincote North,South Derbyshire,East Midlands,1505,4769,426,453,307,383,6338,1493,4951,417,439,325,401,6533,1091,330,424,314,388,2547,0.220359523328621,0.79136690647482,0.965831435079727,0.966153846153846,0.967581047381546,0.389866829940303
E02004125,Swadlincote West,South Derbyshire,East Midlands,1750,5691,561,527,306,405,7490,1587,5644,532,523,371,399,7469,1252,407,509,362,379,2909,0.221828490432318,0.765037593984962,0.973231357552581,0.975741239892183,0.949874686716792,0.389476502878565
E02004126,Swadlincote Central,South Derbyshire,East Midlands,1236,4628,488,424,295,400,6235,1316,4814,508,488,310,387,6507,1109,388,466,302,377,2642,0.230369754881595,0.763779527559055,0.954918032786885,0.974193548387097,0.974160206718346,0.406024281542954
E02004128,"Castle Gresley, Overseal & Coton",South Derbyshire,East Midlands,1851,7054,699,760,546,555,9614,1945,7089,679,764,567,619,9718,1557,563,731,547,583,3981,0.219636055861193,0.829160530191458,0.956806282722513,0.964726631393298,0.941841680129241,0.409652191809014
E02006919,Swadlincote South,South Derbyshire,East Midlands,2358,7363,417,382,250,306,8718,2230,6967,422,396,243,256,8284,1513,314,367,231,242,2667,0.217166642744366,0.744075829383886,0.926767676767677,0.950617283950617,0.9453125,0.321945919845485
E02006920,Swadlincote East,South Derbyshire,East Midlands,1859,5680,337,325,182,179,6703,1733,5526,356,330,203,218,6633,1169,265,312,195,207,2148,0.211545421643142,0.74438202247191,0.945454545454546,0.960591133004926,0.94954128440367,0.323835368611488
E02005334,Leicester Forest East,Blaby,East Midlands,1160,3778,297,257,213,387,4932,1159,3861,294,235,217,305,4912,928,262,223,208,288,1909,0.24035224035224,0.891156462585034,0.948936170212766,0.95852534562212,0.944262295081967,0.38864006514658
E02005335,Kirby Muxloe & Thurlaston,Blaby,East Midlands,1338,4176,424,458,333,587,5978,1281,4410,414,453,373,688,6338,1103,387,436,365,654,2945,0.250113378684807,0.934782608695652,0.962472406181016,0.978552278820375,0.950581395348837,0.464657620700536
E02005336,Thorpe Astley,Blaby,East Midlands,1591,4994,257,243,142,235,5871,1620,4952,293,224,168,249,5886,971,252,212,158,235,1828,0.19608239095315,0.860068259385666,0.946428571428571,0.940476190476191,0.943775100401606,0.310567448182127
E02005337,Braunstone Town,Blaby,East Midlands,1860,6219,452,467,386,578,8102,1915,6598,503,487,389,587,8564,1308,441,457,356,549,3111,0.198241891482267,0.876739562624255,0.938398357289528,0.915167095115681,0.93526405451448,0.363264829518916
E02005338,Enderby & Glen Parva,Blaby,East Midlands,2181,6689,525,578,333,577,8702,2161,7119,550,577,378,578,9202,1531,508,549,358,546,3492,0.215058294704312,0.923636363636364,0.951473136915078,0.947089947089947,0.944636678200692,0.379482721147577
E02005339,Narborough,Blaby,East Midlands,1625,5376,489,508,289,389,7051,1560,5511,491,526,351,397,7276,1161,450,501,342,381,2835,0.210669569951007,0.916496945010183,0.952471482889734,0.974358974358974,0.959697732997481,0.389637163276526
E02005340,Blaby Village,Blaby,East Midlands,1534,5373,478,520,452,550,7373,1486,5497,503,517,483,586,7586,1253,470,498,472,565,3258,0.227942514098599,0.934393638170974,0.963249516441006,0.977225672877847,0.964163822525597,0.429475349327709
E02005341,Whetstone,Blaby,East Midlands,1568,5008,322,364,229,334,6257,1463,5011,325,380,232,322,6270,1052,293,364,227,309,2245,0.209938136100579,0.901538461538462,0.957894736842105,0.978448275862069,0.959627329192547,0.358054226475279
E02005342,"Cosby, Croft & Elmesthorpe",Blaby,East Midlands,1429,4196,467,466,352,353,5834,1403,4504,442,492,374,411,6223,996,411,478,366,394,2645,0.22113676731794,0.929864253393665,0.971544715447154,0.978609625668449,0.958637469586375,0.425036156194761
E02005343,Countesthorpe & Kilby,Blaby,East Midlands,1482,4396,559,511,346,421,6233,1511,4891,499,553,394,452,6789,1181,465,540,387,433,3006,0.241463913310162,0.93186372745491,0.976491862567812,0.982233502538071,0.957964601769912,0.442775077330977
E02005344,"Stoney Stanton, Sapcote & Sharnford",Blaby,East Midlands,1730,5058,519,620,386,459,7042,1721,5405,523,596,450,509,7483,1167,479,565,437,491,3139,0.2159111933395,0.915869980879541,0.947986577181208,0.971111111111111,0.964636542239686,0.419484164105305
E02006820,Glenfield,Blaby,East Midlands,1869,6247,655,685,420,777,8784,1848,6536,625,771,494,770,9196,1704,560,718,463,733,4178,0.260709914320685,0.896,0.931258106355383,0.937246963562753,0.951948051948052,0.454327968682036
E02005345,Loughborough Dishley & Hathern,Charnwood,East Midlands,1138,4200,406,387,257,258,5508,1107,4174,455,402,269,266,5566,655,379,390,258,251,1933,0.156923814087207,0.832967032967033,0.970149253731343,0.95910780669145,0.943609022556391,0.347287100251527
E02005346,Loughborough Lemyngton & Hastings,Charnwood,East Midlands,2410,9316,455,317,228,412,10728,2297,10021,504,380,239,394,11538,1128,306,321,214,339,2308,0.112563616405548,0.607142857142857,0.844736842105263,0.895397489539749,0.860406091370558,0.200034668053389
E02005347,Loughborough Storer & Queen's Park,Charnwood,East Midlands,1028,9207,312,250,177,301,10247,973,8990,320,276,186,322,10094,668,216,249,167,299,1599,0.0743047830923248,0.675,0.902173913043478,0.897849462365591,0.928571428571429,0.15841093719041
E02005348,Loughborough Garendon,Charnwood,East Midlands,686,3458,453,430,317,324,4982,740,3536,401,473,344,366,5120,510,324,445,332,341,1952,0.144230769230769,0.807980049875312,0.940803382663848,0.965116279069768,0.931693989071038,0.38125
E02005349,Shepshed West,Charnwood,East Midlands,1372,4495,439,427,312,406,6079,1398,4766,471,467,370,410,6484,769,381,447,359,391,2347,0.161351237935376,0.808917197452229,0.957173447537473,0.97027027027027,0.953658536585366,0.361967921036397
E02005350,Shepshed East,Charnwood,East Midlands,1079,4043,438,437,265,346,5529,1071,4203,456,429,284,389,5761,737,357,410,274,367,2145,0.175350939804901,0.782894736842105,0.955710955710956,0.964788732394366,0.943444730077121,0.372331192501302
E02005351,Loughborough - University,Charnwood,East Midlands,1142,10649,268,257,204,278,11656,1117,12612,263,251,219,268,13613,583,204,239,209,260,1495,0.0462258166825246,0.775665399239544,0.952191235059761,0.954337899543379,0.970149253731343,0.109821494159994
E02005352,"Wymeswold, Rearsby & Cossington",Charnwood,East Midlands,1161,3873,409,373,264,372,5291,1117,3997,425,397,287,359,5465,942,387,382,279,338,2328,0.235676757568176,0.910588235294118,0.962216624685139,0.97212543554007,0.94150417827298,0.425983531564501
E02005353,Loughborough - Shelthorpe & Woodthorpe,Charnwood,East Midlands,2095,7229,424,426,261,343,8683,2153,7676,418,425,312,389,9220,1073,290,388,289,369,2409,0.139786347055758,0.69377990430622,0.912941176470588,0.926282051282051,0.948586118251928,0.261279826464208
E02005354,Loughborough - Outwoods,Charnwood,East Midlands,1812,6306,535,517,402,742,8502,1788,6502,582,530,443,738,8795,1051,487,515,434,705,3192,0.161642571516456,0.836769759450172,0.971698113207547,0.979683972911964,0.955284552845528,0.362933484934622
E02005355,Barrow upon Soar,Charnwood,East Midlands,1384,4395,447,457,310,392,6001,1324,4548,441,482,354,392,6217,1104,385,459,338,381,2667,0.242744063324538,0.873015873015873,0.952282157676349,0.954802259887006,0.971938775510204,0.428985041016568
E02005356,Quorn & Mountsorrel Castle,Charnwood,East Midlands,1329,4383,421,467,329,449,6049,1241,4652,407,504,351,475,6389,951,351,483,330,461,2576,0.204428202923474,0.862407862407862,0.958333333333333,0.94017094017094,0.970526315789474,0.403192987948036
E02005357,Sileby,Charnwood,East Midlands,1717,5489,431,344,227,322,6813,1706,5430,411,365,254,321,6781,1320,381,352,243,309,2605,0.243093922651934,0.927007299270073,0.964383561643836,0.956692913385827,0.962616822429906,0.384161628078455
E02005358,Mountsorrel & Rothley,Charnwood,East Midlands,2300,7298,536,569,390,571,9364,2398,7650,577,550,451,599,9827,1634,510,520,433,579,3676,0.21359477124183,0.883882149046794,0.945454545454546,0.960088691796009,0.96661101836394,0.374071435840033
E02005359,East Goscote & Queniborough,Charnwood,East Midlands,1348,4169,423,484,322,370,5768,1432,4586,443,500,357,432,6318,1201,402,485,340,416,2844,0.261883994766681,0.90744920993228,0.97,0.952380952380952,0.962962962962963,0.45014245014245
E02005360,"Thurcaston, Woodhouse & Bradgate",Charnwood,East Midlands,1050,3909,466,449,333,485,5642,1002,3881,453,497,340,471,5642,930,405,472,330,455,2592,0.239628961607833,0.894039735099338,0.949698189134809,0.970588235294118,0.966029723991507,0.45941155618575
E02005361,Syston West,Charnwood,East Midlands,1115,4345,385,333,231,330,5624,1027,4306,397,348,254,350,5655,1086,364,332,244,327,2353,0.252206223873665,0.916876574307305,0.954022988505747,0.960629921259842,0.934285714285714,0.416091954022988
E02005362,Syston East,Charnwood,East Midlands,1491,4526,388,444,222,365,5945,1470,4662,401,445,312,393,6213,1083,368,419,300,378,2548,0.232303732303732,0.917705735660848,0.941573033707865,0.961538461538461,0.961832061068702,0.410107838403348
E02005363,Birstall Wanlip & Riverside,Charnwood,East Midlands,1687,5173,424,516,353,653,7119,1676,5476,427,488,361,652,7404,1215,380,470,349,631,3045,0.221877282688094,0.889929742388759,0.963114754098361,0.966759002770083,0.967791411042945,0.411264181523501
E02005364,Birstall Central,Charnwood,East Midlands,999,3372,281,248,190,258,4349,911,3501,289,238,210,298,4536,740,251,220,197,287,1695,0.211368180519851,0.868512110726644,0.92436974789916,0.938095238095238,0.963087248322148,0.373677248677249
E02005365,Thurmaston,Charnwood,East Midlands,1843,6333,560,503,472,555,8423,1768,6303,629,562,453,568,8515,1429,556,516,419,530,3450,0.22671743614152,0.883942766295708,0.918149466192171,0.924944812362031,0.933098591549296,0.405167351732237
E02005366,Anstey,Charnwood,East Midlands,1357,4410,397,472,296,431,6006,1423,4521,371,466,365,421,6144,932,332,453,355,410,2482,0.206149082061491,0.894878706199461,0.972103004291846,0.972602739726027,0.973871733966746,0.403971354166667
E02005368,"Tilton, Billesdon & Great Easton",Harborough,East Midlands,1043,3754,407,476,296,374,5307,996,3861,448,456,334,397,5496,836,414,428,321,380,2379,0.216524216524217,0.924107142857143,0.93859649122807,0.961077844311377,0.957178841309824,0.432860262008734
E02005369,Kibworth & Great Glen,Harborough,East Midlands,2473,6969,704,714,517,745,9649,2364,7309,698,746,564,747,10064,1955,651,710,548,722,4586,0.267478451224518,0.932664756446991,0.951742627345844,0.971631205673759,0.966532797858099,0.455683624801272
E02005370,Broughton Astley,Harborough,East Midlands,1840,5778,532,482,269,319,7380,1787,6152,551,541,311,374,7929,1286,515,518,301,359,2979,0.209037711313394,0.934664246823956,0.957486136783734,0.967845659163987,0.959893048128342,0.375709421112372
E02005371,"Fleckney, Kilworth & Foxton",Harborough,East Midlands,1785,6178,644,707,429,509,8467,1723,6484,662,697,495,566,8904,1619,611,657,473,544,3904,0.249691548426897,0.922960725075529,0.942611190817791,0.955555555555556,0.96113074204947,0.438454627133872
E02005372,"Dunton Bassett, Claybrooke & Swinford",Harborough,East Midlands,1594,5908,677,638,417,543,8183,1569,6209,632,663,486,559,8549,1189,581,632,471,536,3409,0.191496215171525,0.919303797468354,0.953242835595777,0.969135802469136,0.958855098389982,0.398760088899286
E02005373,"Market Harborough West, Great Bowden & Lubenham",Harborough,East Midlands,2054,6804,666,723,545,593,9331,2097,7351,690,773,583,629,10026,1793,642,752,560,617,4364,0.243912392871718,0.930434782608696,0.972833117723157,0.960548885077187,0.980922098569157,0.435268302413724
E02005374,Market Harborough Central,Harborough,East Midlands,1174,4070,376,356,275,632,5709,1038,4232,373,351,295,522,5773,964,336,327,282,499,2408,0.227788279773157,0.900804289544236,0.931623931623932,0.95593220338983,0.955938697318008,0.417114152087303
E02005375,Market Harborough South & Little Bowden,Harborough,East Midlands,1901,5842,447,545,360,578,7772,1762,5839,456,554,430,665,7944,1430,419,517,412,641,3419,0.24490494947765,0.918859649122807,0.933212996389892,0.958139534883721,0.96390977443609,0.430387713997986
E02005376,Lutterworth,Harborough,East Midlands,1959,6212,542,644,432,600,8430,1898,6596,558,637,538,631,8960,1183,506,615,521,609,3434,0.179351121892056,0.906810035842294,0.965463108320251,0.968401486988848,0.96513470681458,0.383258928571429
E02006816,"Houghton, Thurby & Scraptoft",Harborough,East Midlands,1387,4503,531,440,341,554,6369,1491,4966,516,470,376,604,6932,1378,465,456,353,580,3232,0.277486910994764,0.901162790697675,0.970212765957447,0.938829787234043,0.960264900662252,0.466243508366994
E02005377,Markfield & Thornton,Hinckley and Bosworth,East Midlands,1602,5082,562,567,443,539,7193,1652,5444,528,631,462,568,7633,1351,477,608,443,542,3421,0.248163115356356,0.903409090909091,0.963549920760697,0.958874458874459,0.954225352112676,0.448185510284292
E02005378,Groby East,Hinckley and Bosworth,East Midlands,954,3222,338,282,255,297,4394,972,3294,360,308,242,329,4533,805,344,288,235,316,1988,0.244383727990285,0.955555555555556,0.935064935064935,0.971074380165289,0.96048632218845,0.438561658945511
E02005379,Groby West & Ratby,Hinckley and Bosworth,East Midlands,1151,3735,399,423,260,359,5176,1051,3756,380,434,294,382,5246,951,342,420,286,366,2365,0.253194888178914,0.9,0.967741935483871,0.972789115646258,0.958115183246073,0.450819672131148
E02005380,"Market Bosworth, Barlestone & Sheepy Magna",Hinckley and Bosworth,East Midlands,1470,5165,656,701,451,510,7483,1386,5252,681,692,485,564,7674,1081,551,671,474,547,3324,0.205826351865956,0.809104258443466,0.969653179190751,0.977319587628866,0.969858156028369,0.433150899139953
E02005381,Desford & Newbold Verdon,Hinckley and Bosworth,East Midlands,1549,4869,651,624,452,560,7156,1678,5307,630,648,518,564,7667,1333,541,632,506,544,3556,0.251177689843603,0.858730158730159,0.975308641975309,0.976833976833977,0.964539007092199,0.463805921481675
E02005382,Earl Shilton,Hinckley and Bosworth,East Midlands,1985,6696,618,637,385,557,8893,1829,6661,579,639,450,580,8909,1791,518,601,432,554,3896,0.26887854676475,0.894645941278066,0.940532081377152,0.96,0.955172413793104,0.437310584801886
E02005383,Barwell,Hinckley and Bosworth,East Midlands,1597,5732,494,584,361,470,7641,1611,5972,538,580,396,446,7932,1290,484,551,382,429,3136,0.216008037508372,0.899628252788104,0.95,0.964646464646465,0.961883408071749,0.395360564800807
E02005384,"Stoke Golding, Higham & Fenny Drayton",Hinckley and Bosworth,East Midlands,1323,4464,451,451,294,417,6077,1180,4650,440,434,375,461,6360,849,387,413,356,438,2443,0.18258064516129,0.879545454545455,0.951612903225806,0.949333333333333,0.950108459869848,0.384119496855346
E02005385,Hinckley East,Hinckley and Bosworth,East Midlands,1093,3789,448,476,296,383,5392,1053,3935,432,495,321,429,5612,818,411,481,310,413,2433,0.207878017789072,0.951388888888889,0.971717171717172,0.965732087227414,0.962703962703963,0.433535281539558
E02005386,Hinckley Central,Hinckley and Bosworth,East Midlands,1509,5920,405,371,322,503,7521,1542,6341,402,423,327,470,7963,1095,351,402,308,441,2597,0.172685696262419,0.873134328358209,0.950354609929078,0.941896024464832,0.938297872340426,0.32613336682155
E02005387,Hinckley West,Hinckley and Bosworth,East Midlands,1997,6459,517,539,277,303,8095,1946,6546,508,520,373,317,8264,1180,458,485,358,300,2781,0.180262755881454,0.901574803149606,0.932692307692308,0.959785522788204,0.946372239747634,0.336519845111326
E02005388,Hinckley Clarendon Park,Hinckley and Bosworth,East Midlands,1184,3790,326,327,195,319,4957,1168,4142,273,341,214,299,5269,744,244,319,206,286,1799,0.179623370352487,0.893772893772894,0.935483870967742,0.962616822429906,0.956521739130435,0.341431011577149
E02005389,Burbage St Catherines,Hinckley and Bosworth,East Midlands,968,3275,382,408,293,549,4907,962,3498,374,395,331,564,5162,687,335,376,320,537,2255,0.196397941680961,0.89572192513369,0.951898734177215,0.966767371601209,0.952127659574468,0.436846183649748
E02005390,Burbage Sketchley & Stretton,Hinckley and Bosworth,East Midlands,1754,5812,682,700,404,517,8115,1777,6189,650,732,491,595,8657,1287,611,709,477,565,3649,0.207949587978672,0.94,0.968579234972678,0.971486761710794,0.949579831932773,0.42150860575257
E02005391,"Bottesford, Harby & Croxton Kerrial",Melton,East Midlands,1660,5629,712,714,460,555,8070,1574,5917,715,722,509,616,8479,1121,670,698,497,596,3582,0.189454115261112,0.937062937062937,0.966759002770083,0.976424361493124,0.967532467532468,0.422455478240359
E02005392,Melton Mowbray North,Melton,East Midlands,1660,5413,526,537,411,554,7441,1583,5710,532,592,450,595,7879,1134,497,566,439,577,3213,0.198598949211909,0.93421052631579,0.956081081081081,0.975555555555555,0.969747899159664,0.407792867115116
E02005393,"Asfordby, Frisby & Old Dalby",Melton,East Midlands,1178,4317,538,425,326,386,5992,1225,4520,497,516,332,432,6297,1026,464,502,321,415,2728,0.226991150442478,0.933601609657948,0.972868217054264,0.966867469879518,0.960648148148148,0.433222169286962
E02005394,Melton Mowbray West,Melton,East Midlands,2045,5812,557,558,311,483,7721,2007,5903,535,547,382,485,7852,1156,489,532,369,470,3016,0.195832627477554,0.914018691588785,0.972577696526508,0.965968586387435,0.969072164948454,0.384105960264901
E02005395,Melton Mowbray South,Melton,East Midlands,1481,5360,541,519,403,499,7322,1420,5675,563,548,418,542,7746,1124,513,511,401,526,3075,0.198061674008811,0.911190053285968,0.932481751824817,0.95933014354067,0.970479704797048,0.396979085979861
E02005396,"Waltham, Wymondham & Great Dalby",Melton,East Midlands,969,3880,487,536,337,430,5670,956,4142,495,556,374,466,6033,842,457,520,366,445,2630,0.20328343795268,0.923232323232323,0.935251798561151,0.978609625668449,0.954935622317597,0.435935687054533
E02005397,Castle Donington,North West Leicestershire,East Midlands,1602,5682,572,565,387,390,7596,1544,6021,542,568,426,444,8001,1177,503,535,407,429,3051,0.195482477993689,0.928044280442804,0.941901408450704,0.955399061032864,0.966216216216216,0.38132733408324
E02005398,Kegworth & Belton,North West Leicestershire,East Midlands,975,4234,397,400,274,348,5653,921,4270,394,415,291,363,5733,765,359,393,277,344,2138,0.179156908665105,0.911167512690355,0.946987951807229,0.951890034364261,0.947658402203857,0.372928658642944
E02005399,Ashby de la Zouch North,North West Leicestershire,East Midlands,1716,4949,437,433,268,357,6444,1566,5024,413,483,301,326,6547,837,387,466,281,317,2288,0.166600318471338,0.937046004842615,0.9648033126294,0.933554817275748,0.97239263803681,0.349473041087521
E02005400,Thringstone & Swannington,North West Leicestershire,East Midlands,989,3296,457,490,264,347,4854,967,3379,427,469,335,364,4974,667,387,452,322,343,2171,0.197395679195028,0.90632318501171,0.963752665245203,0.961194029850746,0.942307692307692,0.436469642139123
E02005401,"Packington, Ravenstone & Coleorton",North West Leicestershire,East Midlands,1138,3828,411,427,266,349,5281,1083,3977,423,421,308,315,5444,769,386,404,296,301,2156,0.193361830525522,0.912529550827423,0.959619952494062,0.961038961038961,0.955555555555556,0.396032329169728
E02005402,Ashby de la Zouch South,North West Leicestershire,East Midlands,1247,3795,408,495,293,452,5443,1217,4007,400,493,340,468,5708,780,382,482,333,455,2432,0.194659346144248,0.955,0.977687626774848,0.979411764705882,0.972222222222222,0.426068675543097
E02005403,Whitwick,North West Leicestershire,East Midlands,1032,4141,422,436,376,446,5821,963,4125,402,418,374,431,5750,793,366,396,361,411,2327,0.192242424242424,0.91044776119403,0.947368421052632,0.96524064171123,0.953596287703016,0.404695652173913
E02005404,Donisthope & Blackfordby,North West Leicestershire,East Midlands,1591,5264,487,463,282,363,6859,1570,5465,468,487,319,390,7129,1102,416,471,307,372,2668,0.201646843549863,0.888888888888889,0.967145790554415,0.962382445141066,0.953846153846154,0.374246037312386
E02005405,Agar Nook,North West Leicestershire,East Midlands,1308,4144,405,487,276,399,5711,1385,4439,422,498,323,416,6098,885,377,470,307,395,2434,0.199369227303447,0.893364928909953,0.943775100401606,0.95046439628483,0.949519230769231,0.399147261397179
E02005406,Coalville,North West Leicestershire,East Midlands,1629,5423,341,277,214,298,6553,1594,5496,349,280,226,322,6673,943,290,255,205,294,1987,0.171579330422125,0.830945558739255,0.910714285714286,0.907079646017699,0.91304347826087,0.297767121234827
E02005407,Hugglescote & Bardon Hill,North West Leicestershire,East Midlands,1967,6724,418,486,300,342,8270,1991,7006,442,471,336,368,8623,1306,404,442,320,355,2827,0.186411647159578,0.914027149321267,0.938428874734607,0.952380952380952,0.964673913043478,0.327844137771077
E02005408,Measham & Appleby Magna,North West Leicestershire,East Midlands,1471,4993,485,448,323,311,6560,1416,5077,490,444,357,346,6714,977,458,422,348,332,2537,0.192436478235178,0.93469387755102,0.95045045045045,0.974789915966386,0.959537572254335,0.377867143282693
E02005409,Ibstock & Ellistown,North West Leicestershire,East Midlands,2330,7366,655,632,422,496,9571,2301,7523,609,662,475,536,9805,1321,484,629,453,500,3387,0.175594842483052,0.794745484400657,0.950151057401813,0.953684210526316,0.932835820895522,0.345436002039776
E02005412,Oadby South & West,Oadby and Wigston,East Midlands,1652,4927,471,469,394,809,7070,1762,5364,502,488,395,801,7550,1298,421,455,376,757,3307,0.241983594332588,0.838645418326693,0.932377049180328,0.951898734177215,0.945068664169788,0.438013245033113
E02005414,Wigston Town,Oadby and Wigston,East Midlands,1576,4740,435,393,288,730,6586,1633,5269,429,413,300,618,7029,1001,380,391,284,594,2650,0.189979123173278,0.885780885780886,0.946731234866828,0.946666666666667,0.961165048543689,0.377009531939109
E02005415,South Wigston,Oadby and Wigston,East Midlands,1563,4980,372,345,321,474,6492,1626,5314,385,362,321,499,6881,1038,340,334,309,466,2487,0.195333082423786,0.883116883116883,0.922651933701657,0.962616822429906,0.933867735470942,0.361430024705711
E02005416,Wigston Harcourt & Little Hill,Oadby and Wigston,East Midlands,1366,4776,565,709,469,531,7050,1343,5300,601,720,525,603,7749,1189,548,689,504,579,3509,0.224339622641509,0.911813643926789,0.956944444444444,0.96,0.960199004975124,0.452832623564331
E02006818,Wigston North,Oadby and Wigston,East Midlands,1495,4786,417,425,353,729,6710,1532,5221,427,429,381,671,7129,1134,384,401,365,634,2918,0.217199770158973,0.899297423887588,0.934731934731935,0.958005249343832,0.944858420268256,0.409314069294431
E02006911,Oadby North & East,Oadby and Wigston,East Midlands,2854,9938,697,676,478,812,12601,2882,11363,721,712,509,834,14139,2914,640,664,471,778,5467,0.256446360996216,0.887656033287101,0.932584269662921,0.925343811394892,0.932853717026379,0.38666100855789
E02005417,Leake & Butterwick,Boston,East Midlands,1084,4289,596,579,408,512,6384,1120,5709,610,577,447,538,7881,1240,543,526,422,512,3243,0.217200910842529,0.89016393442623,0.911611785095321,0.94407158836689,0.951672862453531,0.411496003045299
E02005418,Fenside & Lister Way,Boston,East Midlands,2599,7486,470,392,248,427,9023,2785,9129,466,436,262,409,10702,860,304,348,234,382,2128,0.0942052798773141,0.652360515021459,0.798165137614679,0.893129770992367,0.93398533007335,0.198841338067651
E02005419,Boston Central & North,Boston,East Midlands,1683,6338,315,245,192,324,7414,2141,8659,370,298,226,330,9883,925,245,234,197,291,1892,0.106825268506756,0.662162162162162,0.785234899328859,0.871681415929204,0.881818181818182,0.191439846200546
E02005420,Skirbeck,Boston,East Midlands,1848,5271,440,460,346,485,7002,1895,6105,425,457,338,489,7814,1103,347,407,305,464,2626,0.180671580671581,0.816470588235294,0.890590809628009,0.902366863905325,0.948875255623722,0.336063475812644
E02005422,"Swineshead, Bicker & Holland Fen",Boston,East Midlands,1131,3474,443,495,315,400,5127,1139,4071,455,502,368,428,5824,750,396,468,349,404,2367,0.184229918938836,0.87032967032967,0.932270916334661,0.948369565217391,0.94392523364486,0.406421703296703
E02005423,"Kirton, Frampton & Algarkirk",Boston,East Midlands,2019,5636,703,633,498,633,8103,2088,6647,674,647,479,670,9117,1262,599,603,455,643,3562,0.189860087257409,0.888724035608309,0.931993817619784,0.949895615866388,0.959701492537313,0.390698694746079
E02006864,Fishtoft & Wyberton East,Boston,East Midlands,1691,4822,537,602,427,534,6922,1538,5277,558,573,418,623,7449,1249,492,533,394,583,3251,0.236687511843851,0.881720430107527,0.930191972076789,0.942583732057416,0.935794542536116,0.436434420727614
E02006865,Wyberton West & Fen,Boston,East Midlands,1460,4654,508,555,394,572,6683,1521,5355,511,538,426,575,7405,1093,461,495,403,545,2997,0.204108309990663,0.902152641878669,0.920074349442379,0.946009389671362,0.947826086956522,0.40472653612424
E02005424,"Holton-le-Clay, Binbrook & Tetney",East Lindsey,East Midlands,1465,5706,830,983,569,643,8731,1466,6034,769,918,676,717,9114,993,581,868,650,684,3776,0.164567451110375,0.755526657997399,0.945533769063181,0.961538461538461,0.95397489539749,0.41430765854729
E02005425,"Marshchapel, Somercotes & Grimoldby",East Lindsey,East Midlands,937,3588,560,544,383,440,5515,951,3747,518,590,442,458,5755,586,362,558,423,437,2366,0.156391780090739,0.698841698841699,0.945762711864407,0.957013574660633,0.954148471615721,0.411120764552563
E02005426,Louth North & East,East Lindsey,East Midlands,2106,5788,629,640,466,690,8213,2063,6175,624,644,526,733,8702,1233,440,609,507,696,3485,0.199676113360324,0.705128205128205,0.945652173913043,0.963878326996198,0.949522510231924,0.400482647667203
E02005427,Louth Central & South,East Lindsey,East Midlands,1156,4173,470,474,326,495,5938,1053,4229,484,505,390,514,6122,820,363,472,367,487,2509,0.193899266966186,0.75,0.934653465346535,0.941025641025641,0.947470817120623,0.409833387781771
E02005428,Mablethorpe,East Lindsey,East Midlands,1058,4263,835,919,547,623,7187,1193,4817,843,861,661,689,7871,1024,679,808,627,645,3783,0.212580444259913,0.805456702253855,0.938443670150987,0.94856278366112,0.936139332365747,0.480625079405412
E02005429,Sutton-on-Sea,East Lindsey,East Midlands,585,2780,803,941,639,695,5858,510,2732,786,915,701,758,5892,631,697,871,656,698,3553,0.230966325036603,0.88676844783715,0.951912568306011,0.935805991440799,0.920844327176781,0.603021045485404
E02005430,"Wragby, Roughton & Ludford",East Lindsey,East Midlands,977,3935,601,642,440,556,6174,913,3901,608,632,489,587,6217,754,495,589,468,560,2866,0.193283773391438,0.814144736842105,0.931962025316456,0.957055214723926,0.954003407155026,0.460994048576484
E02005431,"Alford, Withern & Willoughby",East Lindsey,East Midlands,1279,4688,747,797,546,653,7431,1286,4992,774,819,594,713,7892,1180,670,771,567,677,3865,0.236378205128205,0.865633074935401,0.941391941391941,0.954545454545455,0.949509116409537,0.489736441966548
E02005432,Little Cawthorpe & South Wolds,East Lindsey,East Midlands,970,4265,763,716,488,492,6724,955,4412,710,736,534,563,6955,939,562,676,501,526,3204,0.212828649138713,0.791549295774648,0.918478260869565,0.938202247191011,0.934280639431616,0.460675772825306
E02005433,Ingoldmells & Chapel St Leonards,East Lindsey,East Midlands,700,3598,768,842,510,605,6323,808,4003,719,886,593,611,6812,956,523,812,540,561,3392,0.238820884336747,0.72739916550765,0.91647855530474,0.9106239460371,0.918166939443535,0.497944803288315
E02005434,Horncastle,East Lindsey,East Midlands,1150,4186,440,546,451,606,6229,1217,4371,460,539,485,592,6447,845,372,515,464,573,2769,0.193319606497369,0.808695652173913,0.955473098330241,0.956701030927835,0.967905405405405,0.429502093997208
E02005435,Skegness North,East Lindsey,East Midlands,1129,3973,616,674,448,495,6206,1250,4657,600,756,517,532,7062,973,440,688,481,482,3064,0.208932789349367,0.733333333333333,0.91005291005291,0.93036750483559,0.906015037593985,0.43387142452563
E02005436,Spilsby & Burgh le Marsh,East Lindsey,East Midlands,1400,4340,689,675,498,610,6812,1296,4504,688,693,542,673,7100,1136,516,630,512,634,3428,0.252220248667851,0.75,0.909090909090909,0.944649446494465,0.942050520059435,0.482816901408451
E02005437,Skegness Town,East Lindsey,East Midlands,993,3646,416,352,212,329,4955,1099,4494,419,372,250,367,5902,773,295,318,228,308,1922,0.172007120605251,0.704057279236277,0.854838709677419,0.912,0.839237057220709,0.325652321247035
E02005438,Skegness South,East Lindsey,East Midlands,1254,3866,517,495,402,541,5821,1266,4105,469,551,421,538,6084,832,350,495,382,499,2558,0.202679658952497,0.746268656716418,0.898366606170599,0.907363420427554,0.927509293680297,0.420447074293228
E02005439,Coningsby & Woodhall Spa,East Lindsey,East Midlands,2264,6951,753,827,624,923,10078,1966,7137,761,887,726,986,10497,1206,666,840,699,956,4367,0.168978562421185,0.875164257555848,0.947012401352875,0.962809917355372,0.969574036511156,0.416023625797847
E02005440,Wainfleet All Saints,East Lindsey,East Midlands,870,2975,478,455,294,362,4564,862,3267,443,469,304,421,4904,737,365,425,280,395,2202,0.225589225589226,0.82392776523702,0.906183368869936,0.921052631578947,0.938242280285036,0.449021207177814
E02005441,"Mareham, Sibsey & New Leake",East Lindsey,East Midlands,1309,4865,696,717,470,618,7366,1213,5004,673,721,534,619,7551,1322,584,681,510,591,3688,0.264188649080735,0.86775631500743,0.944521497919556,0.955056179775281,0.954765751211632,0.488412130843597
E02005442,Ermine,Lincoln,East Midlands,1352,3768,256,242,197,300,4763,1470,4338,276,247,183,239,5283,1042,242,223,168,225,1900,0.24020285846012,0.876811594202899,0.902834008097166,0.918032786885246,0.941422594142259,0.35964414158622
E02005443,Glebe Park,Lincoln,East Midlands,1447,4379,359,380,280,430,5828,1358,4700,368,389,288,408,6153,1249,330,361,274,386,2600,0.265744680851064,0.896739130434783,0.928020565552699,0.951388888888889,0.946078431372549,0.422558101738989
E02005444,Cathedral & West Common,Lincoln,East Midlands,1785,8245,591,538,413,674,10461,1842,9271,610,590,439,738,11648,1756,533,534,406,677,3906,0.189407830870456,0.873770491803279,0.905084745762712,0.924829157175399,0.917344173441735,0.335336538461538
E02005445,"Monks Road, St Giles & Greetwell",Lincoln,East Midlands,2523,8403,429,327,200,271,9630,2733,9896,415,375,218,252,11156,1654,333,310,179,225,2701,0.167138237671787,0.802409638554217,0.826666666666667,0.821100917431193,0.892857142857143,0.242111868053066
E02005446,Wharf & University,Lincoln,East Midlands,503,9722,231,194,119,189,10455,526,9124,223,209,123,157,9836,971,183,182,109,140,1585,0.106422621657168,0.820627802690583,0.870813397129187,0.886178861788618,0.89171974522293,0.161142740951606
E02005447,Pelham Bridge & South Common,Lincoln,East Midlands,1077,5761,188,150,119,278,6496,1284,6973,222,156,119,275,7745,830,157,126,106,241,1460,0.119030546393231,0.707207207207207,0.807692307692308,0.890756302521008,0.876363636363636,0.188508715300194
E02005448,Birchwood West,Lincoln,East Midlands,1689,4408,298,280,207,209,5402,1670,4892,308,303,208,263,5974,1019,261,279,199,243,2001,0.208299264104661,0.847402597402597,0.920792079207921,0.956730769230769,0.923954372623574,0.33495145631068
E02005449,Boultham & New Boultham,Lincoln,East Midlands,1187,6903,320,331,210,322,8086,1214,6809,344,323,237,335,8048,1052,293,299,225,322,2191,0.154501395212219,0.851744186046512,0.925696594427245,0.949367088607595,0.961194029850746,0.272241550695825
E02005450,Hartsholme & Birchwood East,Lincoln,East Midlands,1217,4655,564,561,328,657,6765,1272,5184,557,591,432,564,7328,1191,499,574,419,540,3223,0.22974537037037,0.895870736086176,0.971235194585448,0.969907407407407,0.957446808510638,0.439819868995633
E02005451,Bracebridge North & Boultham Moor,Lincoln,East Midlands,1652,4994,337,281,176,291,6079,1798,5896,317,286,201,365,7065,1222,267,263,190,343,2285,0.207259158751696,0.842271293375394,0.91958041958042,0.945273631840796,0.93972602739726,0.32342533616419
E02005452,Bracebridge South & Swallow Beck,Lincoln,East Midlands,2009,6348,688,679,446,732,8893,1995,7147,669,679,457,654,9606,1722,580,650,441,632,4025,0.240940254652302,0.866965620328849,0.957290132547864,0.964989059080963,0.966360856269113,0.419008952737872
E02005453,Washingborough & Branston,North Kesteven,East Midlands,1666,6442,709,829,630,753,9363,1606,6310,686,810,628,839,9273,1695,603,790,608,814,4510,0.268621236133122,0.879008746355685,0.975308641975309,0.968152866242038,0.970202622169249,0.486358244365362
E02005455,"Skellingthorpe, Witham & Bassingham",North Kesteven,East Midlands,2654,8599,761,888,591,694,11533,2590,8983,798,829,643,700,11953,2123,718,808,622,677,4948,0.236335300011132,0.899749373433584,0.974668275030157,0.967340590979782,0.967142857142857,0.413954655734962
E02005456,Bracebridge Heath & Waddington,North Kesteven,East Midlands,2001,6340,558,531,488,680,8597,2035,7585,511,559,459,654,9768,1583,425,538,445,634,3625,0.20870138431114,0.831702544031311,0.962432915921288,0.969498910675381,0.969418960244648,0.371109746109746
E02005457,"Metheringham, Nocton & Potterhanworth",North Kesteven,East Midlands,1482,4882,550,627,437,604,7100,1491,5159,526,615,482,595,7377,1314,458,590,466,578,3406,0.25470052335724,0.870722433460076,0.959349593495935,0.966804979253112,0.971428571428571,0.461705300257557
E02005458,"Navenby, Harmston & Brant Broughton",North Kesteven,East Midlands,1045,3838,457,589,394,514,5792,1031,3909,428,572,419,559,5887,1006,366,562,409,542,2885,0.257354822205168,0.855140186915888,0.982517482517482,0.976133651551313,0.9695885509839,0.490062850348225
E02005459,Ruskington North & Billinghay,North Kesteven,East Midlands,1567,4790,577,585,422,485,6859,1434,4959,552,621,447,537,7116,1342,493,595,433,506,3369,0.270619076426699,0.893115942028986,0.958132045088567,0.968680089485458,0.942271880819367,0.473440134907251
E02005460,Ruskington West & Cranwell,North Kesteven,East Midlands,1189,4199,342,295,253,233,5322,1125,4436,329,293,242,274,5574,769,294,272,226,253,1814,0.173354373309288,0.893617021276596,0.928327645051194,0.933884297520661,0.923357664233577,0.325439540724794
E02005461,"Ruskington South, Leasingham & Osbournby",North Kesteven,East Midlands,782,3496,504,560,417,524,5501,855,3722,480,567,458,585,5812,929,451,547,438,555,2920,0.249596990865126,0.939583333333333,0.964726631393298,0.956331877729258,0.948717948717949,0.502408809359945
E02005462,Sleaford East,North Kesteven,East Midlands,1878,5888,500,542,403,550,7883,1872,6032,500,553,401,574,8060,1393,451,521,376,538,3279,0.2309350132626,0.902,0.942133815551537,0.937655860349127,0.937282229965157,0.40682382133995
E02005463,Sleaford West,North Kesteven,East Midlands,1957,6132,463,486,315,420,7816,2003,6291,435,509,364,444,8043,1466,407,482,349,428,3132,0.233031314576379,0.935632183908046,0.946954813359529,0.958791208791209,0.963963963963964,0.38940693770981
E02005464,Heckington,North Kesteven,East Midlands,1301,4723,678,735,511,610,7257,1154,4811,667,719,547,682,7426,1284,625,686,523,651,3769,0.266888380794014,0.937031484257871,0.954102920723227,0.956124314442413,0.954545454545455,0.507541071909507
E02006866,North Hykeham South,North Kesteven,East Midlands,1626,5202,395,436,356,476,6865,1693,5350,356,470,360,524,7060,1369,307,449,351,506,2982,0.25588785046729,0.862359550561798,0.95531914893617,0.975,0.965648854961832,0.422379603399433
E02006867,North Hykeham North,North Kesteven,East Midlands,1240,4416,495,570,468,690,6639,1305,4763,515,536,448,661,6923,1241,442,518,441,630,3272,0.260550073483099,0.858252427184466,0.966417910447761,0.984375,0.953101361573374,0.472627473638596
E02005465,"Donington, Quadring & Gosberton",South Holland,East Midlands,1367,4824,676,645,450,601,7196,1426,5161,662,685,458,635,7601,918,601,658,441,616,3234,0.177872505328425,0.90785498489426,0.960583941605839,0.962882096069869,0.97007874015748,0.425470332850941
E02005466,"Long Sutton West, Gedney & Holbeach Hurn",South Holland,East Midlands,1082,3669,484,593,384,473,5603,1085,3894,506,581,363,498,5842,743,461,548,346,474,2572,0.19080636877247,0.911067193675889,0.943201376936317,0.953168044077135,0.951807228915663,0.440260184868196
E02005467,Holbeach,South Holland,East Midlands,1318,4249,458,491,367,680,6245,1373,4613,462,479,397,701,6652,919,426,451,384,661,2841,0.199219596791676,0.922077922077922,0.941544885177453,0.967254408060453,0.942938659058488,0.42708959711365
E02005468,"Moulton, Weston & Whaplode",South Holland,East Midlands,1256,4310,538,617,391,511,6367,1228,4512,501,608,397,538,6556,910,461,589,385,512,2857,0.201684397163121,0.920159680638723,0.96875,0.969773299748111,0.951672862453531,0.435784014643075
E02005469,Pinchbeck & Deeping St Nicholas,South Holland,East Midlands,1480,4715,539,522,318,471,6565,1448,5023,479,538,370,445,6855,827,438,513,361,422,2561,0.164642643838344,0.914405010438413,0.953531598513011,0.975675675675676,0.948314606741573,0.373595915390226
E02005470,Spalding North,South Holland,East Midlands,2407,8301,526,600,423,782,10632,2503,9328,544,564,444,748,11628,1045,454,517,421,716,3153,0.112028301886792,0.834558823529412,0.916666666666667,0.948198198198198,0.957219251336898,0.271155830753354
E02005471,Spalding East,South Holland,East Midlands,1872,5894,554,513,371,588,7920,1808,6485,527,535,397,546,8490,703,440,482,371,518,2514,0.10840400925212,0.834914611005693,0.900934579439252,0.934508816120907,0.948717948717949,0.296113074204947
E02005472,Long Sutton East & Sutton Bridge,South Holland,East Midlands,1702,5318,673,769,589,818,8167,1696,5788,659,772,623,821,8663,1002,563,729,596,790,3680,0.173116793365584,0.854324734446131,0.944300518134715,0.956661316211878,0.962241169305725,0.424795105621609
E02005473,Spalding South West,South Holland,East Midlands,1940,6209,499,563,418,635,8324,1853,6584,490,548,454,627,8703,830,412,513,434,590,2779,0.126063183475091,0.840816326530612,0.936131386861314,0.955947136563877,0.940988835725678,0.31931517867402
E02005474,Fleet Hargate & Holbeach St Johns,South Holland,East Midlands,979,3874,503,571,397,469,5814,967,4094,545,577,404,493,6113,793,486,543,380,468,2670,0.193698094772838,0.891743119266055,0.94107452339688,0.940594059405941,0.949290060851927,0.436774088009161
E02005475,Crowland & Cowbit,South Holland,East Midlands,1323,3909,418,491,285,357,5460,1267,4314,383,444,309,360,5810,868,351,423,305,352,2299,0.201205377839592,0.91644908616188,0.952702702702703,0.98705501618123,0.977777777777778,0.395697074010327
E02005476,"Ancaster, Caythorpe & Claypole",South Kesteven,East Midlands,1200,4179,503,502,410,426,6020,1205,4641,520,498,424,482,6565,1067,486,472,408,465,2898,0.229907347554406,0.934615384615385,0.947791164658635,0.962264150943396,0.964730290456431,0.441431835491241
E02005477,"Long Bennington, Allington & Barrowby",South Kesteven,East Midlands,1426,4776,832,815,590,673,7686,1383,5056,695,869,617,723,7960,921,666,839,597,696,3719,0.182159810126582,0.958273381294964,0.965477560414269,0.967585089141005,0.962655601659751,0.467211055276382
E02005478,Grantham North East,South Kesteven,East Midlands,1890,5660,593,665,454,664,8036,1944,6220,646,634,520,697,8717,1050,583,591,490,666,3380,0.168810289389068,0.902476780185759,0.93217665615142,0.942307692307692,0.955523672883788,0.387748078467363
E02005479,Grantham North West,South Kesteven,East Midlands,1675,5541,564,545,395,532,7577,1705,6232,580,608,437,564,8421,1037,532,574,420,540,3103,0.166399229781771,0.917241379310345,0.944078947368421,0.961098398169336,0.957446808510638,0.368483553022206
E02005480,Grantham South West,South Kesteven,East Midlands,2023,4527,340,332,202,212,5613,1933,5019,299,307,220,208,6053,648,255,288,202,191,1584,0.12910938433951,0.852842809364548,0.938110749185668,0.918181818181818,0.918269230769231,0.261688418965802
E02005481,Grantham South East,South Kesteven,East Midlands,2547,8142,506,508,384,568,10108,2448,8734,502,500,375,575,10686,1196,437,459,347,551,2990,0.136936111747195,0.870517928286853,0.918,0.925333333333333,0.958260869565217,0.279805352798054
E02005482,"Corby Glen, Ropsley & Grantham Outskirts",South Kesteven,East Midlands,1631,5738,763,664,426,455,8046,1506,5877,746,740,473,496,8332,1072,689,709,451,478,3399,0.1824059894504,0.923592493297587,0.958108108108108,0.953488372093023,0.963709677419355,0.407945271243399
E02005483,Morton & Billingborough,South Kesteven,East Midlands,1287,4635,545,555,410,500,6645,1215,4790,522,555,452,541,6860,1197,471,529,435,519,3151,0.249895615866388,0.902298850574713,0.953153153153153,0.962389380530973,0.959334565619224,0.45932944606414
E02005484,"Harlaxton, Colsterworth & South Witham",South Kesteven,East Midlands,1250,4194,470,552,340,405,5961,1201,4432,489,499,399,403,6222,795,442,475,381,390,2483,0.17937725631769,0.903885480572597,0.95190380761523,0.954887218045113,0.967741935483871,0.399067823850852
E02005485,Bourne West,South Kesteven,East Midlands,1453,4319,457,504,296,480,6056,1634,4897,457,498,387,509,6748,1033,389,472,377,490,2761,0.210945476822544,0.851203501094092,0.947791164658635,0.974160206718346,0.962671905697446,0.409158269116775
E02005486,Bourne East,South Kesteven,East Midlands,1935,5629,518,531,428,750,7856,1870,5835,500,527,416,681,7959,1240,423,499,398,653,3213,0.212510711225364,0.846,0.946869070208729,0.956730769230769,0.958883994126285,0.403693931398417
E02005487,"Langtoft, Thurlby & Uffington",South Kesteven,East Midlands,1615,5592,682,762,477,623,8136,1474,5810,720,762,552,631,8475,1087,635,731,542,607,3602,0.187091222030981,0.881944444444445,0.959317585301837,0.981884057971014,0.961965134706815,0.425014749262537
E02005488,Market Deeping,South Kesteven,East Midlands,1268,3927,463,494,316,448,5648,1222,4064,511,481,352,454,5862,900,470,463,346,444,2623,0.221456692913386,0.919765166340509,0.962577962577963,0.982954545454545,0.977973568281938,0.447458205390652
E02005489,Deeping St James & Frognall,South Kesteven,East Midlands,1305,4244,524,486,290,338,5882,1231,4379,500,495,327,363,6064,907,470,484,316,349,2526,0.20712491436401,0.94,0.977777777777778,0.966360856269113,0.961432506887052,0.41655672823219
E02005490,Stamford North,South Kesteven,East Midlands,1775,5581,535,540,400,581,7637,1787,6110,476,575,436,576,8173,1010,272,541,395,537,2755,0.165302782324059,0.571428571428571,0.940869565217391,0.905963302752293,0.932291666666667,0.337085525510828
E02005491,"Stamford Central, West and South",South Kesteven,East Midlands,1863,6609,653,783,526,803,9374,1936,7197,620,709,578,833,9937,1054,428,650,550,797,3479,0.146449909684591,0.690322580645161,0.916784203102962,0.951557093425606,0.956782713085234,0.350105665693871
E02005492,"Caistor, Kelsey & Keelby",West Lindsey,East Midlands,1535,5614,756,738,504,601,8213,1574,5908,798,756,542,603,8607,1264,710,718,519,578,3789,0.213947190250508,0.889724310776942,0.94973544973545,0.957564575645756,0.958540630182421,0.440223074241896
E02005493,"Morton, Blyton & Scotter",West Lindsey,East Midlands,1709,5940,649,706,473,667,8435,1658,6169,625,733,516,611,8654,1585,563,710,500,599,3957,0.256929810342033,0.9008,0.96862210095498,0.968992248062015,0.980360065466449,0.457245204529697
E02005494,Market Rasen & Brookenby,West Lindsey,East Midlands,1662,5774,707,777,539,699,8496,1486,5717,712,763,568,762,8522,1195,577,715,536,729,3752,0.209025712786426,0.810393258426966,0.937090432503276,0.943661971830986,0.956692913385827,0.440272236564187
E02005495,Gainsborough West,West Lindsey,East Midlands,2100,6714,554,506,357,444,8575,2118,7002,549,495,415,460,8921,1560,486,462,393,424,3325,0.222793487574979,0.885245901639344,0.933333333333333,0.946987951807229,0.921739130434783,0.372716063221612
E02005496,Hemswell & Spital,West Lindsey,East Midlands,1002,3977,469,477,313,281,5517,979,3917,460,496,345,318,5536,963,417,472,336,310,2498,0.245851416900689,0.906521739130435,0.951612903225806,0.973913043478261,0.974842767295597,0.451228323699422
E02005497,Gainsborough East,West Lindsey,East Midlands,1939,4554,391,384,228,360,5917,1853,4701,356,375,267,338,6037,1039,311,353,255,317,2275,0.22101680493512,0.873595505617977,0.941333333333333,0.955056179775281,0.937869822485207,0.376842802716581
E02005498,Torksey & Stow,West Lindsey,East Midlands,942,4001,649,736,491,585,6462,983,4119,628,709,553,611,6620,1093,569,672,533,586,3453,0.265355668851663,0.906050955414013,0.947813822284908,0.963833634719711,0.959083469721768,0.521601208459215
E02005499,Dunholme & Welton,West Lindsey,East Midlands,1557,4947,558,529,381,473,6888,1546,5201,561,540,415,511,7228,1346,526,519,401,497,3289,0.258796385310517,0.937611408199644,0.961111111111111,0.966265060240964,0.972602739726027,0.455035971223022
E02005500,Saxilby & Scampton,West Lindsey,East Midlands,1209,4369,458,499,373,406,6105,1124,4344,484,503,437,448,6216,1189,434,488,415,431,2957,0.273710865561694,0.896694214876033,0.970178926441352,0.949656750572082,0.962053571428571,0.475707850707851
E02005501,"Nettleham, Sudbrooke & Scothern",West Lindsey,East Midlands,1251,4310,556,622,455,616,6559,1290,4529,554,651,494,674,6902,1245,523,617,481,643,3509,0.274895120335615,0.944043321299639,0.947772657450077,0.973684210526316,0.954005934718101,0.508403361344538
E02005502,Cherry Willingham & Bardney,West Lindsey,East Midlands,1577,5267,755,770,547,678,8017,1590,5454,679,761,575,716,8185,1467,608,730,553,684,4042,0.268976897689769,0.895434462444772,0.959264126149803,0.961739130434783,0.955307262569832,0.493830177153329
E02005612,"Rowlett, Gretton & Cottingham",Corby,East Midlands,1398,4547,422,393,238,320,5920,1406,4996,479,367,289,351,6482,715,405,352,280,332,2084,0.143114491593275,0.845511482254697,0.959128065395095,0.968858131487889,0.945868945868946,0.321505708114779
E02005613,Corby North,Corby,East Midlands,2046,5926,445,355,286,365,7377,1937,6720,447,404,292,370,8233,905,357,369,277,338,2246,0.134672619047619,0.798657718120805,0.913366336633663,0.948630136986301,0.913513513513514,0.272804566986518
E02005614,Corby Village & Weldon,Corby,East Midlands,2602,7098,467,397,240,350,8552,3100,8783,556,449,311,366,10465,1227,443,418,295,346,2729,0.139701696459069,0.796762589928058,0.930957683741648,0.948553054662379,0.945355191256831,0.260774008600096
E02005615,Corby Lodge Park,Corby,East Midlands,1809,5497,473,479,358,494,7301,1856,6265,492,483,365,499,8104,951,410,452,348,472,2633,0.151795690343176,0.833333333333333,0.935817805383023,0.953424657534246,0.945891783567134,0.324901283316881
E02005616,Corby Town,Corby,East Midlands,1162,3695,248,213,173,208,4537,1243,4484,257,222,157,213,5333,550,186,194,144,198,1272,0.122658340767172,0.723735408560311,0.873873873873874,0.917197452229299,0.929577464788732,0.238514907181699
E02005617,Corby Kingswood,Corby,East Midlands,2628,6837,438,385,269,325,8254,2608,8515,515,421,290,359,10100,1098,394,362,271,329,2454,0.128948913681738,0.76504854368932,0.859857482185273,0.93448275862069,0.916434540389972,0.242970297029703
E02006862,Great Oakley and Danesholme,Corby,East Midlands,1328,4061,384,324,209,200,5178,1341,4571,428,349,227,246,5821,806,368,323,213,231,1941,0.176329030846642,0.85981308411215,0.925501432664757,0.938325991189427,0.939024390243902,0.333447861192235
E02006863,Snatchill,Corby,East Midlands,3294,8041,295,247,107,142,8832,3208,8697,336,247,142,155,9577,1301,273,216,130,135,2055,0.149591813268943,0.8125,0.874493927125506,0.915492957746479,0.870967741935484,0.214576589746267
E02005619,"Clipston, Naseby & Yelvertoft",Daventry,East Midlands,1015,3700,417,395,263,363,5138,1053,4090,407,425,296,403,5621,868,371,401,284,392,2316,0.212224938875306,0.911547911547912,0.943529411764706,0.959459459459459,0.972704714640198,0.412026329834549
E02005620,Broxworth & Spratton,Daventry,East Midlands,1777,5445,534,518,305,378,7180,1666,5630,529,502,369,392,7422,1022,481,480,350,376,2709,0.181527531083481,0.909262759924386,0.956175298804781,0.948509485094851,0.959183673469388,0.364995957962813
E02005621,Braunston & Crick,Daventry,East Midlands,1279,5434,602,619,414,474,7543,1258,5940,597,627,424,538,8126,1070,530,599,406,512,3117,0.18013468013468,0.887772194304858,0.955342902711324,0.957547169811321,0.951672862453531,0.383583558946591
E02005622,Long Buckby East & Ravensthorpe,Daventry,East Midlands,1707,5721,603,614,397,435,7770,1714,6184,603,616,449,491,8343,1229,564,588,431,483,3295,0.198738680465718,0.935323383084577,0.954545454545455,0.959910913140312,0.983706720977597,0.394941867433777
E02005623,Walgrave & Moulton,Daventry,East Midlands,1911,5720,597,630,401,576,7924,2144,6744,624,636,437,649,9090,1621,588,612,425,630,3876,0.240361803084223,0.942307692307692,0.962264150943396,0.97254004576659,0.970724191063174,0.426402640264026
E02005624,Daventry North,Daventry,East Midlands,2330,7172,449,443,314,298,8676,2295,8109,461,485,333,328,9716,1107,378,459,320,316,2580,0.136514983351831,0.819956616052061,0.94639175257732,0.960960960960961,0.963414634146341,0.265541375051462
E02005625,Daventry Central,Daventry,East Midlands,1751,5675,521,564,388,614,7762,1715,6241,499,550,436,609,8335,875,404,515,409,583,2786,0.140201890722641,0.809619238476954,0.936363636363636,0.938073394495413,0.957307060755337,0.334253149370126
E02005626,Daventry South & Southbrook,Daventry,East Midlands,1554,4363,336,291,147,140,5277,1571,5020,315,321,203,183,6042,684,258,304,197,164,1607,0.136254980079681,0.819047619047619,0.947040498442368,0.970443349753695,0.896174863387978,0.265971532605098
E02005627,Long Buckby West & Weedon,Daventry,East Midlands,1318,4311,529,531,338,457,6166,1347,4833,526,549,373,417,6698,950,478,528,362,403,2721,0.196565280364163,0.908745247148289,0.961748633879781,0.970509383378016,0.966426858513189,0.406240668856375
E02005628,"Woodforth Halse, Byfield & Staverton",Daventry,East Midlands,1330,4753,518,525,351,395,6542,1367,5317,523,541,377,408,7166,1086,470,511,365,394,2826,0.204250517208952,0.898661567877629,0.944547134935305,0.96816976127321,0.965686274509804,0.394362266257326
E02005629,"King's Cliffe, Woodnewton & Easton",East Northamptonshire,East Midlands,1092,3693,462,509,296,373,5333,1101,3932,448,490,335,387,5592,629,360,456,320,371,2136,0.159969481180061,0.803571428571429,0.930612244897959,0.955223880597015,0.958656330749354,0.381974248927039
E02005630,"Oundle, Warmington & Titchmarsh",East Northamptonshire,East Midlands,2075,6014,684,693,468,700,8559,1955,6269,642,706,552,725,8894,922,553,671,535,703,3384,0.147072898388898,0.861370716510903,0.95042492917847,0.969202898550725,0.969655172413793,0.380481223296604
E02005631,Thrapston & Brigstock,East Northamptonshire,East Midlands,1904,6537,642,647,369,507,8702,1934,6995,642,634,427,510,9208,1349,524,608,414,493,3388,0.192852037169407,0.816199376947041,0.958990536277603,0.969555035128806,0.966666666666667,0.367940920938315
E02005632,"Ringstead, Woodford & Stanwick",East Northamptonshire,East Midlands,1158,3761,514,478,299,422,5474,1113,3958,466,482,336,422,5664,806,389,448,323,401,2367,0.203638201111673,0.834763948497854,0.929460580912863,0.961309523809524,0.950236966824644,0.417902542372881
E02005633,Raunds,East Northamptonshire,East Midlands,1586,5505,593,602,363,516,7579,1702,5710,567,644,416,477,7814,985,434,613,400,451,2883,0.172504378283713,0.765432098765432,0.951863354037267,0.961538461538461,0.945492662473795,0.368953160993089
E02005634,Irthlingborough,East Northamptonshire,East Midlands,1885,5811,469,502,261,410,7453,1815,5957,449,485,322,388,7601,1291,407,454,306,363,2821,0.216719825415478,0.906458797327394,0.936082474226804,0.950310559006211,0.935567010309278,0.371135376924089
E02005635,Higham Ferrers,East Northamptonshire,East Midlands,1885,5818,531,559,335,481,7724,1867,5971,490,561,403,449,7874,1327,441,541,383,424,3116,0.222240830681628,0.9,0.964349376114082,0.950372208436725,0.944320712694877,0.395732791465583
E02005636,Rushden West & North,East Northamptonshire,East Midlands,2571,7283,688,678,428,586,9663,2517,7805,635,691,483,582,10196,1688,568,651,458,533,3898,0.216271620755926,0.894488188976378,0.942112879884226,0.94824016563147,0.915807560137457,0.382306786975284
E02005637,Rushden East,East Northamptonshire,East Midlands,1894,6077,444,404,275,502,7702,1848,6196,413,408,289,517,7823,1280,347,368,267,485,2747,0.206584893479664,0.840193704600484,0.901960784313725,0.923875432525952,0.938104448742747,0.351144062380161
E02005638,Rushden South,East Northamptonshire,East Midlands,1851,6098,677,681,467,514,8437,1733,6379,610,681,477,526,8673,1382,557,656,458,494,3547,0.216648377488635,0.913114754098361,0.963289280469897,0.960167714884696,0.939163498098859,0.40897036780814
E02005639,"Geddington, Rushton & Stoke Albany",Kettering,East Midlands,757,2899,421,454,260,344,4378,807,3398,406,439,304,380,4927,792,347,415,289,370,2213,0.233078281341966,0.854679802955665,0.945330296127563,0.950657894736842,0.973684210526316,0.449157702455856
E02005640,Desborough,Kettering,East Midlands,2344,6874,677,712,399,514,9176,2371,7391,655,731,490,553,9820,1657,551,677,470,516,3871,0.224191584359356,0.841221374045802,0.926128590971272,0.959183673469388,0.933092224231465,0.394195519348269
E02005641,Rothwell,Kettering,East Midlands,1614,4862,560,506,329,342,6599,1645,5304,533,564,353,349,7103,1212,416,526,336,320,2810,0.228506787330317,0.780487804878049,0.932624113475177,0.951841359773371,0.916905444126075,0.395607489793045
E02005642,Kettering Brambleside,Kettering,East Midlands,1538,5057,423,472,307,418,6677,1504,5600,454,487,361,449,7351,1282,350,444,338,423,2837,0.228928571428571,0.770925110132159,0.91170431211499,0.936288088642659,0.942093541202673,0.385933886546048
E02005643,Kettering Avondale Grange,Kettering,East Midlands,2156,5250,339,300,190,243,6322,2170,6088,369,318,222,246,7243,1130,232,282,199,229,2072,0.185611038107753,0.628726287262873,0.886792452830189,0.896396396396396,0.930894308943089,0.286069308297667
E02005644,Kettering Central East,Kettering,East Midlands,1941,6347,295,219,159,177,7197,2079,7306,313,236,145,170,8170,1113,173,187,127,140,1740,0.152340542020257,0.552715654952077,0.792372881355932,0.875862068965517,0.823529411764706,0.21297429620563
E02005645,Kettering Town & West,Kettering,East Midlands,2383,7586,527,534,418,838,9903,2352,8565,507,556,463,801,10892,1806,349,500,427,738,3820,0.210858143607706,0.68836291913215,0.899280575539568,0.922246220302376,0.921348314606742,0.350716121924348
E02005646,Kettering East,Kettering,East Midlands,1202,3595,437,537,334,368,5271,1163,3799,399,515,395,410,5518,910,331,484,379,393,2497,0.239536720189524,0.829573934837093,0.939805825242719,0.959493670886076,0.958536585365854,0.452519028633563
E02005647,Kettering South,Kettering,East Midlands,1521,4724,340,421,248,447,6180,1491,4906,406,376,303,418,6409,1018,299,344,279,387,2327,0.207501019160212,0.736453201970443,0.914893617021277,0.920792079207921,0.925837320574163,0.363083164300203
E02005648,Barton Seagrave,Kettering,East Midlands,1787,4903,440,513,392,423,6671,1923,6004,466,515,443,474,7902,1352,410,491,427,451,3131,0.225183211192538,0.879828326180258,0.953398058252427,0.963882618510158,0.951476793248945,0.396228802834725
E02005649,"Burton Latimer, Broughton & Mawsley",Kettering,East Midlands,3718,9708,797,824,497,615,12441,3635,10691,802,806,576,680,13555,2676,704,756,547,657,5340,0.250303994013656,0.877805486284289,0.937965260545906,0.949652777777778,0.966176470588235,0.393950571744744
E02005650,Boughton,Northampton,East Midlands,1104,4124,396,412,236,277,5445,1217,5125,366,400,270,272,6433,902,322,377,252,230,2083,0.176,0.879781420765027,0.9425,0.933333333333333,0.845588235294118,0.323799160578268
E02005651,Moulton,Northampton,East Midlands,926,3302,470,466,329,464,5031,981,4012,450,472,385,455,5774,901,403,450,365,439,2558,0.224576271186441,0.895555555555556,0.953389830508475,0.948051948051948,0.964835164835165,0.44302043643921
E02005652,Sunnyside,Northampton,East Midlands,1108,3253,393,488,344,455,4933,1230,4174,378,500,354,521,5927,934,351,471,346,497,2599,0.223766171538093,0.928571428571429,0.942,0.977401129943503,0.953934740882918,0.438501771553906
E02005653,Thorplands & Round Spinney,Northampton,East Midlands,2384,5215,343,301,149,135,6143,2439,6717,369,316,185,172,7759,946,281,264,157,129,1777,0.140836683043025,0.761517615176152,0.835443037974684,0.848648648648649,0.75,0.229024358809125
E02005654,Overstone Lodge & Rectory Farm,Northampton,East Midlands,2278,5064,367,254,166,151,6002,2237,6375,392,329,188,203,7487,993,323,287,173,182,1958,0.155764705882353,0.823979591836735,0.872340425531915,0.920212765957447,0.896551724137931,0.261519967944437
E02005655,Boothville & Spinney Hill,Northampton,East Midlands,1146,3283,414,431,299,476,4903,1130,4035,402,463,310,497,5707,882,352,435,292,460,2421,0.218587360594796,0.875621890547264,0.939524838012959,0.941935483870968,0.925553319919517,0.424215875240932
E02005656,Blackthorn & Lings,Northampton,East Midlands,1590,3681,278,226,122,123,4430,1798,4940,316,250,161,136,5803,746,244,211,144,106,1451,0.151012145748988,0.772151898734177,0.844,0.894409937888199,0.779411764705882,0.250043081164915
E02005657,Kingsthorpe,Northampton,East Midlands,1040,3593,360,392,253,352,4950,1047,4161,385,404,314,420,5684,933,342,382,300,393,2350,0.22422494592646,0.888311688311688,0.945544554455445,0.955414012738854,0.935714285714286,0.413441238564391
E02005658,St David's,Northampton,East Midlands,1608,4163,221,181,134,172,4871,1707,5308,235,198,136,172,6049,862,176,163,117,149,1467,0.162396382818387,0.748936170212766,0.823232323232323,0.860294117647059,0.866279069767442,0.242519424698297
E02005659,Westone,Northampton,East Midlands,1212,3123,313,307,250,430,4423,1269,3902,303,333,259,391,5188,808,248,310,235,355,1956,0.207073295745771,0.818481848184818,0.930930930930931,0.907335907335907,0.907928388746803,0.377023901310717
E02005660,Billing & Riverside,Northampton,East Midlands,1502,3579,357,385,195,172,4688,1650,5113,433,435,230,204,6415,929,360,390,205,186,2070,0.18169372188539,0.831408775981524,0.896551724137931,0.891304347826087,0.911764705882353,0.322681215900234
E02005661,Eastfield,Northampton,East Midlands,1827,4186,261,217,105,198,4967,1778,5264,281,227,129,211,6112,858,215,181,109,189,1552,0.162993920972644,0.765124555160142,0.797356828193833,0.844961240310077,0.895734597156398,0.253926701570681
E02005662,Phippsville,Northampton,East Midlands,1206,4165,273,300,234,370,5342,1331,5148,270,295,264,387,6364,883,217,270,248,360,1978,0.171522921522922,0.803703703703704,0.915254237288136,0.939393939393939,0.930232558139535,0.310810810810811
E02005663,New Duston West,Northampton,East Midlands,951,3169,364,324,218,257,4332,969,3523,346,371,222,250,4712,762,311,357,213,234,1877,0.216292932160091,0.898843930635838,0.962264150943396,0.959459459459459,0.936,0.398344651952462
E02005664,Kingsley Park & Racecourse,Northampton,East Midlands,1045,3943,233,226,166,311,4879,1089,5120,230,226,192,330,6098,795,187,203,165,298,1648,0.1552734375,0.81304347826087,0.898230088495575,0.859375,0.903030303030303,0.270252541816989
E02005665,Little Billing,Northampton,East Midlands,1602,4850,455,372,206,258,6141,1700,6098,484,436,266,261,7545,1047,416,401,247,241,2352,0.17169563791407,0.859504132231405,0.919724770642202,0.928571428571429,0.923371647509579,0.311729622266402
E02005666,King's Heath & Spencer,Northampton,East Midlands,2394,5185,266,224,142,226,6043,2560,6639,279,248,144,210,7520,997,209,226,126,179,1737,0.150173218858262,0.74910394265233,0.911290322580645,0.875,0.852380952380952,0.230984042553192
E02005667,Lodge Farm,Northampton,East Midlands,1521,3754,346,387,285,399,5171,1435,4296,322,357,334,417,5726,862,275,330,307,393,2167,0.200651769087523,0.854037267080745,0.92436974789916,0.919161676646707,0.942446043165468,0.378449179182676
E02005668,New Duston East,Northampton,East Midlands,1195,3317,351,389,328,567,4952,1190,3917,334,395,332,567,5545,858,284,368,322,536,2368,0.219045187643605,0.850299401197605,0.931645569620253,0.969879518072289,0.945326278659612,0.427051397655546
E02005669,Abington Vale,Northampton,East Midlands,1018,3233,392,409,265,430,4729,1069,3879,391,382,307,423,5382,871,355,368,297,405,2296,0.224542407837071,0.907928388746803,0.963350785340314,0.96742671009772,0.957446808510638,0.426607209215905
E02005670,Town Centre & Semilong,Northampton,East Midlands,2049,7216,204,158,98,159,7835,2176,9023,261,189,100,162,9735,835,151,144,68,115,1313,0.0925412833869001,0.578544061302682,0.761904761904762,0.68,0.709876543209877,0.13487416538264
E02005671,Abington,Northampton,East Midlands,1417,5352,225,177,137,279,6170,1533,6697,300,210,144,224,7575,947,213,165,126,193,1644,0.141406599970136,0.71,0.785714285714286,0.875,0.861607142857143,0.217029702970297
E02005672,St Michael's Road,Northampton,East Midlands,1600,6483,145,101,85,93,6907,1738,8004,227,148,93,120,8592,759,139,103,76,83,1160,0.0948275862068965,0.612334801762115,0.695945945945946,0.817204301075269,0.691666666666667,0.135009310986965
E02005673,Stornton & Sixfields,Northampton,East Midlands,1448,4634,277,282,208,372,5773,1501,5610,305,322,212,329,6778,777,238,293,193,298,1799,0.138502673796791,0.780327868852459,0.909937888198758,0.910377358490566,0.905775075987842,0.265417527294187
E02005674,Cliftonville & Rushmere,Northampton,East Midlands,1318,6661,308,234,176,373,7752,1424,7227,285,272,181,463,8428,1088,205,231,163,405,2092,0.150546561505466,0.719298245614035,0.849264705882353,0.900552486187845,0.874730021598272,0.248220218319886
E02005675,Briar Hill & Hunsbury Hill,Northampton,East Midlands,1683,3604,245,202,106,159,4316,1639,4410,260,215,115,160,5160,829,201,194,110,144,1478,0.187981859410431,0.773076923076923,0.902325581395349,0.956521739130435,0.9,0.286434108527132
E02005676,Delapre,Northampton,East Midlands,1402,3743,237,262,150,201,4593,1342,4273,225,254,155,209,5116,890,194,223,142,196,1645,0.208284577580154,0.862222222222222,0.877952755905512,0.916129032258065,0.937799043062201,0.321540265832682
E02005677,"Cotton End, Brackmills & Hardingstone",Northampton,East Midlands,1837,6063,362,322,187,291,7225,1892,7072,364,351,241,293,8321,1055,288,325,227,279,2174,0.149179864253394,0.791208791208791,0.925925925925926,0.941908713692946,0.95221843003413,0.261266674678524
E02005678,Upton & West Hunsbury,Northampton,East Midlands,3710,8054,496,479,277,434,9740,3780,9534,496,521,325,475,11351,1798,440,488,302,457,3485,0.188588210614642,0.887096774193548,0.936660268714012,0.929230769230769,0.962105263157895,0.30702140780548
E02005679,East Hunsbury,Northampton,East Midlands,1780,5494,399,299,199,296,6687,1872,6498,427,379,221,284,7809,1301,370,352,211,264,2498,0.200215450907972,0.866510538641686,0.928759894459103,0.954751131221719,0.929577464788732,0.319887309514663
E02005680,Wootton & Collingtree,Northampton,East Midlands,2144,5212,268,275,168,269,6192,2055,6219,260,294,216,312,7301,1251,232,277,193,293,2246,0.201157742402315,0.892307692307692,0.942176870748299,0.893518518518519,0.939102564102564,0.307629091905219
E02005681,"Harpole, Kislingbury & Bugbrooke",South Northamptonshire,East Midlands,1566,4819,548,623,483,476,6949,1467,5389,591,628,512,535,7655,1208,544,591,491,520,3354,0.224160326591204,0.920473773265651,0.941082802547771,0.958984375,0.97196261682243,0.438145003265839
E02005682,"Cogenhoe, Hackleton & Denton",South Northamptonshire,East Midlands,1279,4056,443,494,325,380,5698,1309,4462,438,507,374,390,6171,969,404,485,359,362,2579,0.217167189601076,0.922374429223744,0.956607495069034,0.959893048128342,0.928205128205128,0.417922540917193
E02005683,"Blisworth, Roade & Yardley Gobion",South Northamptonshire,East Midlands,3226,9028,686,756,469,610,11549,3113,9998,684,753,545,644,12624,1855,614,714,524,623,4330,0.185537107421484,0.89766081871345,0.948207171314741,0.961467889908257,0.967391304347826,0.342997465145754
E02005684,Towcester West & Blakesley,South Northamptonshire,East Midlands,1597,5323,567,597,386,453,7326,1527,5610,598,608,411,461,7688,911,523,591,400,448,2873,0.162388591800357,0.874581939799331,0.97203947368421,0.97323600973236,0.971800433839479,0.373699271592092
E02005685,Towcester East & Paulerspury,South Northamptonshire,East Midlands,1697,5525,506,523,269,438,7261,1762,6390,519,548,333,418,8208,939,385,519,311,404,2558,0.146948356807512,0.741811175337187,0.947080291970803,0.933933933933934,0.966507177033493,0.311647173489279
E02005686,Middleton Cheney & Chipping Warden,South Northamptonshire,East Midlands,1353,4692,479,585,362,493,6611,1322,4984,470,570,413,518,6955,868,378,538,394,504,2682,0.174157303370787,0.804255319148936,0.943859649122807,0.953995157384988,0.972972972972973,0.385621854780733
E02005687,Silverstone & Syresham & Helmdon,South Northamptonshire,East Midlands,1203,3998,394,436,214,338,5380,1116,4348,414,428,274,316,5780,618,322,407,270,306,1923,0.142134314627415,0.777777777777778,0.950934579439252,0.985401459854015,0.968354430379747,0.332698961937716
E02005688,"Deanshanger, Potterspury & Old Stratford",South Northamptonshire,East Midlands,1967,5860,551,552,331,394,7688,1834,6287,520,581,387,448,8223,1040,426,554,363,434,2817,0.16542070940035,0.819230769230769,0.953528399311532,0.937984496124031,0.96875,0.342575702298431
E02005689,Brackley North,South Northamptonshire,East Midlands,2018,6155,410,398,268,409,7640,2156,7184,434,441,297,410,8766,1054,314,424,290,399,2481,0.146714922048998,0.723502304147465,0.961451247165533,0.976430976430976,0.973170731707317,0.283025325119781
E02005690,Brackley South,South Northamptonshire,East Midlands,968,3612,285,316,186,290,4689,912,3721,273,278,239,305,4816,559,155,268,226,297,1505,0.150228433216877,0.567765567765568,0.964028776978417,0.94560669456067,0.973770491803279,0.3125
E02005691,"Kings Sutton, Greatworth & Evenley",South Northamptonshire,East Midlands,1134,4105,373,524,317,372,5691,1018,4094,409,463,326,401,5693,603,274,441,314,383,2015,0.147288715192965,0.669926650366748,0.952483801295896,0.96319018404908,0.955112219451372,0.353943439311435
E02005692,"Finedon, Isham & Harrowden",Wellingborough,East Midlands,1093,3835,488,540,329,371,5563,1050,4216,435,519,384,377,5931,916,378,486,365,348,2493,0.217267552182163,0.868965517241379,0.936416184971098,0.950520833333333,0.923076923076923,0.420333839150228
E02005693,Rixon,Wellingborough,East Midlands,2180,5183,390,397,254,368,6592,2125,6044,397,395,267,378,7481,915,325,352,248,349,2189,0.151389808074123,0.818639798488665,0.891139240506329,0.928838951310862,0.923280423280423,0.292607940114958
E02005694,Redwell,Wellingborough,East Midlands,1304,4410,561,470,326,287,6054,1256,4974,524,511,353,335,6697,952,465,494,332,307,2550,0.191395255327704,0.887404580152672,0.966731898238747,0.940509915014164,0.916417910447761,0.380767507839331
E02005695,Victoria & Isebrook,Wellingborough,East Midlands,1885,6113,305,235,228,314,7195,2180,7700,374,270,203,297,8844,903,271,230,179,252,1835,0.117272727272727,0.724598930481283,0.851851851851852,0.881773399014778,0.848484848484848,0.207485300768883
E02005696,Queensway,Wellingborough,East Midlands,1672,3638,211,283,209,237,4578,1664,4517,239,239,230,280,5505,738,178,220,209,251,1596,0.16338277617888,0.744769874476987,0.920502092050209,0.908695652173913,0.896428571428572,0.28991825613079
E02005697,Central Wellingborough,Wellingborough,East Midlands,1281,4410,378,341,231,476,5836,1261,5081,354,314,250,462,6461,754,273,283,219,408,1937,0.148395985042314,0.771186440677966,0.901273885350319,0.876,0.883116883116883,0.299798792756539
E02005698,Brickhill,Wellingborough,East Midlands,1278,3431,338,345,232,295,4641,1309,4020,294,343,268,357,5282,689,231,322,250,328,1820,0.171393034825871,0.785714285714286,0.938775510204082,0.932835820895522,0.918767507002801,0.344566452101477
E02005699,Croyland,Wellingborough,East Midlands,2177,5053,338,311,202,245,6149,2121,6016,335,308,210,270,7139,1013,269,275,193,233,1983,0.168384308510638,0.802985074626866,0.892857142857143,0.919047619047619,0.862962962962963,0.277769995797731
E02005700,Earls Barton & Great Doddington,Wellingborough,East Midlands,1658,5203,678,691,474,551,7597,1629,6116,756,787,532,596,8787,1389,688,744,512,570,3903,0.227109221713538,0.91005291005291,0.945362134688691,0.962406015037594,0.956375838926174,0.444178900648686
E02005701,"Irchester, Wollaston & Bozeat",Wellingborough,East Midlands,2069,6300,715,851,462,577,8905,1930,6990,714,835,552,601,9692,1269,607,789,527,560,3752,0.181545064377682,0.850140056022409,0.944910179640719,0.954710144927536,0.931780366056572,0.387123400742881
E02005819,Stanton Hill & Skegby,Ashfield,East Midlands,1177,3827,433,423,295,342,5320,1176,3963,449,400,348,335,5495,1162,392,362,322,317,2555,0.293212212969972,0.873051224944321,0.905,0.925287356321839,0.946268656716418,0.464968152866242
E02005820,The Dales & South Skegby,Ashfield,East Midlands,819,3289,350,424,341,300,4704,848,3403,348,395,370,365,4881,1163,312,367,351,337,2530,0.341757272994417,0.896551724137931,0.929113924050633,0.948648648648649,0.923287671232877,0.518336406474083
E02005821,Huthwaite,Ashfield,East Midlands,1459,4338,370,341,264,235,5548,1414,4404,345,350,272,265,5636,1112,273,321,254,248,2208,0.252497729336966,0.791304347826087,0.917142857142857,0.933823529411765,0.935849056603774,0.391767210787793
E02005822,Sutton Forest Side & New Cross,Ashfield,East Midlands,2318,6972,433,322,260,383,8370,2259,7102,436,360,250,392,8540,1976,366,328,231,356,3257,0.278231484088989,0.839449541284404,0.911111111111111,0.924,0.908163265306122,0.381381733021077
E02005823,Sutton Central & Leamington,Ashfield,East Midlands,1640,4820,365,353,261,518,6317,1615,4970,364,376,307,518,6535,1365,305,329,283,474,2756,0.274647887323944,0.837912087912088,0.875,0.921824104234528,0.915057915057915,0.421729150726855
E02005824,Sutton St Mary's & Ashfields,Ashfield,East Midlands,1776,6351,545,518,424,433,8271,1669,6464,530,559,434,466,8453,1974,479,520,416,443,3832,0.305383663366337,0.90377358490566,0.930232558139535,0.95852534562212,0.950643776824034,0.453330178634804
E02005825,East Kirkby,Ashfield,East Midlands,1614,4794,424,449,336,429,6432,1560,5016,432,459,347,412,6666,1504,368,420,330,371,2993,0.299840510366826,0.851851851851852,0.915032679738562,0.951008645533141,0.900485436893204,0.448994899489949
E02005826,Kirkby Central,Ashfield,East Midlands,1435,3910,301,251,189,290,4941,1438,4030,317,262,191,275,5075,1187,270,217,168,227,2069,0.29454094292804,0.851735015772871,0.82824427480916,0.879581151832461,0.825454545454545,0.407684729064039
E02005827,Kirkby Larwood & Kingsway,Ashfield,East Midlands,1788,5959,526,414,310,449,7658,1729,6022,532,432,322,479,7787,1877,482,387,303,443,3492,0.311690468282962,0.906015037593985,0.895833333333333,0.940993788819876,0.924843423799583,0.448439707204315
E02005828,Annesley & Kirkby Woodhouse,Ashfield,East Midlands,1379,4774,516,534,397,363,6584,1299,4742,461,510,424,379,6516,1434,421,469,407,353,3084,0.302404048924505,0.913232104121475,0.919607843137255,0.959905660377358,0.931398416886544,0.47329650092081
E02005829,Selston,Ashfield,East Midlands,1110,4043,415,434,346,382,5620,1108,4193,404,478,332,402,5809,1110,362,442,311,379,2604,0.264726925828762,0.896039603960396,0.924686192468619,0.936746987951807,0.942786069651741,0.448269925976932
E02005830,Jacksdale & Underwoood,Ashfield,East Midlands,856,3568,423,461,325,341,5118,847,3714,435,442,341,347,5279,988,376,412,327,324,2427,0.266020463112547,0.864367816091954,0.932126696832579,0.958944281524927,0.93371757925072,0.459746164046221
E02005831,Hucknall North & East,Ashfield,East Midlands,1991,6618,486,485,351,469,8409,2145,6732,485,490,390,512,8609,1788,439,456,373,472,3528,0.265597147950089,0.905154639175258,0.930612244897959,0.956410256410256,0.921875,0.409803693808805
E02005832,Hucknall Town,Ashfield,East Midlands,1813,6021,445,385,306,405,7562,1708,6090,388,377,330,441,7626,1412,322,332,297,400,2763,0.231855500821018,0.829896907216495,0.880636604774536,0.9,0.90702947845805,0.362313139260425
E02005833,West Hucknall,Ashfield,East Midlands,1294,4642,532,501,371,388,6434,1289,4676,469,521,396,404,6466,1332,421,488,379,382,3002,0.284858853721129,0.897654584221748,0.936660268714012,0.957070707070707,0.945544554455445,0.464274667491494
E02005834,Hucknall Westville,Ashfield,East Midlands,1720,5017,359,386,305,374,6441,1814,5607,365,387,326,403,7088,1511,300,354,301,344,2810,0.269484572855359,0.821917808219178,0.914728682170543,0.923312883435583,0.853598014888337,0.396444695259594
E02005835,"Harworth, Bircotes & Blyth",Bassetlaw,East Midlands,2112,6409,556,602,481,625,8673,2157,6923,584,598,490,671,9266,1379,475,548,469,633,3504,0.199191102123357,0.813356164383562,0.916387959866221,0.957142857142857,0.943368107302534,0.378156701921002
E02005836,"Clarborough, Beckingham & Misterton",Bassetlaw,East Midlands,1522,5179,701,711,504,610,7705,1419,5400,635,723,553,647,7958,1140,550,692,534,610,3526,0.211111111111111,0.866141732283465,0.957123098201936,0.965641952983725,0.942812982998454,0.443076149786379
E02005837,"Ranskill, Everton & Gringley",Bassetlaw,East Midlands,1105,4946,596,539,367,393,6841,1066,5375,553,580,403,398,7309,933,478,555,378,379,2723,0.173581395348837,0.864376130198915,0.956896551724138,0.937965260545906,0.952261306532663,0.372554385004789
E02005838,Carlton & Langold,Bassetlaw,East Midlands,1434,4710,625,573,440,475,6823,1551,5127,598,586,431,483,7225,1129,491,550,418,464,3052,0.220206748585918,0.821070234113712,0.938566552901024,0.969837587006961,0.960662525879917,0.42242214532872
E02005839,Retford North,Bassetlaw,East Midlands,992,3638,437,439,321,541,5376,970,3856,436,454,338,505,5589,923,380,435,330,481,2549,0.239367219917012,0.871559633027523,0.958149779735683,0.976331360946746,0.952475247524752,0.456074431919843
E02005840,Worksop North,Bassetlaw,East Midlands,1896,6006,428,410,240,315,7399,1988,6533,429,424,285,308,7979,1499,347,401,266,298,2811,0.229450482167458,0.808857808857809,0.945754716981132,0.933333333333333,0.967532467532468,0.352299786940719
E02005842,Retford East,Bassetlaw,East Midlands,1602,5068,506,560,375,612,7121,1512,5502,483,551,420,633,7589,1218,423,526,406,596,3169,0.221374045801527,0.875776397515528,0.954627949183303,0.966666666666667,0.941548183254344,0.417578073527474
E02005843,"Worksop West, Shireoaks & Rhodesia",Bassetlaw,East Midlands,1355,4368,290,284,209,306,5457,1395,4788,330,320,212,257,5907,1062,271,298,198,244,2073,0.221804511278196,0.821212121212121,0.93125,0.933962264150943,0.949416342412451,0.350939563230066
E02005844,Retford South,Bassetlaw,East Midlands,1721,5214,460,472,304,399,6849,1743,5633,461,484,343,433,7354,1287,405,461,331,413,2897,0.228475057695722,0.878524945770065,0.952479338842975,0.965014577259475,0.953810623556582,0.393935273320642
E02005846,Worksop Cheapside,Bassetlaw,East Midlands,1638,4700,286,231,153,265,5635,1635,5543,314,258,198,252,6565,954,219,228,180,238,1819,0.172108966263756,0.697452229299363,0.883720930232558,0.909090909090909,0.944444444444444,0.277075399847677
E02005847,Worksop Town & South,Bassetlaw,East Midlands,1215,4425,391,460,284,397,5957,1155,4912,401,399,318,415,6445,1046,328,378,305,403,2460,0.212947882736156,0.817955112219451,0.947368421052632,0.959119496855346,0.971084337349398,0.381691233514352
E02005848,"Manton, Clumber & Elkesley",Bassetlaw,East Midlands,1077,3765,405,466,323,384,5343,1069,4107,427,454,367,419,5774,971,350,430,352,409,2512,0.236425614803993,0.819672131147541,0.947136563876652,0.959128065395095,0.976133651551313,0.435053688950468
E02005849,"Tuxford, Markham & Rampton",Bassetlaw,East Midlands,1543,5499,663,752,474,463,7851,1532,5693,636,749,515,541,8134,1376,577,708,491,517,3669,0.241700333743193,0.907232704402516,0.945260347129506,0.953398058252427,0.955637707948244,0.45106958446029
E02006903,Worksop Kilton,Bassetlaw,East Midlands,1859,6426,749,806,557,820,9358,1920,7002,707,813,571,779,9872,1746,550,769,556,752,4373,0.249357326478149,0.777934936350778,0.945879458794588,0.973730297723293,0.965340179717587,0.442970016207455
E02005850,Eastwood Hall & Brinsley,Broxtowe,East Midlands,1136,4152,497,521,334,419,5923,1056,4054,454,558,375,434,5875,1035,403,522,360,399,2719,0.255303404045387,0.887665198237886,0.935483870967742,0.96,0.919354838709677,0.462808510638298
E02005851,Eastwood Town,Broxtowe,East Midlands,1223,3799,360,359,205,335,5058,1290,3982,366,361,261,337,5307,921,277,337,246,322,2103,0.231290808638875,0.756830601092896,0.933518005540166,0.942528735632184,0.955489614243323,0.396269078575466
E02005852,Eastwood East,Broxtowe,East Midlands,1271,4867,526,686,490,559,7128,1290,4989,484,661,525,596,7255,1350,438,636,497,560,3481,0.270595309681299,0.90495867768595,0.962178517397882,0.946666666666667,0.939597315436242,0.479807029634735
E02005853,Kimberley North & Watnall,Broxtowe,East Midlands,1562,5605,623,607,380,459,7674,1554,5732,618,639,414,473,7876,1455,557,600,398,446,3456,0.253838101884159,0.901294498381877,0.938967136150235,0.961352657004831,0.94291754756871,0.438801422041646
E02005856,Bramcote,Broxtowe,East Midlands,1231,4042,528,568,354,611,6103,1179,4356,483,618,407,617,6481,1152,439,601,391,586,3169,0.264462809917355,0.908902691511387,0.972491909385113,0.960687960687961,0.949756888168558,0.48896775189014
E02005857,Stapleford North,Broxtowe,East Midlands,1382,3848,299,345,265,332,5089,1236,3889,290,313,268,311,5071,889,246,293,248,284,1960,0.228593468758036,0.848275862068966,0.936102236421725,0.925373134328358,0.913183279742765,0.386511536186157
E02005858,Beeston North,Broxtowe,East Midlands,1401,5643,333,322,238,318,6854,1428,6943,367,377,236,334,8257,1250,322,341,220,316,2449,0.18003744778914,0.877384196185286,0.904509283819629,0.932203389830508,0.946107784431138,0.296596826934722
E02005859,Stapleford South,Broxtowe,East Midlands,1735,5803,494,478,350,435,7560,1731,6173,470,490,373,496,8002,1431,411,455,340,475,3112,0.231815972784708,0.874468085106383,0.928571428571429,0.911528150134048,0.957661290322581,0.388902774306423
E02005860,Beeston Town,Broxtowe,East Midlands,1190,6589,381,375,281,509,8135,1247,8489,372,381,321,477,10040,1277,309,349,292,441,2668,0.150429968194134,0.830645161290323,0.916010498687664,0.909657320872274,0.924528301886792,0.265737051792829
E02005861,Beeston Rylands,Broxtowe,East Midlands,948,3746,261,247,206,228,4688,866,4058,266,266,178,248,5016,844,226,243,164,230,1707,0.207984228684081,0.849624060150376,0.913533834586466,0.921348314606742,0.92741935483871,0.340311004784689
E02005862,Chilwell West,Broxtowe,East Midlands,1567,4960,386,450,387,473,6656,1478,5308,365,456,364,492,6985,1194,320,429,345,463,2751,0.224943481537302,0.876712328767123,0.94078947368421,0.947802197802198,0.941056910569106,0.393843951324266
E02005863,Attenborough & Chilwell East,Broxtowe,East Midlands,1309,4420,428,477,341,621,6287,1259,4705,446,501,394,680,6726,1128,407,475,381,649,3040,0.239744952178534,0.912556053811659,0.94810379241517,0.967005076142132,0.954411764705882,0.451977401129944
E02005864,Toton,Broxtowe,East Midlands,1514,5198,425,387,306,437,6753,1454,5294,481,425,308,481,6989,1244,430,404,294,458,2830,0.234982999622214,0.893970893970894,0.950588235294118,0.954545454545455,0.952182952182952,0.404922020317642
E02006906,"Kimberley South, Trowell & Awsworth",Broxtowe,East Midlands,2050,7745,787,835,487,752,10606,1993,7689,761,866,587,729,10632,1907,679,830,557,690,4663,0.248016647158278,0.892247043363995,0.958429561200924,0.948892674616695,0.946502057613169,0.438581640331076
E02005865,Ravenshead & Newstead,Gedling,East Midlands,1335,4568,591,664,500,635,6958,1375,4975,551,662,522,645,7355,1496,495,626,508,590,3715,0.30070351758794,0.898366606170599,0.945619335347432,0.973180076628353,0.914728682170543,0.505098572399728
E02005866,Calverton & Woodborough,Gedling,East Midlands,1630,5494,644,658,449,541,7786,1609,5511,611,695,468,622,7907,1646,568,662,453,602,3931,0.298675376519688,0.92962356792144,0.952517985611511,0.967948717948718,0.967845659163987,0.497154420134058
E02005868,Redhill,Gedling,East Midlands,1368,4262,406,466,285,372,5791,1381,4598,408,435,313,426,6180,1336,372,416,299,406,2829,0.290561113527621,0.911764705882353,0.95632183908046,0.955271565495208,0.953051643192488,0.457766990291262
E02005869,Arnold Town,Gedling,East Midlands,1358,3710,278,246,176,321,4731,1286,3877,279,286,168,320,4930,1062,244,271,158,300,2035,0.273923136445705,0.874551971326165,0.947552447552448,0.940476190476191,0.9375,0.412778904665314
E02005870,Daybrook,Gedling,East Midlands,1320,4432,272,265,199,380,5548,1305,4503,272,306,190,355,5626,1092,229,279,184,339,2123,0.242504996668887,0.841911764705882,0.911764705882353,0.968421052631579,0.954929577464789,0.377355136864557
E02005871,Plains Estate,Gedling,East Midlands,1151,4222,492,535,330,417,5996,1099,4250,482,540,387,457,6116,1265,443,520,365,432,3025,0.297647058823529,0.919087136929461,0.962962962962963,0.943152454780362,0.945295404814004,0.494604316546763
E02005872,Burton Joyce & Lambley,Gedling,East Midlands,1065,3399,440,474,347,495,5155,1087,3640,452,451,376,528,5447,918,416,420,361,503,2618,0.252197802197802,0.920353982300885,0.931263858093126,0.960106382978723,0.952651515151515,0.480631540297411
E02005873,Woodthorpe & Arno Vale,Gedling,East Midlands,1695,5885,677,677,438,678,8355,1697,6191,661,721,517,769,8859,1674,604,687,498,726,4189,0.270392505249556,0.913767019667171,0.952843273231623,0.963249516441006,0.94408322496749,0.472852466418332
E02005874,Mapperley & Porchester,Gedling,East Midlands,1474,5488,475,483,310,485,7241,1456,5702,500,543,345,530,7620,1452,450,515,324,499,3240,0.254647492108032,0.9,0.948434622467772,0.939130434782609,0.941509433962264,0.425196850393701
E02005875,Gedling North,Gedling,East Midlands,1550,4974,401,404,288,417,6484,1589,5158,394,399,281,406,6638,1285,353,373,271,384,2666,0.249127568825126,0.895939086294416,0.93483709273183,0.9644128113879,0.945812807881773,0.401626996083158
E02005876,Gedling South,Gedling,East Midlands,1581,5428,496,510,348,599,7381,1600,5771,492,521,400,549,7733,1441,446,480,374,536,3277,0.249696759660371,0.90650406504065,0.921305182341651,0.935,0.97632058287796,0.423768265873529
E02005877,Carlton Hill,Gedling,East Midlands,1308,4548,381,312,203,355,5799,1400,4832,388,368,249,360,6197,1139,348,337,238,330,2392,0.235720198675497,0.896907216494845,0.915760869565217,0.955823293172691,0.916666666666667,0.385993222527029
E02005878,Carlton,Gedling,East Midlands,1790,6393,601,508,337,526,8365,1670,6565,579,545,372,576,8637,1501,506,498,346,545,3396,0.228636709824829,0.873920552677029,0.913761467889908,0.93010752688172,0.946180555555556,0.393192080583536
E02005879,Netherfield & Colwick,Gedling,East Midlands,1456,5245,273,270,188,198,6174,1463,5291,307,285,199,227,6309,1161,260,263,188,217,2089,0.219429219429219,0.846905537459283,0.92280701754386,0.944723618090452,0.955947136563877,0.331114281185608
E02006835,Bestwood Village,Gedling,East Midlands,1044,3877,379,311,188,252,5007,1100,3947,398,330,209,278,5162,1041,362,308,200,265,2176,0.263744616164175,0.909547738693467,0.933333333333333,0.956937799043062,0.953237410071942,0.421542037969779
E02005880,Church Warsop & Meden Vale,Mansfield,East Midlands,1352,3738,321,357,254,366,5036,1336,4003,355,324,282,337,5301,1229,308,298,274,306,2415,0.307019735198601,0.867605633802817,0.919753086419753,0.971631205673759,0.908011869436202,0.45557441992077
E02005881,Market Warsop,Mansfield,East Midlands,1209,3761,383,299,233,380,5056,1243,4083,365,350,256,294,5348,1296,312,300,234,262,2404,0.317413666421749,0.854794520547945,0.857142857142857,0.9140625,0.891156462585034,0.449513836948392
E02005882,"Manor, Hornby & Peafields",Mansfield,East Midlands,1226,4375,542,579,419,417,6332,1294,4713,543,583,434,469,6742,1663,489,543,412,433,3540,0.352853808614471,0.900552486187845,0.93138936535163,0.949308755760369,0.923240938166311,0.525066745772768
E02005883,Woodhouse,Mansfield,East Midlands,1813,5262,429,378,279,356,6704,1765,5623,380,380,301,346,7030,1793,313,345,280,315,3046,0.318868931175529,0.823684210526316,0.907894736842105,0.930232558139535,0.910404624277457,0.433285917496444
E02005884,Yeoman Hill & Maun Valley,Mansfield,East Midlands,962,3698,383,340,248,295,4964,992,3940,397,385,273,297,5292,1261,352,338,258,267,2476,0.32005076142132,0.886649874055416,0.877922077922078,0.945054945054945,0.898989898989899,0.467876039304611
E02005885,Abbott Road & Pleasley Hill,Mansfield,East Midlands,1492,4879,561,510,346,509,6805,1622,5539,557,516,365,472,7449,1717,493,476,341,443,3470,0.309983751579708,0.885098743267504,0.922480620155039,0.934246575342466,0.938559322033898,0.46583434017989
E02005886,Forest Town & Newlands,Mansfield,East Midlands,2209,6861,624,597,413,541,9036,2220,7370,635,607,484,571,9667,2427,547,552,448,509,4483,0.329308005427408,0.861417322834646,0.909390444810544,0.925619834710744,0.891418563922942,0.463742629564498
E02005887,Mansfield Town Centre & Broomhill,Mansfield,East Midlands,1953,7125,409,334,271,492,8631,1997,8094,400,340,272,436,9542,1453,290,273,239,382,2637,0.179515690635038,0.725,0.802941176470588,0.878676470588235,0.876146788990826,0.276357157828548
E02005888,Newgate & Carr Bank,Mansfield,East Midlands,1765,5600,361,307,205,275,6748,1699,6031,392,327,232,289,7271,1366,313,269,197,249,2394,0.226496435085392,0.798469387755102,0.82262996941896,0.849137931034483,0.86159169550173,0.329253197634438
E02005889,Grange Farm & Ladybrook,Mansfield,East Midlands,2016,6444,592,572,352,531,8491,2073,7015,612,584,435,580,9226,1994,515,516,401,523,3949,0.284248039914469,0.841503267973856,0.883561643835616,0.92183908045977,0.901724137931035,0.428029481898981
E02005890,Eakring & Ling Forest,Mansfield,East Midlands,1102,4079,430,487,286,321,5603,1007,4099,440,448,345,341,5673,1432,393,418,324,310,2877,0.349353500853867,0.893181818181818,0.933035714285714,0.939130434782609,0.909090909090909,0.50713907985193
E02005891,Oak Tree & Ransom Wood,Mansfield,East Midlands,1318,4180,285,267,195,253,5180,1385,4510,303,243,212,268,5536,1270,253,205,188,242,2158,0.28159645232816,0.834983498349835,0.843621399176955,0.886792452830189,0.902985074626866,0.389812138728324
E02005892,"King's Walk, Berry Hill & Oakham",Mansfield,East Midlands,2250,7391,718,706,499,746,10060,2334,8008,725,746,521,766,10766,2495,657,706,498,730,5086,0.311563436563437,0.906206896551724,0.946380697050938,0.955854126679463,0.953002610966058,0.472413152517184
E02005893,Ollerton & Boughton,Newark and Sherwood,East Midlands,2199,6802,610,589,393,523,8917,2206,7480,650,615,435,533,9713,2100,551,568,405,477,4101,0.280748663101604,0.847692307692308,0.923577235772358,0.931034482758621,0.894934333958724,0.422217646453207
E02005894,Edwinstowe & Clipstone,Newark and Sherwood,East Midlands,2224,6469,620,586,400,569,8644,2283,7213,588,601,453,608,9463,2355,526,549,427,557,4414,0.326493830583668,0.894557823129252,0.913477537437604,0.942604856512141,0.916118421052632,0.466448272218113
E02005895,"Muskham, Sutton on Trent & Walesby",Newark and Sherwood,East Midlands,1153,4543,639,686,439,520,6827,1150,4757,639,698,501,539,7134,1318,592,673,484,523,3590,0.277065377338659,0.926447574334898,0.964183381088825,0.966067864271457,0.970315398886827,0.503223997757219
E02005896,"Winthorpe, Coddington & Collingham",Newark and Sherwood,East Midlands,1116,4091,586,736,448,576,6437,1050,4317,548,712,528,582,6687,1126,508,691,513,560,3398,0.260829279592309,0.927007299270073,0.970505617977528,0.971590909090909,0.962199312714777,0.508150142066697
E02005897,Bilsthorpe & Farnsfield,Newark and Sherwood,East Midlands,1704,5399,617,687,416,581,7700,1579,5734,589,670,461,588,8042,1807,528,615,431,542,3923,0.315137774677363,0.896434634974533,0.917910447761194,0.934924078091106,0.921768707482993,0.487813976622731
E02005898,Rainworth & Blidworth,Newark and Sherwood,East Midlands,2114,7162,569,512,400,509,9152,2111,7625,627,557,404,553,9766,2442,531,491,368,492,4324,0.320262295081967,0.84688995215311,0.881508078994614,0.910891089108911,0.889692585895118,0.442760597993037
E02005899,Newark North,Newark and Sherwood,East Midlands,2398,8229,581,479,352,426,10067,2351,8944,613,529,385,477,10948,1418,497,486,351,439,3191,0.158542039355993,0.810766721044046,0.918714555765595,0.911688311688312,0.920335429769392,0.291468761417611
E02005900,Southwell,Newark and Sherwood,East Midlands,1082,4086,464,632,473,650,6305,1020,4276,458,626,524,697,6581,995,411,592,513,678,3189,0.232694106641721,0.897379912663756,0.945686900958466,0.979007633587786,0.972740315638451,0.484576812034645
E02005901,Newark South East,Newark and Sherwood,East Midlands,1991,6109,464,458,358,433,7822,1911,6571,521,461,369,474,8396,1304,442,422,344,445,2957,0.198447724851621,0.848368522072937,0.915401301518438,0.932249322493225,0.938818565400844,0.35219151977132
E02005902,Newark South West,Newark and Sherwood,East Midlands,1604,4929,524,495,316,474,6738,1706,5338,492,511,330,492,7163,1233,432,478,309,464,2916,0.230985387785688,0.878048780487805,0.935420743639922,0.936363636363636,0.943089430894309,0.407092000558425
E02005903,Balderton,Newark and Sherwood,East Midlands,1751,5890,648,673,535,599,8345,1732,6320,613,706,594,676,8909,1614,548,669,562,631,4024,0.255379746835443,0.893964110929853,0.947592067988669,0.946127946127946,0.933431952662722,0.451678078347738
E02005904,"Fernwood, Farndon & Fiskerton",Newark and Sherwood,East Midlands,1751,5456,542,585,403,594,7580,1694,5658,582,600,424,546,7810,1464,522,571,413,520,3490,0.258748674443266,0.896907216494845,0.951666666666667,0.974056603773585,0.952380952380952,0.446862996158771
E02005905,"Lowdham, Bleasby & Gunthorpe",Newark and Sherwood,East Midlands,916,4167,432,500,312,473,5884,841,4020,442,520,354,493,5829,1083,413,495,339,475,2805,0.269402985074627,0.934389140271493,0.951923076923077,0.957627118644068,0.963488843813387,0.481214616572311
E02005906,East Bridgford & Aslockton,Rushcliffe,East Midlands,1122,4468,513,478,338,520,6317,1050,4438,513,521,367,502,6341,1036,477,504,357,486,2860,0.233438485804416,0.929824561403509,0.967370441458733,0.97275204359673,0.968127490039841,0.451032960100931
E02005907,Bingham,Rushcliffe,East Midlands,2104,5955,559,579,438,562,8093,1999,5998,516,584,483,604,8185,1367,481,549,472,575,3444,0.227909303101034,0.932170542635659,0.940068493150685,0.977225672877847,0.951986754966887,0.420769700671961
E02005908,Radcliffe on Trent & Shelford,Rushcliffe,East Midlands,1619,5204,606,670,495,824,7799,1524,5206,557,666,527,840,7796,1338,522,648,510,814,3832,0.257011140991164,0.937163375224416,0.972972972972973,0.967741935483871,0.969047619047619,0.49153412006157
E02005909,Lady Bay,Rushcliffe,East Midlands,1837,5538,370,300,173,314,6695,1767,5825,388,351,209,302,7075,1149,345,327,200,277,2298,0.19725321888412,0.889175257731959,0.931623931623932,0.956937799043062,0.917218543046358,0.324805653710247
E02005910,West Bridgford,Rushcliffe,East Midlands,1615,6948,317,253,141,377,8036,1530,6973,337,293,172,354,8129,1216,289,263,160,325,2253,0.174386920980926,0.857566765578635,0.897610921501707,0.930232558139535,0.918079096045198,0.27715586172961
E02005911,Gamston & Holme Pierrepoint,Rushcliffe,East Midlands,1769,5501,449,405,235,371,6961,1657,5677,452,438,272,366,7205,1359,427,427,264,349,2826,0.239387000176149,0.944690265486726,0.974885844748858,0.970588235294118,0.953551912568306,0.392227619708536
E02005912,Compton Acres & Lutterell,Rushcliffe,East Midlands,1812,5740,510,452,339,634,7675,1767,6141,527,509,355,656,8188,1476,476,477,335,612,3376,0.240351734245237,0.903225806451613,0.93713163064833,0.943661971830986,0.932926829268293,0.412310698583293
E02005913,Edwalton,Rushcliffe,East Midlands,1627,4605,441,406,292,539,6283,1755,5236,431,425,328,565,6985,1315,384,400,305,529,2933,0.251145912910619,0.890951276102088,0.941176470588235,0.929878048780488,0.936283185840708,0.419899785254116
E02005914,Cotgrave,Rushcliffe,East Midlands,1609,5074,377,387,288,378,6504,1649,5213,403,389,315,386,6706,1291,363,363,291,371,2679,0.247650105505467,0.900744416873449,0.933161953727506,0.923809523809524,0.961139896373057,0.399492991351029
E02005915,"Cropwell Bishop, Kinoulton & Upper Broughton",Rushcliffe,East Midlands,940,3278,444,456,297,315,4790,862,3366,421,475,335,350,4947,814,399,461,326,335,2335,0.241830065359477,0.947743467933492,0.970526315789474,0.973134328358209,0.957142857142857,0.472003234283404
E02005916,Ruddington,Rushcliffe,East Midlands,1531,4745,405,408,308,459,6325,1496,4785,430,415,330,460,6420,1178,396,391,309,420,2694,0.246185997910136,0.92093023255814,0.942168674698795,0.936363636363636,0.91304347826087,0.419626168224299
E02005917,"Keyworth North, Tollerton & Willoughby",Rushcliffe,East Midlands,886,3068,363,549,352,577,4909,880,3302,374,511,395,620,5202,822,357,494,383,575,2631,0.248940036341611,0.954545454545455,0.966731898238747,0.969620253164557,0.92741935483871,0.505767012687428
E02005918,Keyworth South,Rushcliffe,East Midlands,810,2860,347,382,343,426,4358,799,2864,352,361,328,449,4354,671,336,343,316,435,2101,0.234287709497207,0.954545454545455,0.950138504155125,0.963414634146341,0.968819599109131,0.482544786403307
E02005919,"Ratcliffe, Sutton Bonington & Gotham",Rushcliffe,East Midlands,1274,4272,337,420,245,341,5615,1236,5284,330,411,326,336,6687,1033,302,393,314,318,2360,0.195495836487509,0.915151515151515,0.956204379562044,0.96319018404908,0.946428571428571,0.352923583071632
E02005920,East Leake,Rushcliffe,East Midlands,1459,4706,521,639,423,521,6810,1486,5125,525,617,471,543,7281,1196,492,595,451,507,3241,0.233365853658537,0.937142857142857,0.964343598055105,0.957537154989384,0.933701657458563,0.445131163301744
E02003237,"Glinton, Northborough & Maxey",Peterborough,East of England,940,3302,415,429,272,410,4828,919,3730,428,432,339,450,5379,734,381,428,331,430,2304,0.196782841823056,0.890186915887851,0.990740740740741,0.976401179941003,0.955555555555556,0.428332403792527
E02003238,Werrington,Peterborough,East of England,1172,3594,287,222,110,182,4395,1088,4205,325,234,144,192,5100,880,260,214,130,175,1659,0.209274673008323,0.8,0.914529914529914,0.902777777777778,0.911458333333333,0.325294117647059
E02003239,Newborough & Peakirk,Peterborough,East of England,1265,4301,497,509,330,472,6109,1387,5155,549,552,366,539,7161,1088,488,534,357,518,2985,0.21105722599418,0.888888888888889,0.967391304347826,0.975409836065574,0.961038961038961,0.416841223292836
E02003240,"Barnack, Wittering & Wansford",Peterborough,East of England,1668,4055,326,306,196,237,5120,1388,4478,357,346,216,262,5659,672,285,325,206,247,1735,0.150066994193837,0.798319327731092,0.939306358381503,0.953703703703704,0.942748091603053,0.306591270542499
E02003241,Eye & Thorney,Peterborough,East of England,1405,3878,356,375,290,271,5170,1405,4657,365,420,331,385,6158,988,336,401,322,365,2412,0.212153747047455,0.920547945205479,0.954761904761905,0.972809667673716,0.948051948051948,0.391685612211757
E02003242,Walton,Peterborough,East of England,1444,4446,506,507,417,633,6509,1514,5334,501,525,438,649,7447,1073,389,489,420,602,2973,0.201162354705662,0.776447105788423,0.931428571428571,0.958904109589041,0.927580893682589,0.399221162884383
E02003243,Paston,Peterborough,East of England,2905,6480,422,289,202,333,7726,3364,8538,456,342,205,299,9840,1288,301,296,182,278,2345,0.150855001171235,0.660087719298246,0.865497076023392,0.887804878048781,0.929765886287625,0.238313008130081
E02003244,Dogsthorpe,Peterborough,East of England,2369,5596,365,374,255,504,7094,2747,7193,388,351,264,433,8629,1030,256,288,234,393,2201,0.143194772695676,0.65979381443299,0.82051282051282,0.886363636363636,0.907621247113164,0.255070112411635
E02003245,North Bretton & Westwood,Peterborough,East of England,2071,4881,297,243,151,193,5765,2267,6544,328,282,157,181,7492,950,217,226,140,156,1689,0.145171149144254,0.661585365853659,0.801418439716312,0.89171974522293,0.861878453038674,0.22544046983449
E02003246,Millfield & Bourges Boulevard,Peterborough,East of England,2418,6765,279,234,134,220,7632,2997,10728,323,293,149,224,11717,914,145,222,121,186,1588,0.0851976137211037,0.448916408668731,0.757679180887372,0.812080536912752,0.830357142857143,0.135529572416147
E02003247,Bretton Park,Peterborough,East of England,1972,5060,406,392,253,287,6398,2100,6483,428,428,263,301,7903,1119,346,385,239,265,2354,0.172605275335493,0.808411214953271,0.899532710280374,0.908745247148289,0.880398671096346,0.297861571555106
E02003248,Central Park,Peterborough,East of England,2798,7185,332,282,183,442,8424,3358,10319,430,317,203,423,11692,894,247,232,174,354,1901,0.0866363019672449,0.574418604651163,0.73186119873817,0.857142857142857,0.836879432624114,0.162589804994868
E02003249,Fengate & Parnwell,Peterborough,East of England,3170,7397,430,396,291,406,8920,3360,9603,515,443,305,408,11274,1256,348,380,283,363,2630,0.130792460689368,0.675728155339806,0.857787810383747,0.927868852459016,0.889705882352941,0.233280113535569
E02003250,Peterborough Central,Peterborough,East of England,2727,8512,399,237,178,417,9743,3202,12399,458,279,177,414,13727,909,238,207,131,324,1809,0.0733123639003145,0.519650655021834,0.741935483870968,0.740112994350282,0.782608695652174,0.131784075180302
E02003251,Longthorpe & Netherton,Peterborough,East of England,1310,3883,531,524,386,611,5935,1511,4968,522,546,453,664,7153,1241,436,514,431,609,3231,0.249798711755234,0.835249042145594,0.941391941391941,0.951434878587196,0.917168674698795,0.451698588005033
E02003252,West Town & Woodston,Peterborough,East of England,3251,8316,316,281,178,346,9437,3609,10412,381,337,202,361,11693,1341,249,279,170,317,2356,0.128793699577411,0.653543307086614,0.827893175074184,0.841584158415842,0.878116343490305,0.201488069785342
E02003253,Fletton,Peterborough,East of England,2291,6250,356,333,243,366,7548,2469,7819,377,341,252,379,9168,1078,258,289,226,329,2180,0.137869292748433,0.684350132625995,0.847507331378299,0.896825396825397,0.868073878627968,0.237783595113438
E02003254,Orton West & Castor,Peterborough,East of England,1546,4962,600,602,339,551,7054,1575,5835,589,632,417,608,8081,1198,521,603,396,581,3299,0.205312767780634,0.884550084889644,0.954113924050633,0.949640287769784,0.955592105263158,0.408241554263086
E02003255,Stanground,Peterborough,East of England,2737,6928,526,528,358,596,8936,3175,9120,587,524,386,630,11247,1321,424,482,367,592,3186,0.14484649122807,0.722316865417377,0.919847328244275,0.950777202072539,0.93968253968254,0.283275540144038
E02003257,Orton Malborne & Goldhay,Peterborough,East of England,2320,5465,407,298,193,250,6613,2487,7070,419,364,213,256,8322,1054,314,328,194,236,2126,0.149080622347949,0.749403341288783,0.901098901098901,0.910798122065728,0.921875,0.255467435712569
E02006877,Hargate & Orton Longueville,Peterborough,East of England,2330,6082,341,337,286,349,7395,2376,7091,404,338,301,395,8529,1188,338,306,282,377,2491,0.167536313637005,0.836633663366337,0.905325443786982,0.93687707641196,0.954430379746835,0.292062375425021
E02006878,Hampton Vale,Peterborough,East of England,3276,7485,195,133,97,213,8123,3716,9226,256,207,116,195,10000,1374,184,171,109,186,2024,0.148926945588554,0.71875,0.826086956521739,0.939655172413793,0.953846153846154,0.2024
E02003258,Bramingham,Luton,East of England,1564,4912,486,519,336,440,6693,1559,5728,527,474,396,521,7646,1095,463,435,367,474,2834,0.191166201117318,0.878557874762808,0.917721518987342,0.926767676767677,0.90978886756238,0.370651320952132
E02003259,Sundon Park,Luton,East of England,1444,3676,286,251,208,306,4727,1579,4675,326,253,222,305,5781,736,257,211,205,275,1684,0.157433155080214,0.788343558282209,0.83399209486166,0.923423423423423,0.901639344262295,0.291299083203598
E02003260,Marsh Farm,Luton,East of England,2292,5037,315,295,188,187,6022,2547,6479,337,280,165,219,7480,1027,242,242,132,170,1813,0.158512116067294,0.718100890207715,0.864285714285714,0.8,0.776255707762557,0.242379679144385
E02003261,Warden Hill,Luton,East of England,1135,3379,287,355,316,515,4852,1227,4217,292,308,351,514,5682,754,234,282,317,468,2055,0.178800094854162,0.801369863013699,0.915584415584416,0.903133903133903,0.910505836575875,0.361668426610349
E02003262,Leagrave,Luton,East of England,2427,6049,459,413,287,493,7701,2700,7587,480,419,332,454,9272,1196,359,337,282,377,2551,0.157638065111375,0.747916666666667,0.804295942720764,0.849397590361446,0.830396475770925,0.275129421915444
E02003263,Limbury,Luton,East of England,2999,7125,399,431,377,701,9033,3241,9026,468,423,394,681,10992,1323,345,358,348,590,2964,0.146576556614226,0.737179487179487,0.846335697399527,0.883248730964467,0.866372980910426,0.269650655021834
E02003264,Barnfield,Luton,East of England,2138,5668,387,327,241,487,7110,2287,6635,438,366,261,492,8192,1110,364,323,241,444,2482,0.167294649585531,0.831050228310502,0.882513661202186,0.923371647509579,0.902439024390244,0.302978515625
E02003265,Stopsley North,Luton,East of England,1417,4725,443,432,332,451,6383,1479,5339,473,485,321,422,7040,1009,406,458,307,390,2570,0.188986701629519,0.858350951374207,0.944329896907217,0.956386292834891,0.924170616113744,0.365056818181818
E02003266,Lewsey North,Luton,East of England,2402,5551,342,229,233,416,6771,2632,7120,366,276,216,368,8346,1256,264,237,191,311,2259,0.176404494382022,0.721311475409836,0.858695652173913,0.884259259259259,0.845108695652174,0.270668583752696
E02003267,Montrose Avenue,Luton,East of England,4078,8457,378,246,229,340,9650,4390,10851,434,308,216,336,12145,1375,285,236,179,257,2332,0.126716431665284,0.65668202764977,0.766233766233766,0.828703703703704,0.764880952380952,0.192013174145739
E02003268,Challney,Luton,East of England,3425,7177,343,277,207,405,8409,3573,8863,357,276,218,390,10104,1258,251,213,176,313,2211,0.141938395577118,0.703081232492997,0.771739130434783,0.807339449541285,0.802564102564103,0.218824228028504
E02003269,Stopsley South & Round Green,Luton,East of England,2111,6496,441,415,305,536,8193,2301,7365,419,415,333,487,9019,1073,346,369,302,445,2535,0.145689069925322,0.825775656324582,0.889156626506024,0.906906906906907,0.913757700205339,0.281073289721699
E02003270,Lewsey South,Luton,East of England,1821,4908,318,310,264,533,6333,1978,6194,330,322,271,555,7672,1386,241,286,247,496,2656,0.22376493380691,0.73030303030303,0.888198757763975,0.911439114391144,0.893693693693694,0.346193952033368
E02003271,Wigmore & Airport,Luton,East of England,1999,6393,428,347,182,272,7622,2170,7431,485,400,228,276,8820,1226,424,372,218,252,2492,0.164984524290136,0.874226804123711,0.93,0.956140350877193,0.91304347826087,0.282539682539683
E02003272,Kingsway,Luton,East of England,3071,6285,320,159,155,261,7180,3490,9019,414,264,163,325,10185,983,261,189,120,220,1773,0.108992127730347,0.630434782608696,0.715909090909091,0.736196319018405,0.676923076923077,0.174079528718704
E02003273,St Anns Hill,Luton,East of England,2635,6761,436,365,216,384,8162,2889,8452,480,386,225,356,9899,1313,387,328,197,306,2531,0.155347846663512,0.80625,0.849740932642487,0.875555555555556,0.859550561797753,0.255682392160824
E02003274,Bury Park,Luton,East of England,3447,7034,221,175,138,266,7834,3612,9634,382,185,166,293,10660,936,209,110,112,204,1571,0.0971559061656633,0.547120418848168,0.594594594594595,0.674698795180723,0.696245733788396,0.147373358348968
E02003275,Central Luton & Park Town,Luton,East of England,3165,11658,335,208,174,296,12671,3386,13400,405,272,158,289,14524,1042,243,193,124,237,1839,0.0777611940298508,0.6,0.709558823529412,0.784810126582278,0.820069204152249,0.126618011567061
E02003276,Dallow Road,Luton,East of England,2612,5797,220,155,90,215,6477,2674,7468,260,177,112,205,8222,687,156,123,87,158,1211,0.0919925013390466,0.6,0.694915254237288,0.776785714285714,0.770731707317073,0.147287764534177
E02003277,Farley Hill & Stockwood Park,Luton,East of England,2954,6876,367,290,169,374,8076,3171,8714,407,332,195,324,9972,1159,277,269,154,266,2125,0.133004360798715,0.680589680589681,0.810240963855422,0.78974358974359,0.820987654320988,0.213096670677898
E02003278,New Town,Luton,East of England,2998,10013,309,271,168,258,11019,2945,10905,345,270,187,217,11924,1003,213,218,150,166,1750,0.0919761577258138,0.617391304347826,0.807407407407407,0.802139037433155,0.764976958525346,0.146762831264676
E02003279,Eastwood Park,Southend-on-Sea,East of England,1592,5289,630,725,492,783,7919,1518,5587,595,699,574,802,8257,1104,510,667,553,761,3595,0.197601575085019,0.857142857142857,0.954220314735336,0.963414634146341,0.948877805486284,0.43538815550442
E02003280,Eastwood,Southend-on-Sea,East of England,1957,6095,640,663,442,654,8494,2026,6570,578,645,451,637,8881,1474,483,589,429,589,3564,0.224353120243531,0.835640138408305,0.913178294573643,0.951219512195122,0.924646781789639,0.401306159216304
E02003281,Belfairs,Southend-on-Sea,East of England,1549,5207,613,817,573,867,8077,1531,5595,595,743,602,839,8374,1073,476,701,562,781,3593,0.191778373547811,0.8,0.943472409152086,0.933554817275748,0.930870083432658,0.429066157153093
E02003282,Prittlewell,Southend-on-Sea,East of England,2133,6216,590,605,453,647,8511,2091,6833,570,569,465,661,9098,1399,488,516,425,599,3427,0.204741694716815,0.856140350877193,0.906854130052724,0.913978494623656,0.906202723146747,0.376676192569796
E02003283,Blenheim Park,Southend-on-Sea,East of England,2268,6636,608,576,397,657,8874,2291,7334,568,611,435,647,9595,1367,455,554,399,588,3363,0.18639214616853,0.801056338028169,0.90671031096563,0.917241379310345,0.908809891808346,0.35049504950495
E02003284,St Lukes,Southend-on-Sea,East of England,2467,7171,522,455,291,419,8858,2429,7708,504,457,307,421,9397,1634,419,421,292,382,3148,0.211987545407369,0.831349206349206,0.921225382932166,0.95114006514658,0.907363420427554,0.335000532084708
E02003285,Westborough,Southend-on-Sea,East of England,2582,7513,383,312,188,213,8609,2708,8361,441,325,227,264,9618,1583,340,272,193,224,2612,0.18933141968664,0.770975056689342,0.836923076923077,0.850220264317181,0.848484848484848,0.271574131836141
E02003286,West Leigh,Southend-on-Sea,East of England,1867,5530,502,561,386,596,7575,1884,5810,536,569,424,592,7931,924,437,546,407,563,2877,0.159036144578313,0.815298507462687,0.959578207381371,0.959905660377358,0.951013513513514,0.362753751103266
E02003287,Southchurch,Southend-on-Sea,East of England,1981,5605,602,647,435,813,8102,2052,6338,542,699,477,789,8845,1306,471,645,440,722,3584,0.206058693594194,0.8690036900369,0.92274678111588,0.922431865828092,0.915082382762991,0.40520067834935
E02003288,Victoria,Southend-on-Sea,East of England,3050,8302,420,398,267,452,9839,3051,9451,525,420,264,407,11067,1705,382,360,223,351,3021,0.180404190032801,0.727619047619048,0.857142857142857,0.84469696969697,0.862407862407862,0.272973705611277
E02003289,Leigh,Southend-on-Sea,East of England,2034,6661,464,460,319,527,8431,1788,6499,478,433,359,513,8282,925,388,388,325,468,2494,0.142329589167564,0.811715481171548,0.89607390300231,0.905292479108635,0.912280701754386,0.301134991547935
E02003290,Chalkwell,Southend-on-Sea,East of England,1726,6631,528,456,309,867,8791,1752,6843,554,539,380,771,9087,1240,454,489,346,696,3225,0.181207072921233,0.819494584837545,0.907235621521336,0.910526315789474,0.90272373540856,0.354902608121492
E02003291,Shoeburyness,Southend-on-Sea,East of England,2440,7325,641,721,407,460,9554,2304,7850,626,680,459,486,10101,1733,506,622,417,447,3725,0.220764331210191,0.808306709265176,0.914705882352941,0.908496732026144,0.919753086419753,0.368775368775369
E02003292,Kursaal,Southend-on-Sea,East of England,2690,8232,490,375,240,316,9653,2658,9054,514,405,264,327,10564,1585,383,335,235,281,2819,0.175060746631323,0.745136186770428,0.82716049382716,0.890151515151515,0.859327217125382,0.266849678152215
E02003293,Southend Central,Southend-on-Sea,East of England,1904,7952,401,456,352,638,9799,2111,8897,505,508,360,628,10898,1496,389,417,300,560,3162,0.168146566258289,0.77029702970297,0.820866141732284,0.833333333333333,0.89171974522293,0.290144980730409
E02003294,Thorpe Bay,Southend-on-Sea,East of England,1424,5129,595,713,557,856,7850,1400,5473,583,699,584,859,8198,1170,511,631,553,795,3660,0.213776722090261,0.876500857632933,0.902718168812589,0.946917808219178,0.925494761350407,0.446450353744816
E02003295,West Shoebury,Southend-on-Sea,East of England,2242,6100,571,626,390,596,8283,2142,6722,542,603,439,596,8902,1356,471,552,406,541,3326,0.20172567688188,0.8690036900369,0.915422885572139,0.924829157175399,0.907718120805369,0.373623904740508
E02003296,Corringham North & London Gateway,Thurrock,East of England,1164,3924,501,544,281,390,5640,1150,4389,445,558,324,408,6124,744,401,542,309,385,2381,0.169514695830485,0.901123595505618,0.971326164874552,0.953703703703704,0.943627450980392,0.38879817112998
E02003297,Corringham South,Thurrock,East of England,1414,4109,416,455,326,443,5749,1434,4524,366,469,360,418,6137,760,332,442,338,394,2266,0.167992926613616,0.907103825136612,0.942430703624733,0.938888888888889,0.942583732057416,0.369235782955842
E02003298,Stanford East,Thurrock,East of England,1212,4015,395,486,266,442,5604,1267,4493,358,483,321,476,6131,740,313,463,304,446,2266,0.164700645448475,0.874301675977654,0.958592132505176,0.947040498442368,0.936974789915966,0.369597129342685
E02003299,"Orsett, Bulphan & Hordon-on-the-Hill",Thurrock,East of England,1038,3601,400,365,252,333,4951,1006,4010,381,384,254,381,5410,694,337,360,233,358,1982,0.173067331670823,0.884514435695538,0.9375,0.917322834645669,0.939632545931758,0.366358595194085
E02003300,Stanford West,Thurrock,East of England,1868,5234,406,419,264,312,6635,1837,5673,396,455,302,313,7139,805,350,422,290,288,2155,0.14190022915565,0.883838383838384,0.927472527472528,0.960264900662252,0.920127795527156,0.301863006023253
E02003301,North Ockendon,Thurrock,East of England,2748,7333,467,442,287,294,8823,2887,8066,507,452,307,331,9663,1096,405,413,268,296,2478,0.135878998264319,0.798816568047337,0.913716814159292,0.872964169381108,0.894259818731118,0.256442098727103
E02003302,South Ockendon,Thurrock,East of England,2592,6931,419,317,193,280,8140,2454,6963,396,349,202,269,8179,1005,301,291,175,220,1992,0.144334338647135,0.76010101010101,0.833810888252149,0.866336633663366,0.817843866171004,0.243550556302727
E02003303,Aveley,Thurrock,East of England,2252,5705,425,326,216,263,6935,2189,6097,388,383,218,299,7385,885,296,349,188,268,1986,0.145153354108578,0.762886597938144,0.911227154046997,0.862385321100918,0.896321070234114,0.268923493568043
E02003304,Stifford Clays,Thurrock,East of England,2049,5814,519,548,312,542,7735,2048,6522,484,546,326,557,8435,949,413,498,303,527,2690,0.145507513032812,0.853305785123967,0.912087912087912,0.929447852760736,0.946140035906643,0.318909306461174
E02003305,Little Thurrock North,Thurrock,East of England,1449,3857,386,387,263,366,5259,1544,4315,365,400,286,353,5719,594,325,381,275,336,1911,0.13765932792584,0.89041095890411,0.9525,0.961538461538461,0.951841359773371,0.334149326805386
E02003307,Chadwell St Mary,Thurrock,East of England,2495,5964,477,448,333,621,7843,2520,6744,472,448,328,606,8598,1232,401,407,305,577,2922,0.182680901542112,0.849576271186441,0.908482142857143,0.929878048780488,0.952145214521452,0.339846475924634
E02003308,East Tilbury,Thurrock,East of England,1741,4516,340,294,181,162,5493,1860,4985,347,332,192,180,6036,966,288,300,176,170,1900,0.193781344032096,0.829971181556196,0.903614457831325,0.916666666666667,0.944444444444444,0.314777998674619
E02003309,Little Thurrock South,Thurrock,East of England,1489,4763,384,396,272,328,6143,1466,5150,412,384,265,386,6597,694,365,357,239,360,2015,0.134757281553398,0.885922330097088,0.9296875,0.90188679245283,0.932642487046632,0.305441867515537
E02003310,"Purfleet, South Stifford & Lakeside",Thurrock,East of England,4013,10424,318,232,147,148,11269,3949,10272,348,257,140,152,11169,1184,266,211,118,130,1909,0.115264797507788,0.764367816091954,0.821011673151751,0.842857142857143,0.855263157894737,0.170919509356254
E02003311,Grays Chafford Gorges & Orsett Road,Thurrock,East of England,1914,6405,258,279,177,318,7437,2044,6859,294,282,209,332,7976,819,233,233,176,314,1775,0.119405161102202,0.792517006802721,0.826241134751773,0.842105263157895,0.945783132530121,0.222542627883651
E02003312,Grays Town,Thurrock,East of England,2757,6782,192,150,96,102,7322,2640,6744,185,162,111,104,7306,632,131,133,100,97,1093,0.0937129300118624,0.708108108108108,0.820987654320988,0.900900900900901,0.932692307692308,0.149603065973173
E02003313,Tilbury,Thurrock,East of England,4260,8957,478,408,284,361,10488,4396,10324,497,447,283,374,11925,1589,382,373,235,322,2901,0.153913211933359,0.768611670020121,0.834451901565996,0.830388692579505,0.86096256684492,0.243270440251572
E02006859,South Chafford,Thurrock,East of England,2115,5742,105,95,60,46,6048,2054,5691,165,103,62,51,6072,647,118,86,50,33,934,0.11368827973994,0.715151515151515,0.83495145631068,0.806451612903226,0.647058823529412,0.153820816864295
E02006926,Chafford & North Stifford,Thurrock,East of England,2094,5538,223,168,119,115,6163,1925,5840,241,191,116,131,6519,793,195,169,105,116,1378,0.135787671232877,0.809128630705394,0.884816753926702,0.905172413793103,0.885496183206107,0.211382113821138
E02003616,Riseley & Sharnbrook,Bedford,East of England,964,3131,367,390,301,357,4546,934,3584,376,410,310,374,5054,762,351,393,303,362,2171,0.212611607142857,0.933510638297872,0.958536585365854,0.97741935483871,0.967914438502674,0.429560743965176
E02003617,"Harrold, Chellington & Turvey",Bedford,East of England,1513,5035,569,610,428,634,7276,1454,5642,574,635,463,584,7898,1131,540,613,438,558,3280,0.200460829493088,0.940766550522648,0.965354330708661,0.946004319654428,0.955479452054795,0.41529501139529
E02003618,"Clapham, Oakley & Thurleigh",Bedford,East of England,1744,5081,503,535,330,540,6989,1717,5632,483,563,368,536,7582,1208,440,539,350,512,3049,0.214488636363636,0.910973084886128,0.957371225577265,0.951086956521739,0.955223880597015,0.402136639409127
E02003619,"Wyboston, Great Barford & Cople",Bedford,East of England,2517,6914,686,680,456,562,9298,2361,7619,666,699,509,593,10086,1581,593,654,488,556,3872,0.207507546922168,0.89039039039039,0.935622317596567,0.958742632612967,0.937605396290051,0.383898473131073
E02003620,Brickhill,Bedford,East of England,1458,4463,508,571,375,660,6577,1476,5103,495,597,371,650,7216,1139,442,560,351,610,3102,0.223202038016853,0.892929292929293,0.938023450586265,0.946091644204852,0.938461538461539,0.429878048780488
E02003621,Putnoe,Bedford,East of England,1308,4202,564,653,416,627,6462,1328,4992,510,664,467,639,7272,1122,469,624,443,597,3255,0.224759615384615,0.919607843137255,0.939759036144578,0.948608137044968,0.934272300469484,0.447607260726073
E02003622,Goldington,Bedford,East of England,2090,5446,376,358,307,473,6960,2055,6481,426,398,294,487,8086,1260,371,350,269,446,2696,0.194414442215707,0.870892018779343,0.879396984924623,0.914965986394558,0.915811088295688,0.333415780361118
E02003623,Bromham & Biddenham,Bedford,East of England,2348,6279,605,602,340,536,8362,2677,7916,613,603,398,533,10063,1557,551,564,379,508,3559,0.196690247599798,0.898858075040783,0.935323383084577,0.952261306532663,0.953095684803002,0.353671867236411
E02003624,De Parys,Bedford,East of England,919,3639,244,300,194,466,4843,888,4205,271,255,207,441,5379,726,229,229,195,399,1778,0.172651605231867,0.845018450184502,0.898039215686275,0.942028985507246,0.904761904761905,0.330544710912809
E02003625,Harpur,Bedford,East of England,1381,5750,403,346,252,627,7378,1343,6947,423,363,259,586,8578,1101,317,307,228,488,2441,0.158485677270764,0.749408983451537,0.845730027548209,0.88030888030888,0.832764505119454,0.284565166705526
E02003626,Newnham,Bedford,East of England,1040,3480,235,243,153,215,4326,1051,3942,275,251,182,222,4872,754,252,233,166,203,1608,0.191273465246068,0.916363636363636,0.928286852589641,0.912087912087912,0.914414414414414,0.330049261083744
E02003627,Castle & Kingsway,Bedford,East of England,1866,7082,401,303,278,457,8521,1894,8565,458,364,257,453,10097,1192,362,310,227,388,2479,0.139171044950379,0.790393013100437,0.851648351648352,0.883268482490272,0.856512141280353,0.245518470832921
E02003628,Queens Park,Bedford,East of England,2661,5983,256,163,147,273,6822,2854,7400,301,225,127,280,8333,925,208,186,102,225,1646,0.125,0.691029900332226,0.826666666666667,0.803149606299213,0.803571428571429,0.197527901116045
E02003629,Kingsbrook,Bedford,East of England,2405,6420,371,314,211,470,7786,2530,7719,416,330,261,434,9160,1301,319,284,230,390,2524,0.168545148335277,0.766826923076923,0.860606060606061,0.881226053639847,0.898617511520737,0.275545851528384
E02003630,Cauldwell,Bedford,East of England,2554,7399,348,247,181,260,8435,2670,9000,385,287,183,276,10131,1517,267,230,157,234,2405,0.168555555555556,0.693506493506494,0.801393728222996,0.85792349726776,0.847826086956522,0.237390188530254
E02003631,Kempston North,Bedford,East of England,1015,3432,307,267,192,247,4445,987,3834,324,307,193,252,4910,828,285,285,186,241,1825,0.215962441314554,0.87962962962963,0.928338762214984,0.963730569948187,0.956349206349206,0.371690427698574
E02003632,Kempston Central & East,Bedford,East of England,1207,3712,301,277,156,270,4716,1217,4325,306,277,181,254,5343,972,265,262,170,236,1905,0.224739884393064,0.866013071895425,0.945848375451263,0.939226519337017,0.929133858267716,0.356541268950028
E02003633,Kempston West & South,Bedford,East of England,2329,5990,394,375,271,340,7370,2332,7088,428,419,305,322,8562,1535,380,398,290,295,2898,0.216563205417607,0.88785046728972,0.949880668257757,0.950819672131147,0.916149068322981,0.338472319551507
E02003634,"Elstow, Shortstown & Wixams",Bedford,East of England,3333,7872,578,601,333,435,9819,3722,9527,624,637,397,516,11701,1796,558,602,377,490,3823,0.188516846856303,0.894230769230769,0.945054945054945,0.949622166246851,0.949612403100775,0.326724211605846
E02003635,Wootton & Stewartby,Bedford,East of England,1883,4522,308,352,252,392,5826,2467,6150,370,346,275,371,7512,1191,336,332,270,355,2484,0.193658536585366,0.908108108108108,0.959537572254335,0.981818181818182,0.956873315363881,0.330670926517572
E02003599,Sandy North,Central Bedfordshire,East of England,1286,3777,283,233,151,199,4643,1245,3869,285,260,166,205,4785,529,241,236,153,195,1354,0.136727836650297,0.845614035087719,0.907692307692308,0.921686746987952,0.951219512195122,0.282967607105538
E02003600,Sandy South,Central Bedfordshire,East of England,1249,4144,393,406,233,268,5444,1178,4016,404,407,281,317,5425,563,352,383,266,294,1858,0.140189243027888,0.871287128712871,0.941031941031941,0.946619217081851,0.927444794952681,0.342488479262673
E02003601,Potton,Central Bedfordshire,East of England,1440,4680,523,468,279,355,6305,1450,5016,500,539,332,373,6760,731,454,515,318,358,2376,0.1457336523126,0.908,0.955473098330241,0.957831325301205,0.959785522788204,0.351479289940828
E02003602,"Blunham, Caldecote & Broom",Central Bedfordshire,East of England,987,3648,414,411,330,395,5198,1010,3879,416,444,350,394,5483,613,360,420,338,380,2111,0.158030420211395,0.865384615384615,0.945945945945946,0.965714285714286,0.964467005076142,0.385008207185847
E02003603,Biggleswade West,Central Bedfordshire,East of England,2040,7069,522,489,306,488,8874,2201,7270,531,540,366,461,9168,1070,461,511,340,435,2817,0.147180192572215,0.868173258003766,0.946296296296296,0.92896174863388,0.943600867678959,0.307264397905759
E02003604,Biggleswade East,Central Bedfordshire,East of England,2418,6776,423,423,301,418,8341,2383,6983,487,405,346,409,8630,991,441,387,330,393,2542,0.141916081913218,0.905544147843943,0.955555555555556,0.953757225433526,0.960880195599022,0.294553881807648
E02003605,Cranfield & Aspley Guise,Central Bedfordshire,East of England,1818,6052,404,499,353,362,7670,1968,7289,439,480,377,389,8974,846,393,466,364,367,2436,0.116065303882563,0.895216400911162,0.970833333333333,0.96551724137931,0.943444730077121,0.271450858034321
E02003606,Houghton Conquest & Clophill,Central Bedfordshire,East of England,1403,4834,501,550,347,489,6721,1508,5493,504,550,399,482,7428,856,454,520,387,469,2686,0.155834698707446,0.900793650793651,0.945454545454546,0.969924812030075,0.973029045643153,0.361604738826064
E02003607,"Marston Moretaine, Lidlington & Woburn",Central Bedfordshire,East of England,2223,6820,468,465,370,430,8553,2318,7172,512,530,372,447,9033,1122,451,504,361,423,2861,0.156441717791411,0.880859375,0.950943396226415,0.970430107526882,0.946308724832215,0.316727554522307
E02003608,Arlesey & Henlow,Central Bedfordshire,East of England,2320,7657,652,572,411,532,9824,2267,7786,689,612,425,532,10044,1484,612,574,405,517,3592,0.190598510146417,0.888243831640058,0.937908496732026,0.952941176470588,0.971804511278195,0.357626443647949
E02003609,Shefford & Shillington,Central Bedfordshire,East of England,2552,7325,521,458,344,422,9070,2432,8101,539,514,373,512,10039,1503,459,491,357,479,3289,0.185532650290088,0.851576994434137,0.955252918287938,0.957104557640751,0.935546875,0.327622273134774
E02003610,Ampthill & Millbrook,Central Bedfordshire,East of England,1719,5360,384,424,276,497,6941,1755,5835,394,432,327,507,7495,824,372,397,315,482,2390,0.141216795201371,0.944162436548223,0.918981481481481,0.963302752293578,0.95069033530572,0.318879252835224
E02003611,"Clifton, Meppershall & Stondon",Central Bedfordshire,East of England,1820,5928,524,476,350,495,7773,1858,5835,525,521,379,535,7795,1141,446,496,371,484,2938,0.1955441302485,0.84952380952381,0.952015355086372,0.978891820580475,0.904672897196262,0.376908274534958
E02003612,Stotfold,Central Bedfordshire,East of England,2883,7635,554,536,366,439,9530,2822,7725,596,556,433,454,9764,1478,521,519,417,436,3371,0.191326860841424,0.874161073825503,0.933453237410072,0.963048498845266,0.960352422907489,0.345247849242114
E02003613,Flitwick East,Central Bedfordshire,East of England,1061,3748,267,275,208,329,4827,993,3854,262,284,218,365,4983,504,239,267,207,335,1552,0.130773222625843,0.912213740458015,0.940140845070422,0.94954128440367,0.917808219178082,0.311458960465583
E02003614,Flitwick West,Central Bedfordshire,East of England,1424,5208,451,379,192,277,6507,1497,5486,470,395,259,250,6860,708,440,378,246,239,2011,0.129055778344878,0.936170212765957,0.956962025316456,0.94980694980695,0.956,0.293148688046647
E02003615,"Westoning, Harlington & Silsoe",Central Bedfordshire,East of England,2006,6048,556,595,366,481,8046,1987,6490,582,629,435,507,8643,1002,542,593,414,484,3035,0.154391371340524,0.93127147766323,0.942766295707472,0.951724137931035,0.954635108481262,0.351151220640981
E02003636,Barton-le-Clay & Upper Sundon,Central Bedfordshire,East of England,1367,4619,331,382,300,383,6015,1221,4754,355,381,317,391,6198,819,322,362,305,352,2160,0.172275978123685,0.907042253521127,0.9501312335958,0.962145110410095,0.900255754475703,0.348499515972895
E02003637,"Toddington, Heath & Reach",Central Bedfordshire,East of England,1805,6105,627,589,443,563,8327,2104,7102,611,611,468,580,9372,1211,517,581,451,554,3314,0.170515347789355,0.846153846153846,0.950900163666121,0.963675213675214,0.955172413793104,0.353606487409304
E02003638,Leighton Buzzard North & East,Central Bedfordshire,East of England,1507,4525,503,496,278,409,6211,1445,4769,488,544,353,426,6580,812,431,516,330,407,2496,0.17026630320822,0.883196721311476,0.948529411764706,0.934844192634561,0.955399061032864,0.379331306990881
E02003639,Leighton Buzzard Central,Central Bedfordshire,East of England,1900,6110,405,424,297,518,7754,1872,6461,433,441,320,529,8184,1138,345,404,298,510,2695,0.1761337254295,0.796766743648961,0.91609977324263,0.93125,0.964083175803403,0.329301075268817
E02003640,Linslade East,Central Bedfordshire,East of England,1057,3748,392,404,266,347,5157,1064,4016,361,428,269,374,5448,703,318,413,253,353,2040,0.175049800796813,0.880886426592798,0.964953271028037,0.940520446096654,0.943850267379679,0.374449339207049
E02003641,Linslade West,Central Bedfordshire,East of England,1012,3434,331,383,223,218,4589,1003,3486,309,384,254,204,4637,663,281,363,245,195,1747,0.190189328743546,0.909385113268608,0.9453125,0.964566929133858,0.955882352941176,0.376752210480914
E02003642,Houghton Regis North,Central Bedfordshire,East of England,2478,6273,370,272,151,206,7272,2340,6802,415,313,171,200,7901,969,319,271,148,177,1884,0.142458100558659,0.768674698795181,0.865814696485623,0.865497076023392,0.885,0.238450829008986
E02003643,Leighton Buzzard South East,Central Bedfordshire,East of England,3289,8597,438,403,283,376,10097,3346,8855,484,417,326,385,10467,1553,411,384,307,370,3025,0.175381140598532,0.849173553719008,0.920863309352518,0.941717791411043,0.961038961038961,0.28900353491927
E02003644,Houghton Regis South,Central Bedfordshire,East of England,2118,6277,445,336,265,406,7729,1997,6444,472,376,258,385,7935,974,370,345,238,347,2274,0.15114835505897,0.783898305084746,0.917553191489362,0.922480620155039,0.901298701298701,0.286578449905482
E02003645,Dunstable East,Central Bedfordshire,East of England,1259,4479,314,362,239,451,5845,1349,4656,327,319,266,477,6045,855,259,292,243,452,2101,0.183634020618557,0.792048929663609,0.915360501567398,0.913533834586466,0.947589098532495,0.347559966914806
E02003646,Dunstable West,Central Bedfordshire,East of England,2376,6423,468,445,308,393,8037,2424,7093,421,506,349,380,8749,1414,340,462,329,353,2898,0.199351473283519,0.807600950118765,0.91304347826087,0.94269340974212,0.928947368421053,0.331237855754943
E02003647,Dunstable Central,Central Bedfordshire,East of England,1975,6503,370,443,308,636,8260,1954,7052,408,464,317,561,8802,1243,324,427,292,508,2794,0.176262053318208,0.794117647058824,0.920258620689655,0.921135646687697,0.905525846702317,0.317427857305158
E02003648,Dunstable Manshead,Central Bedfordshire,East of England,1341,3479,242,196,166,313,4396,1264,3730,232,236,156,292,4646,698,187,209,149,272,1515,0.187131367292225,0.806034482758621,0.885593220338983,0.955128205128205,0.931506849315068,0.326086956521739
E02003649,Dunstable South,Central Bedfordshire,East of England,1061,4283,323,482,358,368,5814,1075,4326,327,435,369,405,5862,946,276,420,345,381,2368,0.218677762367083,0.844036697247707,0.96551724137931,0.934959349593496,0.940740740740741,0.403957693619925
E02003650,"Eaton Bray, Whipsnade & Holywell",Central Bedfordshire,East of England,1119,3910,529,578,330,488,5835,1040,4086,549,555,416,496,6102,838,487,535,399,472,2731,0.205090553108174,0.887067395264117,0.963963963963964,0.959134615384615,0.951612903225806,0.447558177646673
E02003651,Caddington & Slip End,Central Bedfordshire,East of England,1162,3926,448,498,343,353,5568,1255,4297,464,501,396,424,6082,886,404,474,369,401,2534,0.206190365371189,0.870689655172414,0.946107784431138,0.931818181818182,0.945754716981132,0.416639263400197
E02003719,Kings Hedges,Cambridge,East of England,1813,5157,354,264,210,463,6448,1918,8142,379,293,246,403,9463,1280,277,252,229,368,2406,0.157209530827806,0.730870712401055,0.860068259385666,0.930894308943089,0.913151364764268,0.254253408010145
E02003720,Arbury,Cambridge,East of England,1597,5556,390,344,233,421,6944,1735,8794,409,389,265,435,10292,1163,265,328,237,380,2373,0.132249260859677,0.647921760391198,0.84318766066838,0.89433962264151,0.873563218390805,0.23056743101438
E02003721,East Chesterton,Cambridge,East of England,1656,5799,335,312,208,504,7158,1720,8844,396,342,245,514,10341,1209,300,298,223,475,2505,0.136702849389417,0.757575757575758,0.871345029239766,0.910204081632653,0.924124513618677,0.242239628662605
E02003722,West Chesterton,Cambridge,East of England,1291,5184,390,380,270,397,6621,1268,7773,457,417,304,441,9392,1061,366,381,282,398,2488,0.136498134568378,0.800875273522976,0.913669064748201,0.927631578947368,0.90249433106576,0.264906303236797
E02003723,Eddington & Castle,Cambridge,East of England,882,8073,223,229,163,294,8982,1200,16537,327,252,197,301,17614,1089,219,210,165,263,1946,0.06585233113624,0.669724770642202,0.833333333333333,0.83756345177665,0.87375415282392,0.110480299761553
E02003724,East Barnwell & Abbey,Cambridge,East of England,1938,5917,358,270,165,307,7017,1944,8914,410,324,174,308,10130,1403,303,287,154,279,2426,0.157392865155934,0.739024390243903,0.885802469135803,0.885057471264368,0.905844155844156,0.239486673247779
E02003725,Central & West Cambridge,Cambridge,East of England,1390,12281,365,357,267,479,13749,1467,21752,415,422,325,472,23386,1251,302,360,275,422,2610,0.0575119529238691,0.727710843373494,0.853080568720379,0.846153846153846,0.894067796610169,0.111605233900624
E02003726,Petersfield,Cambridge,East of England,1092,6502,321,193,157,177,7350,1082,10628,342,278,171,186,11605,866,270,234,157,163,1690,0.0814828754234099,0.789473684210526,0.841726618705036,0.91812865497076,0.876344086021505,0.145626884963378
E02003727,Romsey,Cambridge,East of England,1412,6231,240,182,152,230,7035,1388,9259,288,209,161,230,10147,1308,208,175,143,204,2038,0.141267955502754,0.722222222222222,0.837320574162679,0.888198757763975,0.886956521739131,0.200847541145166
E02003728,Coleridge,Cambridge,East of England,1580,6121,362,277,201,377,7338,1548,8936,390,308,235,331,10200,1357,279,269,217,308,2430,0.151857654431513,0.715384615384615,0.873376623376623,0.923404255319149,0.930513595166163,0.238235294117647
E02003729,Cherry Hinton,Cambridge,East of England,1870,4702,381,394,271,422,6170,2057,7231,414,420,322,381,8768,1540,296,389,301,351,2877,0.21297192642788,0.714975845410628,0.926190476190476,0.934782608695652,0.921259842519685,0.328125
E02003730,Trumpington,Cambridge,East of England,3554,9211,353,387,312,468,10731,3794,14707,419,402,364,477,16369,2357,299,327,317,422,3722,0.160263819949684,0.713603818615752,0.813432835820896,0.870879120879121,0.884696016771489,0.227381025108437
E02003731,Addenbrooke's & Queen Edith's,Cambridge,East of England,1638,5987,394,352,247,562,7542,1668,9096,439,405,279,508,10727,1925,360,360,256,487,3388,0.211631486367634,0.82004555808656,0.888888888888889,0.917562724014337,0.958661417322835,0.315838538267922
E02003732,Littleport,East Cambridgeshire,East of England,2061,6099,471,426,317,514,7827,2017,6626,484,470,355,497,8432,1303,404,430,331,468,2936,0.196649562330214,0.834710743801653,0.914893617021277,0.932394366197183,0.941649899396378,0.34819734345351
E02003733,Little Downham & Sutton,East Cambridgeshire,East of England,1625,5052,517,562,363,409,6903,1497,5406,502,591,376,439,7314,1121,451,553,361,419,2905,0.207362190159082,0.898406374501992,0.935702199661591,0.960106382978723,0.954441913439636,0.397183483729833
E02003734,North Ely,East Cambridgeshire,East of England,2650,7335,631,634,417,676,9693,2369,7868,581,628,461,749,10287,1404,513,591,436,704,3648,0.178444331469243,0.882960413080895,0.941082802547771,0.945770065075922,0.939919893190921,0.354622338874307
E02003735,South Ely,East Cambridgeshire,East of England,1793,5682,443,502,355,528,7510,1581,5953,431,459,374,515,7732,998,369,427,364,484,2642,0.167646564757265,0.85614849187935,0.930283224400871,0.973262032085561,0.939805825242719,0.341696844283497
E02003736,"Haddenham, Stretham & Witchford",East Cambridgeshire,East of England,2002,5901,626,702,450,515,8194,1904,6446,652,679,497,534,8808,1312,597,652,489,514,3564,0.203537077257214,0.915644171779141,0.960235640648012,0.983903420523139,0.962546816479401,0.404632152588556
E02003737,Soham,East Cambridgeshire,East of England,2762,8912,679,590,423,606,11210,2745,11978,667,654,430,656,14385,1567,525,614,405,627,3738,0.130823175822341,0.787106446776612,0.938837920489297,0.941860465116279,0.955792682926829,0.25985401459854
E02003738,"Isleham, Fordham & Chippenham",East Cambridgeshire,East of England,1203,3757,329,414,249,328,5077,1155,4034,396,401,268,352,5451,836,326,380,258,336,2136,0.207238472979673,0.823232323232323,0.947630922693267,0.962686567164179,0.954545454545455,0.391854705558613
E02003739,Burwell,East Cambridgeshire,East of England,1241,3708,352,417,268,431,5176,1109,3996,386,385,295,445,5507,804,345,371,286,425,2231,0.201201201201201,0.893782383419689,0.963636363636364,0.969491525423729,0.955056179775281,0.405120755402215
E02003740,Swaffham & Bottisham,East Cambridgeshire,East of England,1196,3525,423,405,265,497,5115,1146,3826,409,400,317,476,5428,858,371,385,304,448,2366,0.224255096706743,0.907090464547677,0.9625,0.958990536277603,0.941176470588235,0.435887988209285
E02006825,Dullingham & Cheveley,East Cambridgeshire,East of England,1126,3870,440,448,320,398,5476,1006,4217,403,458,298,430,5806,931,373,437,287,410,2438,0.22077306141807,0.925558312655087,0.954148471615721,0.963087248322148,0.953488372093023,0.419910437478471
E02003742,"Leverington, Gorefield & Tydd St Giles",Fenland,East of England,1042,3632,554,562,402,472,5622,1065,4149,592,586,408,494,6229,736,451,560,386,466,2599,0.177392142684984,0.761824324324324,0.955631399317406,0.946078431372549,0.94331983805668,0.417241932894526
E02003743,Wisbech North,Fenland,East of England,2241,7193,480,531,336,595,9135,2406,8676,523,543,381,587,10710,850,318,488,353,536,2545,0.0979714153988013,0.608030592734226,0.898710865561694,0.926509186351706,0.913117546848382,0.237628384687208
E02003744,Wisbech South & Peckover,Fenland,East of England,2337,9062,793,741,525,897,12018,2549,10460,809,760,553,790,13372,1087,517,692,516,743,3555,0.103919694072658,0.639060568603214,0.910526315789474,0.933092224231465,0.940506329113924,0.265854023332336
E02003745,"Wisbech St Mary, Waldersea & Christchurch",Fenland,East of England,1888,5971,676,763,464,552,8426,1840,6617,745,729,529,576,9196,1178,562,670,500,534,3444,0.178026295904488,0.754362416107383,0.919067215363512,0.945179584120983,0.927083333333333,0.374510656807308
E02003746,March North,Fenland,East of England,1438,4699,420,422,322,455,6318,1384,5054,408,408,343,442,6655,1034,330,378,322,416,2480,0.204590423426989,0.808823529411765,0.926470588235294,0.938775510204082,0.941176470588235,0.372652141247183
E02003747,Whittlesey,Fenland,East of England,2237,6785,750,789,510,811,9645,2264,7871,775,801,601,843,10891,1554,657,756,572,812,4351,0.19743361707534,0.847741935483871,0.943820224719101,0.951747088186356,0.963226571767497,0.399504177761454
E02003748,March East,Fenland,East of England,1392,4428,524,547,373,555,6427,1377,4597,497,557,424,541,6616,1011,385,525,406,515,2842,0.219926038720905,0.774647887323944,0.942549371633752,0.957547169811321,0.951940850277264,0.42956469165659
E02003749,"Coates, Benwick & Pondersbridge",Fenland,East of England,1031,3640,392,409,244,308,4993,1073,3944,412,406,271,294,5327,837,337,379,261,277,2091,0.212221095334686,0.817961165048544,0.933497536945813,0.96309963099631,0.942176870748299,0.392528627745448
E02003750,March West,Fenland,East of England,1270,4044,494,543,419,711,6211,1205,4345,490,523,461,655,6474,1029,398,500,440,624,2991,0.236823935558113,0.812244897959184,0.956022944550669,0.954446854663775,0.952671755725191,0.462001853568119
E02003751,"Doddington, Wimblington & Manea",Fenland,East of England,1245,4032,492,482,330,446,5782,1285,4608,520,532,378,527,6565,1088,438,497,361,481,2865,0.236111111111111,0.842307692307692,0.93421052631579,0.955026455026455,0.912713472485768,0.436405178979436
E02003752,Chatteris,Fenland,East of England,2108,6689,655,593,440,667,9044,2045,7121,610,621,483,644,9479,1498,494,577,460,609,3638,0.210363712961663,0.809836065573771,0.92914653784219,0.952380952380952,0.945652173913043,0.383795759046313
E02003753,Yaxley & Farcet,Huntingdonshire,East of England,2248,6934,616,647,388,481,9066,2235,7778,625,672,401,529,10005,1300,475,627,383,498,3283,0.167138081769092,0.76,0.933035714285714,0.955112219451372,0.941398865784499,0.328135932033983
E02003754,"Stilton, Elton & Folksworth",Huntingdonshire,East of England,962,3365,419,384,220,333,4721,923,3763,413,421,274,312,5183,697,360,395,261,301,2014,0.185224554876428,0.871670702179177,0.938242280285036,0.952554744525547,0.96474358974359,0.38857804360409
E02003755,Ramsey,Huntingdonshire,East of England,1434,5010,476,487,331,408,6712,1523,5545,517,538,376,499,7475,1182,441,509,357,477,2966,0.213165013525699,0.852998065764023,0.946096654275093,0.949468085106383,0.955911823647295,0.396789297658863
E02003756,Sawtry & Gidding,Huntingdonshire,East of England,1225,4262,419,439,284,331,5735,1220,4680,420,436,332,378,6246,1210,383,410,318,354,2675,0.258547008547009,0.911904761904762,0.940366972477064,0.957831325301205,0.936507936507937,0.42827409542107
E02003757,Warboys & Bury,Huntingdonshire,East of England,1120,3871,392,406,279,470,5418,1181,4139,418,399,335,355,5646,845,348,383,321,332,2229,0.204155593138439,0.832535885167464,0.959899749373434,0.958208955223881,0.935211267605634,0.394792773645058
E02003758,"Somersham, Riptons & Raveleys",Huntingdonshire,East of England,1850,5812,608,531,362,443,7756,1785,6666,602,560,421,478,8727,966,510,526,405,457,2864,0.144914491449145,0.847176079734219,0.939285714285714,0.961995249406176,0.956066945606695,0.328176922195485
E02003759,"Bluntisham, Earith & Needingworth",Huntingdonshire,East of England,983,3563,391,429,269,273,4925,915,3724,450,437,291,330,5232,631,382,420,280,318,2031,0.169441460794844,0.848888888888889,0.961098398169336,0.962199312714777,0.963636363636364,0.388188073394495
E02003760,Huntingdon Sapley & Oxmoor,Huntingdonshire,East of England,2263,6070,270,237,177,260,7014,2291,7149,312,253,155,254,8123,1102,223,222,144,242,1933,0.154147433207442,0.71474358974359,0.877470355731225,0.929032258064516,0.952755905511811,0.237966268619968
E02003761,Huntingdon Hartford,Huntingdonshire,East of England,964,3530,349,415,265,432,4991,951,3885,362,439,327,458,5471,756,317,412,316,442,2243,0.194594594594595,0.875690607734807,0.938496583143508,0.966360856269113,0.965065502183406,0.409979893986474
E02003762,"Brampton, the Stukeleys and the Alconburys",Huntingdonshire,East of England,1921,5666,519,540,409,513,7647,2142,6597,528,572,459,559,8715,1654,483,537,442,535,3651,0.250720024253449,0.914772727272727,0.938811188811189,0.962962962962963,0.957066189624329,0.418932874354561
E02003763,St Ives North,Huntingdonshire,East of England,1737,6160,591,510,334,364,7959,1769,6733,565,577,367,379,8621,999,459,548,347,355,2708,0.148373681865439,0.812389380530973,0.949740034662045,0.94550408719346,0.936675461741425,0.314116691799095
E02003764,Huntingdon Central & West,Huntingdonshire,East of England,2014,7309,343,331,176,440,8599,1968,7873,388,337,252,439,9289,1495,318,303,232,421,2769,0.189889495744951,0.819587628865979,0.899109792284867,0.920634920634921,0.958997722095672,0.298094520400474
E02003765,St Ives South,Huntingdonshire,East of England,1212,4367,372,459,315,597,6110,1216,4811,406,464,377,565,6623,696,327,440,358,532,2353,0.144668468093951,0.805418719211823,0.948275862068965,0.949602122015915,0.941592920353982,0.355277064774271
E02003766,Godmanchester,Huntingdonshire,East of England,1465,4522,347,379,260,306,5814,1580,5056,346,385,261,334,6382,982,273,364,248,316,2183,0.194224683544304,0.789017341040462,0.945454545454546,0.950191570881226,0.946107784431138,0.342055781886556
E02003767,"Kimbolton, Great Staughton & Molesworth",Huntingdonshire,East of England,1127,3895,382,454,289,350,5370,1041,4289,418,426,327,374,5834,900,390,413,312,353,2368,0.209839123338774,0.933014354066986,0.969483568075117,0.954128440366972,0.943850267379679,0.405896468974974
E02003768,"Houghton, Hemingford & Fenstanton",Huntingdonshire,East of England,1695,5384,657,780,528,694,8043,1717,5968,649,758,603,734,8712,1078,575,724,582,709,3668,0.180630026809651,0.88597842835131,0.955145118733509,0.965174129353234,0.965940054495913,0.421028466483012
E02003769,Buckden & Perry,Huntingdonshire,East of England,1045,4557,500,554,420,440,6471,997,4446,479,528,459,434,6346,1003,415,505,443,410,2776,0.225596041385515,0.866388308977036,0.956439393939394,0.965141612200436,0.944700460829493,0.437440907658367
E02003770,"Little Paxton, Love's Farm & Great Gransden",Huntingdonshire,East of England,2347,6375,491,531,316,380,8093,2540,6994,523,557,372,398,8844,1245,457,519,352,376,2949,0.178009722619388,0.873804971319312,0.931777378815081,0.946236559139785,0.944723618090452,0.333446404341927
E02003771,St Neots Priory Park,Huntingdonshire,East of England,1070,4029,319,362,266,446,5422,1015,4435,308,365,264,443,5815,821,209,326,249,409,2014,0.185118376550169,0.678571428571429,0.893150684931507,0.943181818181818,0.923250564334086,0.346345657781599
E02003772,St Neots Eaton Ford,Huntingdonshire,East of England,1079,3976,457,518,319,400,5670,1049,4188,464,502,382,421,5957,740,377,479,361,401,2358,0.176695319961796,0.8125,0.954183266932271,0.945026178010471,0.95249406175772,0.395836830619439
E02003773,St Neots Eynesbury,Huntingdonshire,East of England,2075,7013,465,516,332,442,8768,1965,7368,474,516,383,459,9200,1394,362,477,356,430,3019,0.189196525515744,0.763713080168776,0.924418604651163,0.929503916449086,0.93681917211329,0.328152173913044
E02003774,St Neots Eaton Socon,Huntingdonshire,East of England,1011,3505,307,354,262,384,4812,992,3677,326,363,290,396,5052,699,237,338,267,358,1899,0.190100625509927,0.726993865030675,0.931129476584022,0.920689655172414,0.904040404040404,0.375890736342043
E02003775,Willingham & Over,South Cambridgeshire,East of England,1354,4180,372,410,257,313,5532,1436,4810,409,454,309,362,6344,1107,376,435,298,347,2563,0.23014553014553,0.919315403422983,0.958149779735683,0.964401294498382,0.958563535911602,0.404003783102144
E02003776,Cottenham,South Cambridgeshire,East of England,1216,3869,387,383,276,462,5377,1325,4484,402,427,298,454,6065,1013,364,406,274,415,2472,0.225914362176628,0.90547263681592,0.950819672131147,0.919463087248322,0.914096916299559,0.407584501236603
E02003777,"Longstanton, Swavesey & Oakington",South Cambridgeshire,East of England,1957,5028,393,371,250,306,6348,2155,6150,404,384,301,350,7589,1285,353,363,287,337,2625,0.208943089430894,0.873762376237624,0.9453125,0.953488372093023,0.962857142857143,0.345895374884702
E02003778,Waterbeach and Landbeach,South Cambridgeshire,East of England,1254,3973,284,307,205,325,5094,1252,4225,316,324,231,332,5428,936,280,296,224,308,2044,0.221538461538462,0.886075949367089,0.91358024691358,0.96969696969697,0.927710843373494,0.37656595431098
E02003779,Bar Hill & Boxworth,South Cambridgeshire,East of England,865,3123,345,303,188,203,4162,867,3278,345,316,226,231,4396,643,314,300,212,209,1678,0.196156192800488,0.910144927536232,0.949367088607595,0.938053097345133,0.904761904761905,0.381710646041856
E02003780,"HIston, Impington & Orchard Park",South Cambridgeshire,East of England,2316,7744,502,502,316,711,9775,2332,8347,525,550,361,699,10482,1528,466,508,337,635,3474,0.18305978195759,0.887619047619048,0.923636363636364,0.933518005540166,0.908440629470672,0.331425300515169
E02003781,"Milton, Fen Ditton & Quy",South Cambridgeshire,East of England,1127,4203,344,285,175,303,5310,1118,4702,353,289,245,310,5899,887,302,276,234,295,1994,0.188643130582731,0.855524079320113,0.955017301038062,0.955102040816327,0.951612903225806,0.338023393795559
E02003783,Girton & Barton,South Cambridgeshire,East of England,1271,4583,399,425,313,599,6319,1315,5262,426,414,333,642,7077,895,336,382,315,602,2530,0.170087419232231,0.788732394366197,0.922705314009662,0.945945945945946,0.937694704049844,0.357496114172672
E02003784,Hardwick & Highfields,South Cambridgeshire,East of England,1691,5124,460,560,325,454,6923,1611,5772,486,532,391,512,7693,1105,440,515,376,475,2911,0.191441441441441,0.905349794238683,0.968045112781955,0.961636828644501,0.927734375,0.378395944365007
E02003785,Fulbourn & Teversham,South Cambridgeshire,East of England,1751,5663,416,441,341,561,7422,1708,6110,454,409,353,508,7834,1376,374,390,342,498,2980,0.225204582651391,0.823788546255507,0.953545232273839,0.968838526912181,0.980314960629921,0.380393158029104
E02003786,Great Shelford & Stapleford,South Cambridgeshire,East of England,1264,3700,368,367,312,577,5324,1205,4178,386,402,333,566,5865,1198,310,371,318,543,2740,0.286740067017712,0.803108808290156,0.922885572139304,0.954954954954955,0.959363957597173,0.467178175618073
E02003787,"Barrington, Orwell & Gamlingay",South Cambridgeshire,East of England,1323,4123,499,561,326,466,5975,1322,4574,540,559,392,543,6608,797,474,526,379,517,2693,0.174245736773065,0.877777777777778,0.940966010733453,0.966836734693878,0.952117863720074,0.407536319612591
E02003788,"Little Shelford , Foxton & Haslingfield",South Cambridgeshire,East of England,1547,4308,372,440,368,429,5917,1689,5088,354,431,402,464,6739,1180,295,399,383,434,2691,0.231918238993711,0.833333333333333,0.925754060324826,0.95273631840796,0.935344827586207,0.399317406143345
E02003789,Sawston,South Cambridgeshire,East of England,1344,4155,455,453,341,485,5889,1436,4855,426,468,332,486,6567,1488,305,442,316,456,3007,0.30648815653965,0.715962441314554,0.944444444444444,0.951807228915663,0.938271604938272,0.457895538297548
E02003790,Linton & Balsham,South Cambridgeshire,East of England,1716,5373,647,634,388,661,7703,1631,6058,626,673,442,695,8494,1656,527,631,428,666,3908,0.27335754374381,0.84185303514377,0.937592867756315,0.968325791855204,0.958273381294964,0.460089474923475
E02003791,"Duxford, Whittlesford & the Abingtons",South Cambridgeshire,East of England,1547,4847,435,474,324,397,6477,1612,5387,506,474,389,461,7217,1351,389,444,368,447,2999,0.250788936328198,0.768774703557312,0.936708860759494,0.946015424164525,0.969631236442516,0.415546626021893
E02003792,"Meldreth, Melbourn & Great Chishill",South Cambridgeshire,East of England,1885,5542,573,655,446,563,7779,1904,6407,579,647,494,630,8757,1437,464,624,475,595,3595,0.224285937256126,0.801381692573403,0.964451313755796,0.961538461538461,0.944444444444444,0.410528719881238
E02003793,Bassingbourn & the Mordens,South Cambridgeshire,East of England,1302,4255,368,471,289,314,5697,1377,4591,375,457,323,346,6092,979,332,437,311,325,2384,0.213243302112829,0.885333333333333,0.956236323851203,0.962848297213622,0.939306358381503,0.391332895600788
E02006873,Cambourne,South Cambridgeshire,East of England,2927,6060,108,135,82,157,6542,2977,6750,115,125,104,158,7252,1057,84,118,97,142,1498,0.156592592592593,0.730434782608696,0.944,0.932692307692308,0.89873417721519,0.206563706563707
E02006874,"Papworth, Caxton & Fen Drayton",South Cambridgeshire,East of England,2380,6012,457,403,262,350,7484,2428,7140,458,428,302,373,8701,1480,410,397,287,351,2925,0.207282913165266,0.895196506550218,0.927570093457944,0.950331125827815,0.941018766756032,0.336168256522239
E02004424,Billericay North East,Basildon,East of England,1362,4206,423,465,306,343,5743,1418,4568,403,466,331,398,6166,755,319,446,321,386,2227,0.165280210157618,0.791563275434243,0.957081545064378,0.969788519637462,0.969849246231156,0.36117418099254
E02004425,Billericay Queen's Park,Basildon,East of England,1433,4549,347,374,225,444,5939,1426,4828,363,393,248,438,6270,842,282,376,239,419,2158,0.174399337199669,0.776859504132231,0.956743002544529,0.963709677419355,0.95662100456621,0.344178628389155
E02004426,Billericay Central & Sunnymede,Basildon,East of England,1516,4918,349,431,293,578,6569,1552,5330,371,427,340,576,7044,860,284,404,327,543,2418,0.161350844277674,0.765498652291105,0.946135831381733,0.961764705882353,0.942708333333333,0.343270868824532
E02004427,Billericay Tye Common,Basildon,East of England,1467,4411,428,542,422,643,6446,1477,4894,402,540,442,690,6968,912,317,505,428,663,2825,0.186350633428688,0.788557213930348,0.935185185185185,0.968325791855204,0.960869565217391,0.405424799081516
E02004428,Wickford North East,Basildon,East of England,1311,4079,325,384,285,561,5634,1293,4354,335,398,304,562,5953,758,283,370,290,532,2233,0.174092788240698,0.844776119402985,0.92964824120603,0.953947368421053,0.946619217081851,0.375104989081136
E02004429,Wickford West,Basildon,East of England,1146,4141,461,599,420,615,6236,1206,4633,460,606,431,632,6762,682,412,573,409,603,2679,0.147204834880207,0.895652173913044,0.945544554455445,0.948955916473318,0.954113924050633,0.396184560780834
E02004430,Wickford Shotgate,Basildon,East of England,1613,5141,424,434,271,361,6631,1653,5440,438,444,339,367,7028,1028,388,417,322,351,2506,0.188970588235294,0.885844748858447,0.939189189189189,0.949852507374631,0.956403269754768,0.356573705179283
E02004431,Wickford South,Basildon,East of England,2044,6402,405,422,256,302,7787,2135,6648,390,438,295,299,8070,1093,336,392,272,277,2370,0.164410348977136,0.861538461538462,0.894977168949772,0.922033898305085,0.926421404682274,0.29368029739777
E02004432,Bursteads,Basildon,East of England,1327,4144,398,434,300,382,5658,1356,4507,440,417,329,382,6075,728,346,384,310,356,2124,0.161526514311072,0.786363636363636,0.920863309352518,0.942249240121581,0.931937172774869,0.34962962962963
E02004433,Steeple View & Noak Bridge,Basildon,East of England,1865,5657,394,448,242,412,7153,1740,5767,417,433,288,395,7300,930,346,399,269,360,2304,0.161262354777181,0.829736211031175,0.921478060046189,0.934027777777778,0.911392405063291,0.315616438356164
E02004434,Felmore & Bowers Gifford,Basildon,East of England,1819,5553,441,389,253,309,6945,1779,5855,460,426,274,294,7309,982,390,386,239,249,2246,0.167719897523484,0.847826086956522,0.906103286384976,0.872262773722628,0.846938775510204,0.307292379258449
E02004435,Whitmore Way & Fremnells,Basildon,East of England,2243,5839,361,311,215,370,7096,2388,6516,373,324,217,337,7767,1066,277,290,200,303,2136,0.163597298956415,0.742627345844504,0.895061728395062,0.921658986175115,0.899109792284867,0.27500965623793
E02004436,Chalvedon,Basildon,East of England,2039,5017,409,332,204,246,6208,2133,5577,421,395,224,229,6846,886,347,352,204,198,1987,0.15886677425139,0.824228028503563,0.891139240506329,0.910714285714286,0.864628820960699,0.290242477359042
E02004437,Laindon West & Southfields,Basildon,East of England,1939,5781,449,474,295,398,7397,2124,6300,458,510,306,429,8003,960,375,470,291,391,2487,0.152380952380952,0.818777292576419,0.92156862745098,0.950980392156863,0.911421911421911,0.310758465575409
E02004438,Basildon Central & Pipps Hill,Basildon,East of England,2226,6021,336,320,208,635,7520,2382,6523,354,345,217,494,7933,922,259,304,202,458,2145,0.141346006438755,0.731638418079096,0.881159420289855,0.930875576036866,0.927125506072874,0.270389512164377
E02004439,Laindon Central,Basildon,East of England,2795,6385,284,261,168,230,7328,2657,6720,290,269,165,223,7667,946,212,230,155,209,1752,0.14077380952381,0.731034482758621,0.855018587360595,0.939393939393939,0.937219730941704,0.228511803834616
E02004440,Laindon East & Lee Chapel North,Basildon,East of England,1935,5301,311,262,255,411,6540,2176,6504,315,289,235,426,7769,1053,242,262,217,397,2171,0.16190036900369,0.768253968253968,0.906574394463668,0.923404255319149,0.931924882629108,0.279443943879521
E02004441,Eversley,Basildon,East of England,1583,4695,438,432,276,314,6155,1699,5301,442,469,317,324,6853,965,381,424,291,294,2355,0.182041124316167,0.861990950226245,0.904051172707889,0.917981072555205,0.907407407407407,0.343645118926018
E02004442,Barstable,Basildon,East of England,2362,5343,315,282,193,242,6375,2307,5904,357,302,192,275,7030,782,255,263,176,233,1709,0.132452574525745,0.714285714285714,0.870860927152318,0.916666666666667,0.847272727272727,0.243100995732575
E02004443,Lee Chapel South & Kingswood,Basildon,East of England,1992,6446,398,374,265,494,7977,2084,7253,420,397,262,463,8795,1290,333,359,244,432,2658,0.177857438301393,0.792857142857143,0.904282115869018,0.931297709923664,0.93304535637149,0.302217168845935
E02004444,Langdon Hills,Basildon,East of England,1726,5902,485,446,304,361,7498,1740,6213,485,469,300,388,7855,958,409,429,285,366,2447,0.1541928215033,0.843298969072165,0.914712153518124,0.95,0.943298969072165,0.311521323997454
E02004445,Vange & Pitsea,Basildon,East of England,1801,5484,357,393,253,333,6820,1803,5692,364,390,284,305,7035,813,291,350,255,278,1987,0.142832044975404,0.79945054945055,0.897435897435897,0.897887323943662,0.911475409836066,0.282444918265814
E02004446,Steeple Bumpstead & Great Yeldham,Braintree,East of England,1169,4139,454,463,284,358,5698,1075,4308,471,505,320,372,5976,801,403,474,294,343,2315,0.185933147632312,0.855626326963907,0.938613861386139,0.91875,0.922043010752688,0.387382864792503
E02004447,"Bures Hamlet, Maplestead & Belchamp",Braintree,East of England,823,3477,465,500,302,348,5092,797,3527,460,497,371,368,5223,807,411,471,353,346,2388,0.228806351006521,0.893478260869565,0.947686116700201,0.951482479784367,0.940217391304348,0.457208500861574
E02004448,"Hedingham, Gosfield & Greenstead Green",Braintree,East of England,1336,4223,449,465,340,378,5855,1349,4613,460,458,359,470,6360,757,389,436,342,441,2365,0.164101452417082,0.845652173913044,0.951965065502183,0.952646239554318,0.938297872340426,0.37185534591195
E02004449,Halstead Central & West,Braintree,East of England,1747,5138,446,458,327,454,6823,1694,5428,447,449,363,405,7092,1091,335,417,345,382,2570,0.20099484156227,0.749440715883669,0.928730512249443,0.950413223140496,0.94320987654321,0.362380146644106
E02004450,"Panfield, Finchingfield & Bardfield",Braintree,East of England,982,3776,436,482,303,375,5372,971,4004,431,495,326,400,5656,662,375,466,317,380,2200,0.165334665334665,0.870069605568446,0.941414141414141,0.97239263803681,0.95,0.388967468175389
E02004451,Halstead East & Colnes,Braintree,East of England,1610,5028,561,564,459,632,7244,1575,5556,599,626,476,621,7878,1127,528,597,453,595,3300,0.2028437724982,0.881469115191987,0.953674121405751,0.951680672268908,0.958132045088567,0.418888042650419
E02004452,Bocking Churchstreet & Blackwater,Braintree,East of England,1667,5403,553,638,369,651,7614,1671,5581,515,633,427,633,7789,980,432,593,392,584,2981,0.175595771367139,0.838834951456311,0.936808846761453,0.918032786885246,0.92259083728278,0.382719219411991
E02004453,Bocking,Braintree,East of England,1630,4354,340,337,281,348,5660,1550,4653,330,325,275,345,5928,760,263,286,259,319,1887,0.163335482484419,0.796969696969697,0.88,0.941818181818182,0.92463768115942,0.31831983805668
E02004454,Central Braintree,Braintree,East of England,1683,6112,435,460,266,511,7784,1660,6136,442,465,325,466,7834,907,352,420,308,431,2418,0.147816166883963,0.796380090497738,0.903225806451613,0.947692307692308,0.924892703862661,0.308654582588716
E02004455,Braintree West & Rayne,Braintree,East of England,1514,4825,413,517,286,317,6358,1444,4995,412,491,338,326,6562,814,361,467,320,306,2268,0.162962962962963,0.87621359223301,0.95112016293279,0.946745562130177,0.938650306748466,0.345626333434928
E02004456,Braintree South,Braintree,East of England,2176,6303,435,424,261,385,7808,1971,6336,494,427,300,368,7925,964,403,384,287,336,2374,0.152146464646465,0.81578947368421,0.899297423887588,0.956666666666667,0.91304347826087,0.299558359621451
E02004457,Silver End & Stisted,Braintree,East of England,2139,6383,482,517,324,502,8208,2178,6791,484,518,344,484,8621,1111,395,478,318,455,2757,0.163598880871742,0.816115702479339,0.922779922779923,0.924418604651163,0.940082644628099,0.319800487182461
E02004458,Great Notley & Black Notley,Braintree,East of England,2043,5856,495,498,324,464,7637,2005,6325,437,500,355,511,8128,983,382,464,340,473,2642,0.155415019762846,0.874141876430206,0.928,0.957746478873239,0.925636007827789,0.325049212598425
E02004459,Coggeshall & Kelvedon,Braintree,East of England,1937,6194,664,686,475,670,8689,1788,6290,648,747,482,682,8849,1367,594,703,459,644,3767,0.217329093799682,0.916666666666667,0.941097724230254,0.952282157676349,0.944281524926686,0.425697818962595
E02004460,North Witham,Braintree,East of England,1866,5587,501,538,342,343,7311,1869,5935,506,573,421,406,7841,815,458,536,401,388,2598,0.13732097725358,0.905138339920949,0.93542757417103,0.95249406175772,0.955665024630542,0.331335288866216
E02004461,West Witham,Braintree,East of England,1389,3697,250,254,153,152,4506,1333,3843,246,290,150,142,4671,533,204,264,139,130,1270,0.138693728857663,0.829268292682927,0.910344827586207,0.926666666666667,0.915492957746479,0.271890387497324
E02004462,Witham Town,Braintree,East of England,2122,7054,527,548,376,606,9111,2122,7102,561,554,396,620,9233,940,503,502,372,581,2898,0.132357082511968,0.896613190730838,0.906137184115524,0.939393939393939,0.937096774193548,0.313874147081122
E02004463,"Witham South, Hatfield Peverel & White Notley",Braintree,East of England,1455,4668,519,485,330,544,6546,1480,5091,528,500,389,521,7029,969,481,472,366,491,2779,0.190335886859163,0.910984848484848,0.944,0.940874035989717,0.942418426103647,0.395362071418409
E02004464,Kelvedon Hatch & Doddinghurst,Brentwood,East of England,1744,5812,642,696,486,735,8371,1731,6412,644,698,567,748,9069,853,515,657,544,718,3287,0.133031815346226,0.799689440993789,0.941260744985673,0.959435626102293,0.959893048128342,0.362443488808027
E02004465,Ingatestone & Mountnessing,Brentwood,East of England,1021,3640,351,400,295,553,5239,1016,4041,333,395,305,532,5606,537,245,371,292,508,1953,0.132887899034892,0.735735735735736,0.939240506329114,0.957377049180328,0.954887218045113,0.348376739207991
E02004466,Hutton,Brentwood,East of England,1657,5064,351,356,264,530,6565,1680,5436,428,376,291,507,7038,788,356,356,274,481,2255,0.144959529065489,0.831775700934579,0.946808510638298,0.941580756013746,0.948717948717949,0.320403523728332
E02004467,Brentwood North,Brentwood,East of England,1894,5003,409,416,256,367,6451,1794,5353,391,423,275,388,6830,827,257,384,261,362,2091,0.154492807771343,0.657289002557545,0.907801418439716,0.949090909090909,0.93298969072165,0.30614934114202
E02004468,Shenfield & Hutton Mount,Brentwood,East of England,1946,6113,493,605,456,898,8565,1991,6652,548,566,515,874,9155,877,481,538,490,839,3225,0.131840048105833,0.877737226277372,0.950530035335689,0.951456310679612,0.959954233409611,0.352266521026761
E02004469,Brook Street & Pilgrim's Hatch,Brentwood,East of England,1377,4114,385,441,252,436,5628,1424,4623,396,410,284,397,6110,721,281,383,275,380,2040,0.155959333765953,0.70959595959596,0.934146341463415,0.96830985915493,0.957178841309824,0.333878887070376
E02004470,Brentwood Central,Brentwood,East of England,2161,8007,386,451,299,597,9740,2145,8355,420,433,318,623,10149,951,266,386,291,586,2480,0.113824057450628,0.633333333333333,0.891454965357968,0.915094339622642,0.940609951845907,0.244359050152724
E02004471,Brentwood South & Warley,Brentwood,East of England,1638,5337,397,369,268,514,6885,1700,5826,429,400,273,480,7408,883,303,360,257,449,2252,0.151561963611397,0.706293706293706,0.9,0.941391941391941,0.935416666666667,0.303995680345572
E02004472,"Herongate, Ingrave & West Horndon",Brentwood,East of England,993,3815,344,373,197,417,5146,1019,4082,345,377,200,424,5428,592,282,356,188,399,1817,0.145026947574718,0.817391304347826,0.944297082228117,0.94,0.941037735849057,0.334745762711864
E02004473,Benfleet North,Castle Point,East of England,1480,4594,408,551,390,498,6441,1481,4873,404,492,399,532,6700,735,343,457,368,504,2407,0.150831110199056,0.849009900990099,0.928861788617886,0.922305764411028,0.947368421052632,0.359253731343284
E02004474,New Thundersley,Castle Point,East of England,1296,4345,502,586,399,619,6451,1317,4818,458,550,445,602,6873,871,396,515,420,567,2769,0.180780406807804,0.864628820960699,0.936363636363636,0.943820224719101,0.941860465116279,0.402880838061982
E02004475,Benfleet Appleton,Castle Point,East of England,1177,4012,411,464,328,394,5609,1176,4246,415,463,384,440,5948,643,344,432,362,419,2200,0.151436646255299,0.828915662650602,0.93304535637149,0.942708333333333,0.952272727272727,0.369872225958305
E02004476,Thundersley Glen,Castle Point,East of England,1357,4775,463,597,411,510,6756,1305,4993,410,582,451,562,6998,796,343,538,422,532,2631,0.159423192469457,0.836585365853659,0.924398625429553,0.93569844789357,0.946619217081851,0.375964561303229
E02004477,Hadleigh North,Castle Point,East of England,852,3239,463,501,396,598,5197,848,3340,420,498,381,569,5208,648,375,472,373,536,2404,0.194011976047904,0.892857142857143,0.947791164658635,0.979002624671916,0.942003514938489,0.461597542242704
E02004478,Hadleigh South,Castle Point,East of England,1080,3837,373,428,301,522,5461,1092,4174,352,421,315,587,5849,697,310,384,296,558,2245,0.166986104456157,0.880681818181818,0.912114014251781,0.93968253968254,0.950596252129472,0.383826295093178
E02004479,South Benfleet,Castle Point,East of England,1405,4954,457,559,393,602,6965,1338,5117,449,568,422,583,7139,776,358,521,396,544,2595,0.151651358217706,0.797327394209354,0.917253521126761,0.938388625592417,0.933104631217839,0.363496287995518
E02004480,Canvey Island Winter Gardens,Castle Point,East of England,1499,4337,462,443,223,220,5685,1494,4605,403,457,288,228,5981,718,334,418,266,193,1929,0.155917480998914,0.8287841191067,0.914660831509847,0.923611111111111,0.846491228070175,0.322521317505434
E02004481,Canvey Island Newlands,Castle Point,East of England,1005,3365,538,749,530,645,5827,927,3522,493,713,591,718,6037,656,390,667,551,668,2932,0.1862578080636,0.791075050709939,0.935483870967742,0.932318104906937,0.930362116991643,0.48567169123737
E02004482,Canvey Island North West,Castle Point,East of England,1867,5148,439,451,276,370,6684,1909,5857,449,456,306,396,7464,977,339,406,266,303,2291,0.166808946559672,0.755011135857461,0.890350877192983,0.869281045751634,0.765151515151515,0.306939978563773
E02004483,Canvey Island South West,Castle Point,East of England,1234,4797,640,654,473,546,7110,1240,4793,622,711,524,590,7240,909,502,658,486,529,3084,0.189651575213854,0.807073954983923,0.925457102672292,0.927480916030534,0.896610169491525,0.425966850828729
E02004484,Canvey Island Leigh Beck,Castle Point,East of England,1212,4585,585,649,427,480,6726,1378,5366,597,684,467,542,7656,921,464,625,430,480,2920,0.17163622810287,0.777219430485762,0.91374269005848,0.920770877944326,0.885608856088561,0.381400208986416
E02004485,Great Leighs & the Walthams,Chelmsford,East of England,1888,4968,427,479,253,390,6517,2129,6002,422,502,349,380,7655,1014,334,474,330,362,2514,0.168943685438187,0.791469194312796,0.944223107569721,0.945558739255014,0.952631578947368,0.328412802090137
E02004486,South Broomfield,Chelmsford,East of England,1683,5112,433,539,373,578,7035,1632,5552,452,523,399,601,7527,1180,363,499,387,570,2999,0.212536023054755,0.803097345132743,0.954110898661568,0.969924812030075,0.948419301164726,0.398432310349409
E02004487,"Melbourne Park, Chignall & Pleshey",Chelmsford,East of England,1698,4470,431,386,264,375,5926,1694,4890,422,427,304,376,6419,772,334,402,289,365,2162,0.157873210633947,0.791469194312796,0.941451990632319,0.950657894736842,0.970744680851064,0.336812587630472
E02004488,Springfield North,Chelmsford,East of England,1852,5565,487,482,269,480,7283,1984,6197,542,518,319,454,8030,1264,459,492,305,436,2956,0.203969662740036,0.846863468634686,0.94980694980695,0.956112852664577,0.960352422907489,0.368119551681196
E02004489,Boreham & Little Baddow,Chelmsford,East of England,2092,5719,406,429,287,336,7177,2033,6296,419,477,316,390,7898,1197,376,455,293,365,2686,0.190120711562897,0.897374701670644,0.953878406708595,0.927215189873418,0.935897435897436,0.340086097746265
E02004490,Melbourne,Chelmsford,East of England,1904,5182,306,339,220,324,6371,1768,5569,338,323,235,334,6799,1004,232,295,217,309,2057,0.180283713413539,0.686390532544379,0.913312693498452,0.923404255319149,0.925149700598802,0.302544491837035
E02004491,Springfield South & Coronation Park,Chelmsford,East of England,1532,4857,346,395,232,417,6247,1487,5006,376,372,265,391,6410,1007,331,336,253,374,2301,0.201158609668398,0.88031914893617,0.903225806451613,0.954716981132075,0.956521739130435,0.358970358814353
E02004492,Chelmer Village,Chelmsford,East of England,1900,6396,323,318,192,286,7515,1845,6695,403,372,230,280,7980,955,332,334,212,263,2096,0.142643764002987,0.823821339950372,0.897849462365591,0.921739130434783,0.939285714285714,0.26265664160401
E02004493,Waterhouse Lane & Admirals Park,Chelmsford,East of England,2046,7080,359,331,255,455,8480,2068,7690,410,375,263,443,9181,1099,334,339,247,416,2435,0.142912873862159,0.814634146341463,0.904,0.939163498098859,0.939051918735892,0.265221653414661
E02004494,Central Chelmsford,Chelmsford,East of England,1801,9479,340,327,243,555,10944,1936,10651,339,361,267,555,12173,1206,246,322,249,511,2534,0.11322880480706,0.725663716814159,0.89196675900277,0.932584269662921,0.920720720720721,0.208165612420932
E02004495,Writtle & Highwood,Chelmsford,East of England,1354,4901,500,570,435,752,7158,1342,5106,470,550,482,755,7363,789,372,532,473,733,2899,0.154524089306698,0.791489361702128,0.967272727272727,0.981327800829875,0.970860927152318,0.393725383675132
E02004496,Moulsham West,Chelmsford,East of England,1763,4863,305,369,293,489,6319,1751,5286,306,363,296,560,6811,743,254,347,286,546,2176,0.140559969731366,0.830065359477124,0.955922865013774,0.966216216216216,0.975,0.319483188959037
E02004497,Great Baddow North & East,Chelmsford,East of England,1298,4438,422,545,437,670,6512,1268,4744,413,533,475,738,6903,738,350,498,466,720,2772,0.155564924114671,0.847457627118644,0.934333958724203,0.981052631578947,0.975609756097561,0.401564537157758
E02004498,Great Baddow South & West,Chelmsford,East of England,1976,6164,463,550,341,515,8033,1973,6585,436,542,375,522,8460,983,339,494,354,498,2668,0.149278663629461,0.777522935779817,0.911439114391144,0.944,0.954022988505747,0.315366430260047
E02004499,Moulsham East,Chelmsford,East of England,1272,4155,358,397,283,343,5536,1292,4429,335,401,292,354,5811,794,302,390,281,339,2106,0.179272973583202,0.901492537313433,0.972568578553616,0.962328767123288,0.957627118644068,0.36241610738255
E02004500,Danbury & Bicknacre,Chelmsford,East of England,1647,5217,569,664,437,615,7502,1627,5681,580,646,531,674,8112,1158,539,630,519,639,3485,0.203837352578771,0.929310344827586,0.975232198142415,0.977401129943503,0.948071216617211,0.429610453648915
E02004501,Galleywood,Chelmsford,East of England,1324,4016,443,496,345,464,5764,1270,4168,446,503,367,481,5965,683,388,483,357,456,2367,0.163867562380038,0.869955156950673,0.960238568588469,0.97275204359673,0.948024948024948,0.396814752724225
E02004502,"Margaretting, Stock & Ramsden",Chelmsford,East of England,1156,4159,427,496,362,491,5935,1060,4627,531,472,411,566,6607,672,451,443,395,542,2503,0.145234493192133,0.849340866290019,0.938559322033898,0.961070559610706,0.957597173144876,0.37884062358105
E02004503,South Woodham Ferrers North,Chelmsford,East of England,1594,4698,502,549,272,367,6388,1561,5145,499,572,337,369,6922,708,450,546,331,352,2387,0.137609329446064,0.901803607214429,0.954545454545455,0.98219584569733,0.953929539295393,0.344842531060387
E02004504,South Woodham Ferrers South,Chelmsford,East of England,1425,5148,515,445,175,288,6571,1426,5456,575,493,253,284,7061,753,499,460,239,271,2222,0.138013196480938,0.867826086956522,0.933062880324544,0.944664031620553,0.954225352112676,0.314686305055941
E02004505,Rettendon & Runwell,Chelmsford,East of England,925,3367,405,485,310,478,5045,1048,3616,367,533,368,499,5383,642,328,508,355,474,2307,0.177544247787611,0.893732970027248,0.953095684803002,0.964673913043478,0.949899799599198,0.428571428571429
E02004506,"Horkesley Heath, Langham & Dedham",Colchester,East of England,1239,4216,457,523,294,420,5910,1273,4439,464,494,338,458,6193,1048,417,469,318,446,2698,0.23608920928137,0.898706896551724,0.949392712550607,0.940828402366864,0.973799126637555,0.435653156789924
E02004507,Highwoods,Colchester,East of England,2283,6572,335,316,175,252,7650,2104,7012,352,363,228,274,8229,1746,303,321,206,239,2815,0.249001711351968,0.860795454545455,0.884297520661157,0.903508771929825,0.872262773722628,0.342082877627901
E02004508,West Bergholt & Wormingford,Colchester,East of England,1131,3777,420,465,330,388,5380,1144,4046,395,477,357,419,5694,884,364,453,337,400,2438,0.218487394957983,0.921518987341772,0.949685534591195,0.943977591036415,0.954653937947494,0.428170003512469
E02004509,Mile End & Braiswick,Colchester,East of England,3438,10104,390,370,255,328,11447,3757,10993,410,448,272,371,12494,2937,364,410,253,344,4308,0.267170017283726,0.887804878048781,0.915178571428571,0.930147058823529,0.92722371967655,0.344805506643189
E02004512,Central Colchester,Colchester,East of England,2030,7785,424,447,330,594,9580,1978,8279,427,474,361,650,10191,1608,337,418,335,601,3299,0.194226355840077,0.789227166276347,0.881856540084388,0.92797783933518,0.924615384615385,0.323717005200667
E02004513,Greenstead,Colchester,East of England,2152,10200,355,343,271,269,11438,1960,10805,338,368,252,287,12050,1246,275,330,230,267,2348,0.115316982878297,0.813609467455621,0.896739130434783,0.912698412698413,0.930313588850174,0.194854771784232
E02004514,Lexden,Colchester,East of England,1121,3283,264,341,237,422,4547,1113,3789,294,353,260,447,5143,937,257,329,233,424,2180,0.247294800738981,0.874149659863946,0.932011331444759,0.896153846153846,0.948545861297539,0.423877114524597
E02004515,Marks Tey & Wakes Colne,Colchester,East of England,1724,5158,517,524,337,409,6945,1982,5976,510,541,373,416,7816,1318,473,512,357,383,3043,0.220548862115127,0.927450980392157,0.946395563770795,0.957104557640751,0.920673076923077,0.389329580348004
E02004516,New Town & Hythe,Colchester,East of England,2895,10223,311,306,162,197,11199,2888,9566,346,335,213,230,10690,1800,286,299,186,209,2780,0.18816642274723,0.826589595375723,0.892537313432836,0.873239436619718,0.908695652173913,0.260056127221703
E02004517,Stanway,Colchester,East of England,1693,5410,486,561,376,610,7443,1797,5813,480,590,439,655,7977,1368,432,546,406,612,3364,0.235334594873559,0.9,0.925423728813559,0.924829157175399,0.934351145038168,0.421712423216748
E02004518,Abbey Field,Colchester,East of England,1788,5057,313,258,192,261,6081,1780,7405,273,344,231,282,8535,1054,237,315,210,260,2076,0.142336259284267,0.868131868131868,0.915697674418605,0.909090909090909,0.921985815602837,0.24323374340949
E02004519,Prettygate & Westlands,Colchester,East of England,1239,4071,490,499,353,662,6075,1238,4604,476,503,398,657,6638,1214,416,477,382,632,3121,0.263683753258037,0.873949579831933,0.94831013916501,0.959798994974874,0.961948249619482,0.470171738475444
E02004520,Shrub End,Colchester,East of England,2575,6062,253,257,169,213,6954,2592,5765,291,272,185,208,6721,1263,244,240,166,186,2099,0.219080659150043,0.838487972508591,0.882352941176471,0.897297297297297,0.894230769230769,0.312304716560036
E02004521,Old Heath & Rowhedge,Colchester,East of England,1746,5938,458,406,252,389,7443,1775,6237,467,465,295,400,7864,1519,408,427,272,381,3007,0.24354657687991,0.873661670235546,0.918279569892473,0.922033898305085,0.9525,0.382375381485249
E02004522,Wivenhoe & University,Colchester,East of England,1275,8875,473,573,407,407,10735,1287,10798,481,567,427,451,12724,1138,443,527,409,438,2955,0.105389887016114,0.920997920997921,0.929453262786596,0.957845433255269,0.971175166297117,0.23223828984596
E02004523,Monkwick,Colchester,East of England,2321,6607,425,415,207,360,8014,2416,6821,424,427,255,359,8286,1574,347,372,241,328,2862,0.23075795337927,0.818396226415094,0.871194379391101,0.945098039215686,0.913649025069638,0.3454018826937
E02004524,"Layer-de-la-Haye, Abberton & Mersea East",Colchester,East of England,1444,4912,582,614,380,458,6946,1359,5058,582,632,430,469,7171,1127,537,606,414,445,3129,0.222815342032424,0.922680412371134,0.958860759493671,0.962790697674419,0.948827292110874,0.43634081718031
E02004525,Tiptree,Colchester,East of England,1185,4265,539,640,452,516,6412,1280,4649,497,677,516,592,6931,783,454,638,498,554,2927,0.168423316842332,0.913480885311871,0.942392909896603,0.965116279069768,0.935810810810811,0.422305583609869
E02004526,West Mersea,Colchester,East of England,947,3654,654,743,519,768,6338,913,3820,601,758,579,768,6526,878,537,726,562,742,3445,0.229842931937173,0.89351081530782,0.95778364116095,0.970639032815199,0.966145833333333,0.527888446215139
E02006922,Parson's Heath,Colchester,East of England,2373,8320,808,901,630,911,11570,2548,8935,810,872,720,951,12288,2110,723,791,690,904,5218,0.236149972020145,0.892592592592593,0.907110091743119,0.958333333333333,0.950578338590957,0.424641927083333
E02004527,"North Weald, Matching & Sheering",Epping Forest,East of England,1522,5461,486,519,369,494,7329,1608,5929,512,557,428,526,7952,997,416,514,407,497,2831,0.168156518805869,0.8125,0.922800718132855,0.950934579439252,0.944866920152091,0.35601106639839
E02004528,"Roydon, Lower Nazeing & Epping Green",Epping Forest,East of England,1318,5042,511,596,391,569,7109,1635,6391,575,593,450,619,8628,913,484,541,420,574,2932,0.142857142857143,0.841739130434783,0.912310286677909,0.933333333333333,0.927302100161551,0.339823829392675
E02004529,"Fyfield, High Ongar & Stapleford Abbotts",Epping Forest,East of England,1094,4179,414,458,301,391,5743,1223,4680,456,477,333,415,6361,598,373,438,314,384,2107,0.127777777777778,0.817982456140351,0.918238993710692,0.942942942942943,0.925301204819277,0.331237226851124
E02004530,Chipping Ongar,Epping Forest,East of England,1310,3664,379,432,251,519,5245,1436,4105,398,429,298,516,5746,509,332,401,288,478,2008,0.123995127892814,0.834170854271357,0.934731934731935,0.966442953020134,0.926356589147287,0.349460494256874
E02004531,Epping North,Epping Forest,East of England,1474,4037,408,373,278,508,5604,1422,4506,393,420,272,466,6057,757,309,386,253,432,2137,0.167998224589436,0.786259541984733,0.919047619047619,0.930147058823529,0.927038626609442,0.352814924880304
E02004532,Epping South,Epping Forest,East of England,1156,3838,344,365,227,445,5219,1137,4083,356,382,270,382,5473,655,270,356,258,360,1899,0.160421258878276,0.758426966292135,0.931937172774869,0.955555555555556,0.942408376963351,0.346976064315732
E02004533,Waltham Abbey North,Epping Forest,East of England,1509,4487,355,406,264,482,5994,1494,4996,384,430,313,488,6611,816,287,385,292,448,2228,0.163330664531625,0.747395833333333,0.895348837209302,0.932907348242811,0.918032786885246,0.337014067463319
E02004534,Waltham Abbey South,Epping Forest,East of England,1964,5722,355,393,271,339,7080,1902,6000,388,404,322,372,7486,919,294,355,300,342,2210,0.153166666666667,0.757731958762887,0.878712871287129,0.93167701863354,0.919354838709677,0.295217739780924
E02004535,Waltham Abbey West & Outer,Epping Forest,East of England,989,3579,344,390,239,383,4935,1009,3921,355,369,280,361,5286,640,277,330,254,332,1833,0.163223667431778,0.780281690140845,0.894308943089431,0.907142857142857,0.919667590027701,0.346765039727582
E02004536,Theydon Bois & Abridge,Epping Forest,East of England,1085,3603,410,413,274,478,5178,1062,3856,417,440,287,459,5459,574,333,414,272,430,2023,0.148858921161826,0.798561151079137,0.940909090909091,0.947735191637631,0.93681917211329,0.370580692434512
E02004537,Loughton East,Epping Forest,East of England,1924,6059,364,281,246,343,7293,1938,6678,387,319,227,326,7937,876,246,272,208,297,1899,0.131176999101527,0.635658914728682,0.852664576802508,0.916299559471366,0.911042944785276,0.239259165931712
E02004538,Loughton North,Epping Forest,East of England,1854,6191,403,462,319,568,7943,1826,6804,468,505,364,575,8716,945,363,463,337,542,2650,0.138888888888889,0.775641025641026,0.916831683168317,0.925824175824176,0.942608695652174,0.304038549793483
E02004539,Loughton South,Epping Forest,East of England,1699,5075,310,303,246,375,6309,1587,5477,343,323,253,359,6755,705,243,288,238,339,1813,0.128720102245755,0.708454810495627,0.891640866873065,0.940711462450593,0.944289693593315,0.26839378238342
E02004540,Loughton West,Epping Forest,East of England,1204,3777,300,261,196,328,4862,1158,4191,310,288,233,346,5368,623,254,264,219,318,1678,0.148651873061322,0.819354838709677,0.916666666666667,0.939914163090129,0.919075144508671,0.312593144560358
E02004541,Buckhurst Hill,Epping Forest,East of England,2366,7243,483,569,442,679,9416,2401,8212,553,585,487,685,10522,1023,427,546,455,634,3085,0.124573794447151,0.772151898734177,0.933333333333333,0.93429158110883,0.925547445255475,0.293195210036115
E02004542,Chigwell,Epping Forest,East of England,1100,4145,389,359,223,425,5541,1206,4512,422,406,260,427,6027,1080,334,367,238,391,2410,0.23936170212766,0.791469194312796,0.903940886699507,0.915384615384615,0.915690866510539,0.399867263978762
E02004543,Grange Hill,Epping Forest,East of England,1519,4561,337,274,245,385,5802,1603,5117,346,326,249,392,6430,976,239,280,226,341,2062,0.190736759820207,0.690751445086705,0.858895705521472,0.907630522088353,0.869897959183674,0.320684292379471
E02004544,Old Harlow & Newhall,Harlow,East of England,2019,5327,418,408,276,437,6866,2233,6639,469,443,305,421,8277,1029,409,396,277,385,2496,0.154993221870764,0.872068230277186,0.893905191873589,0.908196721311475,0.914489311163896,0.301558535701341
E02004545,Mark Hall & Templefields,Harlow,East of England,1688,4797,349,279,172,372,5969,1812,5656,404,299,181,343,6883,928,336,272,167,314,2017,0.164073550212164,0.831683168316832,0.909698996655518,0.922651933701657,0.915451895043732,0.29304082522156
E02004546,Nettleswell,Harlow,East of England,1792,5005,371,272,187,389,6224,1843,6021,402,290,196,344,7253,930,326,249,179,304,1988,0.154459392127554,0.810945273631841,0.858620689655172,0.913265306122449,0.883720930232558,0.274093478560596
E02004547,Little Parndon & Hare Street,Harlow,East of England,2172,5970,305,239,173,427,7114,2458,7292,383,288,197,381,8541,1362,304,253,176,333,2428,0.186780032912781,0.793733681462141,0.878472222222222,0.893401015228426,0.874015748031496,0.284275845919682
E02004548,Church Langley,Harlow,East of England,2088,5636,295,301,197,189,6618,2005,6172,333,321,214,231,7271,1235,287,281,198,213,2214,0.200097213220998,0.861861861861862,0.875389408099689,0.925233644859813,0.922077922077922,0.304497318113052
E02004549,Bush Fair & Brays Grove,Harlow,East of England,1819,4849,318,225,214,412,6018,1813,5586,363,276,215,425,6865,938,303,261,194,385,2081,0.167919799498747,0.834710743801653,0.945652173913043,0.902325581395349,0.905882352941176,0.30313182811362
E02004550,Passmores & The High,Harlow,East of England,1952,5149,285,287,258,520,6499,2026,6122,359,309,239,492,7521,1101,284,282,220,451,2338,0.17984318850049,0.79108635097493,0.912621359223301,0.920502092050209,0.916666666666667,0.310862917165271
E02004551,Potter Street,Harlow,East of England,1704,4417,353,300,246,400,5716,1748,5096,398,315,242,388,6439,917,339,289,227,351,2123,0.179945054945055,0.851758793969849,0.917460317460317,0.93801652892562,0.904639175257732,0.329709582233266
E02004552,Great Parndon & Katherines,Harlow,East of England,1219,3870,406,391,214,261,5142,1236,4454,411,431,254,283,5833,821,365,386,242,262,2076,0.184328693309385,0.888077858880779,0.895591647331787,0.952755905511811,0.925795053003534,0.355906051774387
E02004553,Staple Tye & Latton Bush,Harlow,East of England,1696,4354,281,267,228,344,5474,1843,5347,312,272,222,322,6475,873,253,246,203,300,1875,0.163269122872639,0.810897435897436,0.904411764705882,0.914414414414414,0.93167701863354,0.28957528957529
E02004554,Kingsmoor,Harlow,East of England,1642,4501,331,333,215,256,5636,1679,5402,360,331,243,294,6630,915,306,302,225,271,2019,0.169381710477601,0.85,0.91238670694864,0.925925925925926,0.921768707482993,0.304524886877828
E02004555,"Tollesbury, Tolleshunt & Goldhanger",Maldon,East of England,1023,3684,519,534,302,373,5412,1010,3896,462,538,342,403,5641,825,435,515,332,382,2489,0.211755646817248,0.941558441558442,0.95724907063197,0.970760233918129,0.947890818858561,0.441233823790108
E02004556,"Great Totham, Wickham Bishops & Woodham",Maldon,East of England,1239,4126,519,654,431,522,6252,1236,4517,504,604,521,556,6702,861,455,586,506,531,2939,0.19061323887536,0.902777777777778,0.970198675496689,0.971209213051823,0.955035971223021,0.438525813190093
E02004557,Heybridge,Maldon,East of England,1543,5217,505,529,329,425,7005,1564,5426,527,549,331,472,7305,1371,488,519,316,446,3140,0.252672318466642,0.925996204933586,0.945355191256831,0.954682779456193,0.944915254237288,0.42984257357974
E02004558,Maldon North,Maldon,East of England,1081,4004,360,494,330,670,5858,1077,4013,368,438,369,656,5844,1017,344,411,354,631,2757,0.253426364315973,0.934782608695652,0.938356164383562,0.959349593495935,0.961890243902439,0.4717659137577
E02004559,Maldon South,Maldon,East of England,1207,4503,539,560,383,519,6504,1212,4834,481,581,442,541,6879,1225,455,557,428,522,3187,0.253413322300372,0.945945945945946,0.958691910499139,0.968325791855204,0.964879852125693,0.463294083442361
E02004560,"Southminster, Bradwell & Dengie Peninsula",Maldon,East of England,1635,5423,613,619,401,486,7542,1548,5803,583,653,449,523,8011,934,513,596,420,498,2961,0.160951232121317,0.879931389365352,0.91271056661562,0.935412026726058,0.952198852772467,0.369616776931719
E02004561,"Mayland, Althorne & Cold Norton",Maldon,East of England,1642,6417,738,776,501,593,9025,1604,6750,743,775,552,635,9455,1168,674,737,537,616,3732,0.173037037037037,0.907133243606999,0.950967741935484,0.972826086956522,0.97007874015748,0.394711792702274
E02004562,Burnham-on-Crouch,Maldon,East of England,1231,4499,622,657,418,531,6727,1365,4935,631,639,508,543,7256,744,575,593,482,522,2916,0.150759878419453,0.911251980982567,0.928012519561815,0.948818897637795,0.961325966850829,0.401874310915105
E02004563,Hullbridge,Rochford,East of England,860,3561,535,643,436,524,5699,916,3863,486,645,473,580,6047,956,442,615,462,560,3035,0.247476054879627,0.909465020576132,0.953488372093023,0.976744186046512,0.96551724137931,0.501901769472466
E02004564,Ashingdon,Rochford,East of England,1303,4955,532,557,379,528,6951,1263,5012,525,570,404,570,7081,1161,473,534,391,539,3098,0.231644054269753,0.900952380952381,0.936842105263158,0.967821782178218,0.945614035087719,0.437508826436944
E02004565,Hockley & Hawkwell West,Rochford,East of England,2674,9534,931,1056,782,1031,13334,2609,9761,898,975,841,1063,13538,2109,813,928,811,1016,5677,0.216063927876242,0.905345211581292,0.951794871794872,0.964328180737218,0.955785512699906,0.419338159255429
E02004566,Rochford Town & Canewdon,Rochford,East of England,1211,3715,276,280,183,325,4779,1118,3745,275,300,191,327,4838,796,245,283,180,283,1787,0.212550066755674,0.890909090909091,0.943333333333333,0.942408376963351,0.865443425076453,0.369367507234394
E02004567,Rayleigh North East,Rochford,East of England,1414,4769,502,578,363,634,6846,1333,5121,442,566,408,671,7208,1013,366,531,397,627,2934,0.197812927162664,0.828054298642534,0.938162544169611,0.973039215686275,0.934426229508197,0.407047724750277
E02004568,Rayleigh North West,Rochford,East of England,1910,5847,395,414,306,341,7303,1787,5791,391,440,294,357,7273,1144,322,410,279,313,2468,0.197547919184942,0.823529411764706,0.931818181818182,0.948979591836735,0.876750700280112,0.339337274852193
E02004569,Rochford Outer & Hawkwell East,Rochford,East of England,1415,5032,382,455,288,483,6640,1625,5542,431,454,355,498,7280,1253,381,423,336,464,2857,0.226091663659329,0.883990719257541,0.931718061674009,0.946478873239437,0.931726907630522,0.392445054945055
E02004570,Rayleigh South West,Rochford,East of England,1553,5163,501,637,394,686,7381,1530,5317,503,589,466,739,7614,1019,397,558,437,695,3106,0.191649426368253,0.789264413518887,0.947368421052632,0.937768240343348,0.940460081190798,0.407932755450486
E02004571,Rayleigh South East,Rochford,East of England,1367,4661,532,585,403,642,6823,1339,4750,455,584,442,622,6853,945,376,550,427,598,2896,0.198947368421053,0.826373626373626,0.941780821917808,0.96606334841629,0.961414790996785,0.422588647307748
E02004572,Great Wakering & Foulness,Rochford,East of England,1382,4769,519,536,321,378,6523,1394,5095,502,541,340,412,6890,1128,447,508,314,390,2787,0.221393523061825,0.890438247011952,0.939001848428835,0.923529411764706,0.946601941747573,0.404499274310595
E02004573,Harwich Town & Dovercourt,Tendring,East of England,1327,3903,366,323,230,380,5202,1275,4082,372,360,251,397,5462,962,312,324,223,358,2179,0.235668789808917,0.838709677419355,0.9,0.888446215139442,0.90176322418136,0.398938117905529
E02004574,Harwich Parkeston,Tendring,East of England,1684,4403,433,481,366,457,6140,1628,4638,436,477,359,490,6400,1113,376,455,342,460,2746,0.239974126778784,0.862385321100918,0.953878406708595,0.952646239554318,0.938775510204082,0.4290625
E02004575,Manningtree & Mistley,Tendring,East of England,1988,6830,762,781,542,784,9699,1938,7252,792,793,601,829,10267,1998,736,750,570,799,4853,0.275510204081633,0.929292929292929,0.94577553593947,0.948419301164726,0.963811821471653,0.472679458459141
E02004576,Harwich West & South,Tendring,East of England,1486,5010,659,720,518,717,7624,1440,5239,643,702,582,747,7913,1568,593,660,547,696,4064,0.29929375835083,0.922239502332815,0.94017094017094,0.939862542955326,0.931726907630522,0.513585239479338
E02004577,Elmstead Market & Ardleigh,Tendring,East of England,974,3412,385,349,250,310,4706,989,3773,357,374,268,323,5095,1010,338,346,258,307,2259,0.267691492181288,0.946778711484594,0.925133689839572,0.962686567164179,0.95046439628483,0.443375858684985
E02004578,Walton & Frinton Coastal,Tendring,East of England,978,3415,641,860,531,906,6353,1011,3773,629,791,616,894,6703,1115,558,740,585,842,3840,0.295520805724887,0.887122416534181,0.935524652338812,0.949675324675325,0.941834451901566,0.572877815903327
E02004579,Weeley & Thorpe-le-Soken,Tendring,East of England,1093,3874,621,685,475,518,6173,1170,4515,659,723,517,575,6989,1369,615,662,492,549,3687,0.303211517165006,0.933232169954476,0.915629322268326,0.951644100580271,0.954782608695652,0.527543282300758
E02004580,Frinton West & Kirby,Tendring,East of England,1568,5749,1058,1380,965,1474,10626,1509,5912,1077,1372,1033,1511,10905,1857,988,1325,989,1444,6603,0.314106901217862,0.91736304549675,0.965743440233236,0.957405614714424,0.955658504301787,0.605502063273728
E02004581,"Alresford, Great Bentley & Thorrington",Tendring,East of England,1267,4325,591,681,456,597,6650,1377,4939,603,690,535,616,7383,1369,567,662,514,589,3701,0.277181615711683,0.940298507462687,0.959420289855072,0.960747663551402,0.956168831168831,0.501286739807666
E02004582,Clacton North,Tendring,East of England,942,3412,612,762,564,711,6061,889,3599,600,702,582,725,6208,980,547,665,535,654,3381,0.27229786051681,0.911666666666667,0.947293447293447,0.919243986254295,0.902068965517241,0.544619845360825
E02004583,Brightlingsea & Point Clear,Tendring,East of England,1451,4887,598,800,472,645,7402,1473,5330,588,749,562,669,7898,1506,535,704,531,634,3910,0.282551594746717,0.909863945578231,0.939919893190921,0.944839857651246,0.947683109118087,0.495062041023044
E02004584,Holland-on-Sea,Tendring,East of England,674,2866,654,948,652,898,6018,645,2979,561,900,699,944,6083,933,520,849,667,889,3858,0.313192346424975,0.926916221033868,0.943333333333333,0.954220314735336,0.941737288135593,0.63422653296071
E02004585,Clacton Bocking's Elm,Tendring,East of England,1601,4802,603,679,469,520,7073,1638,5239,582,730,521,573,7645,1461,545,689,492,526,3713,0.278870013361329,0.936426116838488,0.943835616438356,0.944337811900192,0.917975567190227,0.485676913015043
E02004586,Clacton East,Tendring,East of England,1395,4462,550,677,483,802,6974,1412,4808,564,653,500,831,7356,1388,503,610,475,770,3746,0.288685524126456,0.891843971631206,0.934150076569678,0.95,0.926594464500602,0.509244154431756
E02004587,Clacton Rush Green,Tendring,East of England,1801,4488,516,496,368,449,6317,1807,4904,502,485,394,469,6754,1347,443,443,371,434,3038,0.274673735725938,0.882470119521912,0.91340206185567,0.941624365482233,0.925373134328358,0.449807521468759
E02004588,Clacton Central,Tendring,East of England,1325,4334,370,356,266,528,5854,1432,4938,379,374,303,569,6563,1368,313,348,275,512,2816,0.277035236938032,0.825857519788918,0.93048128342246,0.907590759075908,0.899824253075571,0.429072070699375
E02004589,Clacton West,Tendring,East of England,1461,4268,463,542,386,613,6272,1333,4415,413,527,421,636,6412,1344,372,492,399,592,3199,0.304416761041903,0.900726392251816,0.933586337760911,0.947743467933492,0.930817610062893,0.498908296943232
E02004590,Jaywick & St Osyth,Tendring,East of England,1093,4311,770,885,644,699,7309,1139,4830,733,871,692,807,7933,1381,638,786,638,738,4181,0.28592132505176,0.870395634379263,0.902411021814007,0.921965317919075,0.91449814126394,0.527038951216438
E02004591,"Audley End, Ashdon & the Chesterfords",Uttlesford,East of England,1398,4468,437,411,290,430,6036,1412,4771,450,469,332,412,6434,817,360,445,322,396,2340,0.171242926011318,0.8,0.948827292110874,0.969879518072289,0.961165048543689,0.363692881566677
E02004592,Saffron Walden Town,Uttlesford,East of England,2643,8109,697,682,561,976,11025,2576,8416,730,682,530,939,11297,1443,513,639,504,904,4003,0.171459125475285,0.702739726027397,0.936950146627566,0.950943396226415,0.96272630457934,0.354341860670975
E02004593,"Newport, Littlebury & Clavering",Uttlesford,East of England,1649,5071,563,590,348,488,7060,1602,5476,577,620,400,526,7599,981,483,586,390,508,2948,0.179145361577794,0.837088388214905,0.945161290322581,0.975,0.965779467680608,0.387945782339782
E02004594,"Thaxted, Great Sampford & Radwinter",Uttlesford,East of England,1598,5341,462,522,351,442,7118,1538,5731,467,507,406,499,7610,949,387,478,381,475,2670,0.165590647356482,0.828693790149893,0.942800788954635,0.938423645320197,0.95190380761523,0.350854139290407
E02004595,Stansted Mountfitchet & Elsenham,Uttlesford,East of England,2967,8889,699,736,499,701,11524,3024,9536,755,805,555,701,12352,1504,609,763,530,669,4075,0.157718120805369,0.806622516556291,0.947826086956522,0.954954954954955,0.95435092724679,0.329906088082902
E02004596,"Takeley, Airport & Mountfitchet South",Uttlesford,East of England,2451,6563,443,460,314,373,8153,2346,6783,461,492,367,418,8521,978,372,464,332,401,2547,0.144183989385228,0.806941431670282,0.943089430894309,0.904632152588556,0.95933014354067,0.298908578805305
E02004597,Great Dunmow,Uttlesford,East of England,1648,5373,436,441,289,454,6993,1791,5656,454,459,344,475,7388,893,385,432,329,458,2497,0.157885431400283,0.848017621145375,0.941176470588235,0.956395348837209,0.964210526315789,0.337980508933406
E02004598,"Flitch Green, Felsted & High Easter",Uttlesford,East of England,2327,6648,599,583,424,625,8879,2200,6941,601,606,481,639,9268,1104,518,579,468,607,3276,0.159054891226048,0.861896838602329,0.955445544554455,0.972972972972973,0.949921752738654,0.353474320241692
E02004599,"Hatfield Heath, Hallingburys & Rodings",Uttlesford,East of England,1453,4758,404,469,308,423,6362,1405,5061,451,465,360,470,6807,761,392,442,346,437,2378,0.150365540407034,0.869179600886918,0.950537634408602,0.961111111111111,0.929787234042553,0.349346261201704
E02004843,Hoddesdon Ware Road,Broxbourne,East of England,1321,4054,366,447,325,447,5639,1350,4681,368,457,381,482,6369,813,333,429,366,457,2398,0.1736808374279,0.904891304347826,0.938730853391685,0.960629921259842,0.948132780082988,0.376511226252159
E02004844,Rye Park,Broxbourne,East of England,1564,4611,295,294,185,369,5754,1562,5261,311,289,207,360,6428,846,268,258,200,332,1904,0.160805930431477,0.861736334405145,0.892733564013841,0.966183574879227,0.922222222222222,0.296204107031736
E02004845,Hoddesdon Town,Broxbourne,East of England,1533,4847,350,439,285,531,6452,1552,5532,365,413,311,524,7145,809,309,386,292,500,2296,0.146240057845264,0.846575342465753,0.934624697336562,0.938906752411576,0.954198473282443,0.321343596920924
E02004846,Broxbourne Town,Broxbourne,East of England,1144,3583,337,431,271,418,5040,1165,4211,389,396,323,455,5774,560,310,374,306,433,1983,0.132985039183092,0.796915167095116,0.944444444444444,0.947368421052632,0.951648351648352,0.343436092829927
E02004847,Wormley & Turnford,Broxbourne,East of England,2536,6600,421,412,308,384,8125,2416,6918,443,443,303,403,8510,898,338,408,277,375,2296,0.129806302399537,0.762979683972912,0.920993227990971,0.914191419141914,0.930521091811414,0.269800235017626
E02004848,Flamstead End,Broxbourne,East of England,1666,4705,357,353,257,324,5996,1663,5136,353,381,284,322,6476,714,292,353,259,300,1918,0.139018691588785,0.827195467422096,0.926509186351706,0.911971830985916,0.93167701863354,0.296170475602224
E02004849,Goffs Oak,Broxbourne,East of England,1161,4257,364,361,273,345,5600,1215,4653,372,388,270,379,6062,648,321,354,244,353,1920,0.13926499032882,0.862903225806452,0.912371134020619,0.903703703703704,0.931398416886544,0.316727152754866
E02004850,Cheshunt Coopers Walk,Broxbourne,East of England,1464,4730,327,353,214,417,6041,1455,5101,329,342,260,413,6445,670,265,314,248,387,1884,0.131346794746128,0.805471124620061,0.91812865497076,0.953846153846154,0.937046004842615,0.292319627618309
E02004851,Rosedale,Broxbourne,East of England,1235,3598,274,307,213,302,4694,1181,3894,294,319,230,276,5013,584,257,288,213,255,1597,0.149974319465845,0.874149659863946,0.90282131661442,0.926086956521739,0.923913043478261,0.318571713544784
E02004852,Cheshunt Central,Broxbourne,East of England,1603,4745,323,343,266,515,6192,1580,5335,337,350,270,521,6813,621,272,321,245,495,1954,0.116401124648547,0.807121661721068,0.917142857142857,0.907407407407407,0.950095969289827,0.286804638191692
E02004853,Churchgate,Broxbourne,East of England,1415,4004,291,323,215,391,5224,1470,4588,315,338,231,367,5839,688,236,309,214,344,1791,0.149956408020924,0.749206349206349,0.914201183431953,0.926406926406927,0.93732970027248,0.306730604555575
E02004854,Cheshunt South,Broxbourne,East of England,1494,4842,298,320,258,518,6236,1443,5231,326,330,261,501,6649,715,252,306,243,482,1998,0.136685146243548,0.773006134969325,0.927272727272727,0.931034482758621,0.962075848303393,0.300496315235374
E02004855,Waltham Cross Town,Broxbourne,East of England,1788,5414,253,248,199,248,6362,1855,6074,285,251,195,264,7069,712,213,207,179,233,1544,0.117220941718801,0.747368421052632,0.824701195219124,0.917948717948718,0.882575757575758,0.218418446739284
E02004856,"Markyate, Flamstead & Gaddesden",Dacorum,East of England,1092,3579,297,286,208,226,4596,1121,3797,358,289,189,258,4891,641,321,267,180,241,1650,0.168817487490124,0.896648044692737,0.923875432525952,0.952380952380952,0.934108527131783,0.337354324269066
E02004857,Tring West & Long Marston,Dacorum,East of England,1131,3620,334,314,213,365,4846,1125,4044,318,349,226,396,5333,607,297,335,214,369,1822,0.150098911968348,0.933962264150943,0.959885386819484,0.946902654867257,0.931818181818182,0.341646352897056
E02004858,Tring North,Dacorum,East of England,1054,3175,241,282,164,238,4100,1058,3503,248,258,196,215,4420,510,228,240,185,200,1363,0.145589494718812,0.919354838709677,0.930232558139535,0.943877551020408,0.930232558139535,0.308371040723982
E02004859,"Tring East, Wigginton & Aldbury",Dacorum,East of England,1003,3028,337,365,207,319,4256,974,3310,313,379,237,324,4563,478,285,361,224,305,1653,0.144410876132931,0.910543130990415,0.952506596306069,0.945147679324895,0.941358024691358,0.362261669953978
E02004860,Woodhall Farm,Dacorum,East of England,1306,4069,277,175,98,78,4697,1307,4252,283,237,136,110,5018,662,247,211,123,99,1342,0.155691439322672,0.872791519434629,0.890295358649789,0.904411764705882,0.9,0.267437225986449
E02004861,Northchurch & Potten End,Dacorum,East of England,961,3031,338,395,258,509,4531,955,3321,354,418,288,501,4882,542,322,382,268,468,1982,0.163203854260765,0.909604519774011,0.913875598086124,0.930555555555556,0.934131736526946,0.405981155264236
E02004862,Grovehill,Dacorum,East of England,1759,4984,469,356,196,230,6235,1771,5366,509,420,212,218,6725,992,439,377,195,190,2193,0.184867685426761,0.862475442043222,0.897619047619048,0.919811320754717,0.871559633027523,0.326096654275093
E02004863,Highfield,Dacorum,East of England,1911,4971,288,250,185,424,6118,1898,5521,334,258,218,400,6731,1072,283,222,194,364,2135,0.194167723238544,0.847305389221557,0.86046511627907,0.889908256880734,0.91,0.317189124944288
E02004864,Berkhamsted Town,Dacorum,East of England,1179,3965,372,324,234,473,5368,1164,4253,374,359,254,451,5691,550,333,329,242,433,1887,0.129320479661415,0.890374331550802,0.916434540389972,0.952755905511811,0.960088691796009,0.331576172904586
E02004865,Gadebridge & Old Town,Dacorum,East of England,1114,3689,209,252,127,290,4567,1068,3869,247,226,150,271,4763,658,219,212,136,243,1468,0.170069785474283,0.88663967611336,0.938053097345133,0.906666666666667,0.896678966789668,0.308209111904262
E02004866,Warners End,Dacorum,East of England,1443,4188,278,274,202,375,5317,1377,4460,337,262,192,350,5601,801,296,237,183,315,1832,0.179596412556054,0.878338278931751,0.904580152671756,0.953125,0.9,0.327084449205499
E02004867,Berkhamsted West,Dacorum,East of England,1565,3861,300,326,209,396,5092,1563,4193,298,353,221,346,5411,641,269,328,204,326,1768,0.152873837347961,0.902684563758389,0.929178470254957,0.923076923076923,0.942196531791908,0.326741822214009
E02004868,Maylands & Adeyfield,Dacorum,East of England,1749,4341,268,271,176,438,5494,1920,5042,299,252,194,363,6150,912,263,231,185,336,1927,0.180880602935343,0.879598662207358,0.916666666666667,0.95360824742268,0.925619834710744,0.313333333333333
E02004869,Berkhamsted South,Dacorum,East of England,1258,3538,271,243,190,292,4534,1278,3959,280,270,202,318,5029,525,242,249,188,298,1502,0.132609244758777,0.864285714285714,0.922222222222222,0.930693069306931,0.937106918238994,0.298667727182342
E02004870,Hemel Hempstead Town,Dacorum,East of England,2406,7378,436,360,273,500,8947,2404,8298,470,378,292,560,9998,1455,403,336,271,526,2991,0.175343456254519,0.857446808510638,0.888888888888889,0.928082191780822,0.939285714285714,0.299159831966393
E02004871,Chaulden,Dacorum,East of England,1038,3300,249,191,178,240,4158,1023,3559,257,201,162,261,4440,643,233,181,156,243,1456,0.180668727170554,0.906614785992218,0.900497512437811,0.962962962962963,0.931034482758621,0.327927927927928
E02004872,Leverstock Green,Dacorum,East of England,1432,4434,361,390,296,501,5982,1468,4877,368,394,320,517,6476,951,338,368,309,489,2455,0.194996924338733,0.918478260869565,0.934010152284264,0.965625,0.945841392649903,0.379092032118592
E02004873,Boxmoor & Apsley,Dacorum,East of England,2159,7656,494,469,306,444,9369,2145,7813,500,492,352,458,9615,1296,435,452,331,427,2941,0.165877383847434,0.87,0.91869918699187,0.940340909090909,0.932314410480349,0.305876235049402
E02004874,Corner Hall,Dacorum,East of England,1280,3974,296,234,182,258,4944,1167,4279,317,263,174,243,5276,768,271,243,158,213,1653,0.179481187193269,0.854889589905363,0.923954372623574,0.908045977011494,0.876543209876543,0.31330553449583
E02004875,Nash Mills & Bennetts End,Dacorum,East of England,2402,6393,392,353,218,408,7764,2415,7250,422,385,255,340,8652,1292,354,353,238,303,2540,0.178206896551724,0.838862559241706,0.916883116883117,0.933333333333333,0.891176470588235,0.293573740175682
E02004876,Bovingdon & Chipperfield,Dacorum,East of England,1535,5833,499,569,398,515,7814,1503,6378,506,544,466,535,8429,1265,465,514,449,508,3201,0.198338037002195,0.91897233201581,0.944852941176471,0.963519313304721,0.949532710280374,0.379760351168585
E02004877,Kings Langley,Dacorum,East of England,981,3154,265,289,225,343,4276,949,3601,270,282,245,435,4833,716,234,260,225,397,1832,0.198833657317412,0.866666666666667,0.921985815602837,0.918367346938776,0.91264367816092,0.379060624870681
E02004896,Potters Bar Parkfield,Hertsmere,East of England,1292,4758,418,518,439,894,7027,1204,5428,468,480,421,843,7640,956,410,439,392,799,2996,0.176123802505527,0.876068376068376,0.914583333333333,0.931116389548693,0.947805456702254,0.392146596858639
E02004897,Potters Bar Furzefield,Hertsmere,East of England,1327,3997,328,417,235,391,5368,1319,4581,366,395,261,373,5976,882,309,363,245,339,2138,0.192534381139489,0.844262295081967,0.918987341772152,0.938697318007663,0.908847184986595,0.357764390896921
E02004898,Potters Bar Oakmere,Hertsmere,East of England,1476,4624,416,374,267,480,6161,1445,5399,451,377,296,437,6960,1013,365,338,271,386,2373,0.187627338395999,0.809312638580931,0.896551724137931,0.915540540540541,0.883295194508009,0.340948275862069
E02004899,Shenley & South Mimms,Hertsmere,East of England,1230,3230,276,245,175,299,4225,1211,3857,288,321,196,311,4973,928,251,294,180,281,1934,0.240601503759399,0.871527777777778,0.91588785046729,0.918367346938776,0.903536977491961,0.388900060325759
E02004900,Radlett,Hertsmere,East of England,1651,4715,417,444,317,564,6457,1626,5877,449,436,361,586,7709,1717,395,406,341,548,3407,0.292155861834269,0.879732739420935,0.931192660550459,0.944598337950139,0.935153583617747,0.441950966402906
E02004901,Borehamwood Cowley Hill,Hertsmere,East of England,2142,5690,364,346,240,363,7003,2274,7053,382,347,238,345,8365,1286,307,288,211,304,2396,0.182333758684248,0.803664921465969,0.829971181556196,0.88655462184874,0.881159420289855,0.286431560071727
E02004902,Borehamwood Brookmeadow,Hertsmere,East of England,2245,5064,361,267,199,297,6188,2058,6273,356,351,214,295,7489,1189,276,306,191,256,2218,0.189542483660131,0.775280898876405,0.871794871794872,0.892523364485981,0.867796610169492,0.296167712645213
E02004903,Bushey North,Hertsmere,East of England,1645,4959,272,297,198,309,6035,1645,5465,298,299,190,316,6568,1159,248,277,167,292,2143,0.212076852698994,0.832214765100671,0.926421404682274,0.878947368421053,0.924050632911392,0.326278928136419
E02004904,Borehamwood Kenilworth,Hertsmere,East of England,1467,4164,240,241,139,175,4959,1396,4720,293,261,165,209,5648,905,242,230,150,188,1715,0.191737288135593,0.825938566552901,0.881226053639847,0.909090909090909,0.899521531100479,0.30364730878187
E02004905,Elstree & Aldenham,Hertsmere,East of England,1394,3964,323,352,208,339,5186,1313,4749,361,364,248,400,6122,1375,318,324,221,355,2593,0.289534638871341,0.880886426592798,0.89010989010989,0.891129032258064,0.8875,0.423554393988892
E02004906,Borehamwood Hillside,Hertsmere,East of England,2547,6576,375,389,233,345,7918,2532,7941,449,411,274,371,9446,1593,372,354,237,330,2886,0.200604457876842,0.828507795100223,0.861313868613139,0.864963503649635,0.889487870619946,0.305526148634343
E02004907,Bushey Central,Hertsmere,East of England,2131,6005,475,547,353,560,7940,2124,7295,506,577,435,578,9391,1732,443,531,400,520,3626,0.237422892392049,0.875494071146245,0.920277296360485,0.919540229885057,0.899653979238754,0.386114364817378
E02004908,Bushey Heath,Hertsmere,East of England,1900,5463,533,628,551,830,8005,1984,6638,554,613,590,978,9373,2039,486,569,561,916,4571,0.307170834588732,0.877256317689531,0.928221859706362,0.950847457627119,0.936605316973415,0.487677371172517
E02004909,Royston North & Central,North Hertfordshire,East of England,1175,3670,250,247,162,278,4607,1126,3856,251,266,172,267,4812,805,198,250,159,251,1663,0.208765560165975,0.788844621513944,0.93984962406015,0.924418604651163,0.940074906367041,0.345594347464672
E02004910,"Royston South, West & East",North Hertfordshire,East of England,2164,6629,613,685,453,716,9096,2186,7339,607,774,516,691,9927,1439,500,744,498,667,3848,0.196075759640278,0.823723228995058,0.961240310077519,0.965116279069768,0.965267727930535,0.387629696786542
E02004911,Letchworth Grange,North Hertfordshire,East of England,1382,3989,349,265,246,496,5345,1376,4303,368,290,224,447,5632,851,314,268,212,428,2073,0.197768998373228,0.853260869565217,0.924137931034483,0.946428571428571,0.957494407158837,0.368075284090909
E02004912,Baldock,North Hertfordshire,East of England,1991,6737,448,463,341,644,8633,1874,7233,532,484,374,639,9262,1336,470,455,344,603,3208,0.184708972763722,0.883458646616541,0.940082644628099,0.919786096256684,0.943661971830986,0.346361477002807
E02004913,"Great Ashby, Ashwell & Barley",North Hertfordshire,East of England,3241,9553,741,685,494,677,12150,3050,9945,775,712,534,707,12673,1899,693,663,515,675,4445,0.190950226244344,0.894193548387097,0.931179775280899,0.964419475655431,0.954738330975955,0.350745679791683
E02004914,Letchworth East,North Hertfordshire,East of England,1783,5117,357,327,243,404,6448,1694,5445,357,372,253,385,6812,1004,302,344,237,358,2245,0.184389348025712,0.84593837535014,0.924731182795699,0.936758893280632,0.92987012987013,0.329565472695244
E02004915,Letchworth Wilbury,North Hertfordshire,East of England,1128,3593,280,231,209,273,4586,1106,3771,247,248,211,286,4763,692,208,224,200,270,1594,0.183505701405463,0.842105263157895,0.903225806451613,0.947867298578199,0.944055944055944,0.334663027503674
E02004916,Letchworth South West,North Hertfordshire,East of England,1376,4200,414,499,385,565,6063,1409,4816,403,502,381,611,6713,876,366,472,358,582,2654,0.181893687707641,0.90818858560794,0.940239043824701,0.939632545931758,0.952536824877251,0.395352301504543
E02004917,Letchworth South East,North Hertfordshire,East of England,1223,3636,347,442,280,464,5169,1157,3997,347,433,307,467,5551,802,316,408,292,442,2260,0.200650487865899,0.910662824207493,0.942263279445728,0.95114006514658,0.946466809421842,0.407133849756801
E02004918,Hitchin Bearton,North Hertfordshire,East of England,1585,5909,311,232,182,303,6937,1554,6050,328,253,186,308,7125,929,270,243,173,285,1900,0.153553719008264,0.823170731707317,0.960474308300395,0.93010752688172,0.925324675324675,0.266666666666667
E02004919,Hitchin Walsworth,North Hertfordshire,East of England,1646,4906,357,327,241,346,6177,1619,5196,369,346,258,318,6487,881,297,321,246,300,2045,0.16955350269438,0.804878048780488,0.927745664739884,0.953488372093023,0.943396226415094,0.315245876368121
E02004920,Hitchin Town & West,North Hertfordshire,East of England,2242,6982,569,560,431,885,9427,2174,7261,565,598,448,895,9767,1237,477,567,423,858,3562,0.170362209062113,0.844247787610619,0.948160535117057,0.944196428571429,0.958659217877095,0.364697450598956
E02004921,Hitchin Highbury,North Hertfordshire,East of England,1618,4820,338,374,303,451,6286,1614,5107,353,366,308,491,6625,909,315,353,298,473,2348,0.177990992755042,0.892351274787535,0.96448087431694,0.967532467532468,0.963340122199593,0.354415094339623
E02004922,"Ickleford, Great Offley & Whitwell",North Hertfordshire,East of England,1852,5773,600,606,436,591,8006,1843,6362,587,634,492,542,8617,1184,518,599,461,520,3282,0.186104998428167,0.882453151618399,0.944794952681388,0.936991869918699,0.959409594095941,0.380875014506209
E02004923,"Knebworth, Codicote & Kimpton",North Hertfordshire,East of England,1902,6087,612,645,403,585,8332,1924,6638,642,621,471,764,9136,1082,576,585,443,724,3410,0.163000903886713,0.897196261682243,0.942028985507246,0.940552016985138,0.947643979057592,0.373248686514886
E02004956,Abbots Langley,Three Rivers,East of England,1642,5520,481,483,350,533,7367,1631,6024,480,465,375,510,7854,1071,429,437,362,485,2784,0.177788844621514,0.89375,0.939784946236559,0.965333333333333,0.950980392156863,0.354469060351413
E02004957,Leavesden & Garston Manor,Three Rivers,East of England,2478,6694,448,382,281,299,8104,2524,7416,474,455,301,307,8953,1315,414,413,281,282,2705,0.177319309600863,0.873417721518987,0.907692307692308,0.933554817275748,0.9185667752443,0.302133363118508
E02004958,Croxley North & Sarratt,Three Rivers,East of England,1613,4700,361,477,268,504,6310,1526,5080,415,432,310,480,6717,961,374,410,298,460,2503,0.189173228346457,0.901204819277108,0.949074074074074,0.961290322580645,0.958333333333333,0.372636593717433
E02004959,Rickmansworth North & Loudwater,Three Rivers,East of England,1004,3667,308,327,225,588,5115,1048,4188,340,358,257,612,5755,922,297,327,235,573,2354,0.220152817574021,0.873529411764706,0.91340782122905,0.914396887159533,0.936274509803922,0.409035621198957
E02004960,Chorleywood,Three Rivers,East of England,1216,3342,303,305,249,342,4541,1167,3770,304,315,245,367,5001,670,267,292,228,348,1805,0.177718832891247,0.87828947368421,0.926984126984127,0.930612244897959,0.948228882833788,0.360927814437113
E02004961,Croxley Green,Three Rivers,East of England,2103,5912,468,446,318,482,7626,2015,6527,486,493,318,517,8341,1158,446,467,303,487,2861,0.177416883713804,0.917695473251029,0.947261663286004,0.952830188679245,0.941972920696325,0.343004435918955
E02004962,Rickmansworth West,Three Rivers,East of England,1908,5506,372,365,301,502,7046,1852,6179,398,419,319,482,7797,1142,352,388,293,453,2628,0.184819550089011,0.884422110552764,0.926014319809069,0.918495297805643,0.939834024896266,0.337052712581762
E02004963,Oxhey Hall & Hayling,Three Rivers,East of England,1678,4656,341,320,180,226,5723,1693,5220,371,336,211,273,6411,1010,295,297,187,233,2022,0.193486590038314,0.795148247978437,0.883928571428571,0.886255924170616,0.853479853479854,0.315395414131961
E02004964,"Mill End, Heronsgate & Maple Cross",Three Rivers,East of England,1161,3481,247,233,170,257,4388,1237,3822,260,265,187,255,4789,800,221,242,177,240,1680,0.209314495028781,0.85,0.913207547169811,0.946524064171123,0.941176470588235,0.350803925662978
E02004965,Carpenders Park,Three Rivers,East of England,1230,4094,366,425,312,527,5724,1309,4540,354,415,384,529,6222,917,295,374,350,490,2426,0.201982378854626,0.833333333333333,0.901204819277108,0.911458333333333,0.926275992438563,0.389906782385085
E02004966,Moor Park & Batchworth,Three Rivers,East of England,1283,4534,440,447,292,533,6246,1215,6134,503,493,359,562,8051,1557,432,430,311,492,3222,0.25383110531464,0.858846918489066,0.872210953346856,0.866295264623956,0.875444839857651,0.400198733076636
E02004967,South Oxhey,Three Rivers,East of England,1825,5074,297,199,153,269,5992,1706,5554,310,234,151,266,6515,1076,227,201,137,233,1874,0.193734245588765,0.732258064516129,0.858974358974359,0.907284768211921,0.87593984962406,0.287643898695319
E02004968,Woodside & Leavesden Green,Watford,East of England,1669,4647,304,287,189,340,5767,1643,5208,296,313,221,313,6351,912,240,270,202,290,1914,0.175115207373272,0.810810810810811,0.862619808306709,0.914027149321267,0.926517571884984,0.301369863013699
E02004969,Stanborough,Watford,East of England,1506,4408,313,271,207,386,5585,1503,5239,344,274,243,347,6447,895,296,240,228,322,1981,0.170834128650506,0.86046511627907,0.875912408759124,0.938271604938272,0.927953890489914,0.307274701411509
E02004970,Garston,Watford,East of England,1977,4884,323,318,244,434,6203,1995,5831,373,329,247,405,7185,1011,302,296,225,385,2219,0.173383639169954,0.809651474530831,0.899696048632219,0.910931174089069,0.950617283950617,0.30883785664579
E02004971,Leggatts,Watford,East of England,1917,5043,284,231,178,286,6022,2040,6196,292,245,219,289,7241,1113,244,219,191,262,2029,0.179632020658489,0.835616438356164,0.893877551020408,0.872146118721461,0.906574394463668,0.280209915757492
E02004972,Tudor,Watford,East of England,1146,3650,306,268,196,278,4698,1226,4217,332,272,214,295,5330,772,287,261,198,273,1791,0.183068532131847,0.864457831325301,0.959558823529412,0.925233644859813,0.925423728813559,0.336022514071295
E02004973,North Watford,Watford,East of England,1841,5471,212,180,94,145,6102,1884,6698,249,218,96,146,7407,995,185,181,82,125,1568,0.148551806509406,0.742971887550201,0.830275229357798,0.854166666666667,0.856164383561644,0.211691643040367
E02004974,Nascot Wood,Watford,East of England,1789,5426,354,396,241,568,6985,1852,6273,351,398,303,545,7870,1001,303,364,281,506,2455,0.15957277219831,0.863247863247863,0.914572864321608,0.927392739273927,0.928440366972477,0.311944091486658
E02004975,Cassiobury,Watford,East of England,1725,4977,347,351,243,389,6307,1658,5674,366,371,289,399,7099,1056,317,331,267,381,2352,0.186112090236165,0.866120218579235,0.892183288409704,0.923875432525952,0.954887218045113,0.331314269615439
E02004976,Central Watford,Watford,East of England,2100,7471,237,196,163,258,8325,2133,9531,272,241,170,252,10466,1219,191,194,142,225,1971,0.127898436680306,0.702205882352941,0.804979253112033,0.835294117647059,0.892857142857143,0.188324097076247
E02004977,West Watford,Watford,East of England,2147,5828,212,186,144,206,6576,2188,8041,269,207,145,191,8853,1303,177,165,114,161,1920,0.162044521825644,0.657992565055762,0.797101449275362,0.786206896551724,0.842931937172775,0.216875635377838
E02004978,Holywell,Watford,East of England,2302,6160,301,206,163,258,7088,2464,8081,348,250,187,336,9202,1367,269,210,162,291,2299,0.169162232396981,0.772988505747127,0.84,0.866310160427808,0.866071428571429,0.24983699195827
E02004979,Oxhey,Watford,East of England,1417,4220,340,320,215,288,5383,1406,5108,383,341,243,272,6347,998,337,304,219,248,2106,0.195379796397807,0.879895561357702,0.89149560117302,0.901234567901234,0.911764705882353,0.331810304080668
E02005503,"Bawdeswell, Swanton Morley & North Elmham",Breckland,East of England,1256,4089,530,597,365,583,6164,1232,4320,533,560,426,556,6395,894,451,534,410,530,2819,0.206944444444444,0.846153846153846,0.953571428571429,0.962441314553991,0.953237410071942,0.440813135261923
E02005504,"Whissonsett, Litcham & Narborough",Breckland,East of England,1447,4915,721,762,532,733,7663,1418,5169,700,772,614,724,7979,1285,639,730,575,669,3898,0.248597407622364,0.912857142857143,0.94559585492228,0.936482084690554,0.924033149171271,0.488532397543552
E02005505,Dereham North & Neatherd,Breckland,East of England,1383,4183,462,525,366,681,6217,1339,4463,438,489,417,658,6465,1029,316,463,399,618,2825,0.230562401971768,0.721461187214612,0.946830265848671,0.956834532374101,0.939209726443769,0.436968290796597
E02005506,"Dereham West, Necton & Gressenhall",Breckland,East of England,1110,3860,555,517,391,510,5833,1082,4077,507,545,410,510,6049,1000,443,502,389,484,2818,0.245278390973755,0.873767258382643,0.921100917431193,0.948780487804878,0.949019607843137,0.465862125971235
E02005507,Dereham Central & Toftwood,Breckland,East of England,2091,6906,676,789,583,819,9773,2005,6980,665,759,621,817,9842,1632,487,724,597,791,4231,0.233810888252149,0.732330827067669,0.953886693017128,0.961352657004831,0.968176254589963,0.429892298313351
E02005508,"Hockering, Mattishall & Cranworth",Breckland,East of England,1079,3954,528,635,364,447,5928,1061,4311,563,633,438,481,6426,1040,445,590,418,459,2952,0.241243331013686,0.790408525754885,0.932069510268562,0.954337899543379,0.954261954261954,0.459383753501401
E02005509,Swaffham,Breckland,East of England,1311,4178,621,673,565,930,6967,1306,4573,644,699,590,919,7425,1122,559,653,568,884,3786,0.245353159851301,0.868012422360249,0.934191702432046,0.96271186440678,0.961915125136017,0.50989898989899
E02005510,"Shipdham, Bradenham & Saham Toney",Breckland,East of England,1005,3703,552,732,412,619,6018,988,4025,598,673,521,596,6413,954,495,637,501,569,3156,0.237018633540373,0.827759197324415,0.946508172362556,0.961612284069098,0.954697986577181,0.492125370341494
E02005511,Watton,Breckland,East of England,1206,4575,528,646,487,806,7042,1315,5227,534,705,565,803,7834,992,470,657,549,762,3430,0.189783814807729,0.880149812734083,0.931914893617021,0.971681415929203,0.948941469489415,0.437835077865714
E02005512,"Wayland, Ellingham & Great Hockham",Breckland,East of England,1604,5875,602,614,364,391,7846,1629,6463,594,647,387,445,8536,1232,486,611,373,420,3122,0.190623549435247,0.818181818181818,0.94435857805255,0.963824289405685,0.943820224719101,0.365745079662605
E02005513,Attleborough,Breckland,East of England,1712,5870,550,610,463,748,8241,1814,6571,567,653,536,709,9036,1254,433,630,516,685,3518,0.190838532947801,0.763668430335097,0.964777947932619,0.962686567164179,0.966149506346968,0.389331562638336
E02005514,"Mundford, Weeting & Forest",Breckland,East of England,1061,3930,527,612,332,441,5842,982,3811,482,598,385,445,5721,943,429,561,365,423,2721,0.247441616373655,0.890041493775934,0.938127090301003,0.948051948051948,0.950561797752809,0.475616151022549
E02005515,Buckenhams & Snetterton,Breckland,East of England,1135,3744,424,415,283,423,5289,1069,3950,448,409,301,437,5545,803,387,394,296,426,2306,0.203291139240506,0.863839285714286,0.963325183374083,0.983388704318937,0.974828375286041,0.415870153291253
E02005516,"East Harling, Garboldisham & Kenninghall",Breckland,East of England,1196,3824,534,560,352,442,5712,1139,4133,523,589,361,489,6095,894,461,567,350,466,2738,0.216307766755383,0.881453154875717,0.962648556876061,0.969529085872576,0.952965235173824,0.449220672682527
E02005517,Thetford North,Breckland,East of England,1638,4087,255,203,149,201,4895,1535,4819,251,229,148,197,5644,909,201,206,134,178,1628,0.188628346129903,0.800796812749004,0.899563318777293,0.905405405405405,0.903553299492386,0.288447909284196
E02005518,Thetford Central & East,Breckland,East of England,2056,7316,515,512,397,595,9335,2000,7808,523,531,370,588,9820,1673,462,497,356,558,3546,0.214267418032787,0.883365200764818,0.935969868173258,0.962162162162162,0.948979591836735,0.361099796334012
E02005519,Thetford South,Breckland,East of England,2075,5463,391,340,231,413,6838,2052,6485,385,357,256,389,7872,1327,328,327,235,359,2576,0.204626060138782,0.851948051948052,0.915966386554622,0.91796875,0.922879177377892,0.327235772357724
E02005520,Aylsham,Broadland,East of England,1406,4657,636,778,472,708,7251,1451,4949,598,791,575,743,7656,1362,497,763,562,712,3896,0.27520711254799,0.831103678929766,0.964601769911504,0.977391304347826,0.958277254374159,0.508881922675026
E02005521,"Reepham, Cawston & Lenwade",Broadland,East of England,1372,5112,659,701,421,516,7409,1295,5216,624,710,462,539,7551,1275,481,672,454,519,3401,0.24444018404908,0.770833333333333,0.946478873239437,0.982683982683983,0.962894248608534,0.450403920010595
E02005522,"Coltishall, Buxton & Frettenham",Broadland,East of England,916,3208,339,412,279,380,4618,867,3349,399,402,294,386,4830,864,334,380,278,372,2228,0.257987458942968,0.837092731829574,0.945273631840796,0.945578231292517,0.963730569948187,0.46128364389234
E02005523,"Horsford, Hainford & Hevingham",Broadland,East of England,1614,5172,507,480,343,354,6856,1538,5364,514,523,345,375,7121,1345,374,510,333,369,2931,0.250745712155108,0.727626459143969,0.975143403441683,0.965217391304348,0.984,0.411599494453026
E02005524,Spixworth & St Faiths,Broadland,East of England,865,3123,424,393,315,367,4622,802,3191,372,421,309,396,4689,831,324,406,301,388,2250,0.260419931056095,0.870967741935484,0.96437054631829,0.974110032362459,0.97979797979798,0.479846449136276
E02005525,Taverham,Broadland,East of England,1750,6241,541,611,429,592,8414,1619,6202,555,575,488,656,8476,1587,459,551,463,611,3671,0.255885198323122,0.827027027027027,0.958260869565217,0.948770491803279,0.93140243902439,0.433105238319962
E02005526,Drayton & Thorpe Marriott,Broadland,East of England,905,3103,319,327,219,475,4443,968,3322,319,355,256,469,4721,876,255,346,246,457,2180,0.26369656833233,0.799373040752351,0.974647887323944,0.9609375,0.974413646055437,0.461766574878204
E02005527,"Wroxham, Rackheath & the Plumsteads",Broadland,East of England,1608,5071,534,623,407,679,7314,1594,5373,520,616,472,710,7691,1177,461,582,460,679,3359,0.219058254234134,0.886538461538462,0.944805194805195,0.974576271186441,0.956338028169014,0.436744246521909
E02005528,Old Catton,Broadland,East of England,1362,5037,512,602,429,655,7235,1377,5168,478,586,446,624,7302,1121,422,560,431,605,3139,0.216911764705882,0.882845188284519,0.955631399317406,0.966367713004484,0.969551282051282,0.429882224048206
E02005529,Hellesdon North West,Broadland,East of England,843,3130,384,442,391,714,5061,816,3341,398,460,351,657,5207,825,366,445,346,639,2621,0.246932056270578,0.919597989949749,0.967391304347826,0.985754985754986,0.972602739726027,0.503360860380257
E02005530,Hellesdon South East,Broadland,East of England,829,3242,288,383,287,454,4654,858,3420,303,337,319,448,4827,773,270,327,312,433,2115,0.226023391812866,0.891089108910891,0.970326409495549,0.978056426332288,0.966517857142857,0.438160348042262
E02005531,Sprowston Central,Broadland,East of England,869,3255,327,380,240,376,4578,864,3378,320,339,248,418,4703,757,274,318,241,405,1995,0.224097098875074,0.85625,0.938053097345133,0.971774193548387,0.9688995215311,0.424197320859026
E02005532,Sprowston East,Broadland,East of England,1271,4621,535,653,433,769,7011,1503,5244,516,657,471,780,7668,1297,433,634,459,755,3578,0.247330282227307,0.839147286821705,0.964992389649924,0.974522292993631,0.967948717948718,0.466614501825769
E02005533,"Blofield, Lingwood & Upton",Broadland,East of England,1520,4911,656,686,526,618,7397,1480,5221,640,703,566,655,7785,1147,563,677,551,626,3564,0.219689714614059,0.8796875,0.963015647226173,0.973498233215548,0.955725190839695,0.457803468208093
E02005534,Thorpe St Andrew North,Broadland,East of England,1131,4189,467,507,358,629,6150,1070,4520,497,485,411,630,6543,1033,418,461,397,608,2917,0.22853982300885,0.841046277665996,0.950515463917526,0.965936739659367,0.965079365079365,0.445819960262876
E02005535,Thorpe St Andrew South & Dussindale,Broadland,East of England,1310,4579,382,351,216,405,5933,1257,4628,389,394,233,452,6096,982,329,376,224,426,2337,0.21218668971478,0.845758354755784,0.954314720812183,0.96137339055794,0.942477876106195,0.383366141732283
E02005536,Brundall & Cantley,Broadland,East of England,976,3500,449,469,359,463,5240,979,3733,457,497,378,509,5574,864,384,476,351,495,2570,0.231449236538977,0.840262582056893,0.957746478873239,0.928571428571429,0.972495088408644,0.461069250089702
E02005537,Acle & Reedham,Broadland,East of England,961,3354,424,482,312,517,5089,892,3489,382,477,353,507,5208,907,297,451,334,478,2467,0.259959873889367,0.777486910994765,0.945492662473795,0.946175637393768,0.942800788954635,0.473694316436252
E02005538,Hemsby & Ormesby,Great Yarmouth,East of England,1135,4816,880,925,583,729,7933,1236,5607,880,903,672,744,8806,1351,737,849,650,713,4300,0.240948813982522,0.8375,0.940199335548173,0.967261904761905,0.958333333333333,0.4883034294799
E02005539,"Fleggburgh, Rollesby & Martham",Great Yarmouth,East of England,1135,4207,638,608,444,502,6399,1162,4650,634,688,525,524,7021,1067,539,655,496,498,3255,0.229462365591398,0.850157728706625,0.95203488372093,0.944761904761905,0.950381679389313,0.463609172482552
E02005540,Caister on Sea,Great Yarmouth,East of England,1230,4703,694,871,631,866,7765,1166,5049,693,841,679,819,8081,1100,529,789,652,776,3846,0.217864923747277,0.763347763347763,0.938168846611177,0.960235640648012,0.947496947496948,0.47593119663408
E02005541,Yarmouth North,Great Yarmouth,East of England,1051,3385,356,402,289,441,4873,1105,3937,355,380,327,439,5438,746,261,350,307,405,2069,0.189484378968758,0.735211267605634,0.921052631578947,0.938837920489297,0.92255125284738,0.380470761309305
E02005542,Yarmouth Central & Northgate,Great Yarmouth,East of England,1495,4860,357,322,253,267,6059,1607,6113,362,349,221,279,7324,819,227,300,196,241,1783,0.133976770816293,0.62707182320442,0.859598853868195,0.886877828054299,0.863799283154122,0.243446204259967
E02005543,Yarmouth Parade,Great Yarmouth,East of England,2257,6231,368,322,241,288,7450,2383,8175,415,342,252,291,9475,1021,249,251,210,261,1992,0.124892966360856,0.6,0.733918128654971,0.833333333333333,0.896907216494845,0.21023746701847
E02005544,Southtown & Cobholm,Great Yarmouth,East of England,1757,4689,309,282,198,262,5740,1707,5232,316,296,211,220,6275,936,222,262,192,202,1814,0.178899082568807,0.70253164556962,0.885135135135135,0.909952606635071,0.918181818181818,0.289083665338645
E02005545,Bradwell North,Great Yarmouth,East of England,983,3458,458,559,428,465,5368,1009,3836,449,549,409,519,5762,974,393,522,399,499,2787,0.253910323253389,0.875278396436526,0.950819672131147,0.975550122249389,0.961464354527938,0.483686220062478
E02005546,Gorleston North,Great Yarmouth,East of England,1588,4614,458,462,332,438,6304,1553,5127,445,468,336,443,6819,1275,345,433,305,418,2776,0.248683440608543,0.775280898876405,0.925213675213675,0.907738095238095,0.943566591422122,0.407097814928875
E02005547,Gorleston South & Beach,Great Yarmouth,East of England,1587,5111,523,587,394,610,7225,1460,5516,535,532,426,641,7650,1345,431,496,409,597,3278,0.243836113125453,0.805607476635514,0.932330827067669,0.960093896713615,0.931357254290172,0.428496732026144
E02005548,Gorleston West,Great Yarmouth,East of England,1580,4195,421,408,312,582,5918,1530,4753,403,416,313,528,6413,1272,300,381,291,491,2735,0.267620450241953,0.744416873449132,0.915865384615385,0.929712460063898,0.929924242424242,0.426477467643848
E02005549,Belton,Great Yarmouth,East of England,773,2905,442,501,288,361,4497,802,3345,454,514,352,361,5026,942,363,487,331,345,2468,0.281614349775785,0.799559471365639,0.947470817120623,0.940340909090909,0.955678670360111,0.491046557898926
E02005550,Bradwell South & Hopton,Great Yarmouth,East of England,1207,4119,471,531,376,530,6027,1266,4601,472,551,407,581,6612,1151,380,517,383,556,2987,0.25016300804173,0.805084745762712,0.938294010889292,0.941031941031941,0.95697074010327,0.451754385964912
E02005551,Hunstanton,King's Lynn and West Norfolk,East of England,532,2318,565,659,415,757,4714,516,2434,492,654,454,744,4778,688,417,619,432,719,2875,0.28266228430567,0.847560975609756,0.946483180428135,0.951541850220264,0.966397849462366,0.601716199246547
E02005552,"Brancaster, Burnham Market & Docking",King's Lynn and West Norfolk,East of England,960,3377,650,690,488,625,5830,858,3515,579,643,498,638,5873,898,536,614,473,616,3137,0.25547652916074,0.92573402417962,0.954898911353033,0.949799196787149,0.96551724137931,0.534139281457517
E02005553,Heacham & Snettisham,King's Lynn and West Norfolk,East of England,1041,3980,809,1121,713,968,7591,1031,4292,775,1071,823,982,7943,1133,723,1034,794,943,4627,0.263979496738117,0.932903225806452,0.965452847805789,0.964763061968408,0.960285132382892,0.582525494145789
E02005554,"Dersingham, Sandringham & Massingham",King's Lynn and West Norfolk,East of England,940,3354,597,747,540,727,5965,884,3562,579,716,583,740,6180,1090,480,681,565,719,3535,0.306007860752386,0.829015544041451,0.951117318435754,0.969125214408233,0.971621621621622,0.572006472491909
E02005555,Wootton,King's Lynn and West Norfolk,East of England,1132,3655,556,513,402,589,5715,1062,3939,511,543,435,571,5999,1060,476,531,421,548,3036,0.269103833460269,0.931506849315068,0.977900552486188,0.967816091954023,0.959719789842382,0.506084347391232
E02005556,Gaywood North Bank,King's Lynn and West Norfolk,East of England,1386,4379,427,467,284,465,6022,1363,4889,421,460,361,527,6658,1315,380,438,347,509,2989,0.268971159746369,0.902612826603325,0.952173913043478,0.961218836565097,0.96584440227704,0.448933613697807
E02005557,North Lynn,King's Lynn and West Norfolk,East of England,1615,4190,248,223,171,208,5040,1673,5316,241,228,166,196,6147,858,173,194,154,170,1549,0.161399548532731,0.717842323651452,0.850877192982456,0.927710843373494,0.86734693877551,0.251992842036766
E02005558,Terrington & Clenchwarton,King's Lynn and West Norfolk,East of England,1219,3925,489,565,376,513,5868,1160,4337,522,523,419,526,6327,1118,424,498,409,509,2958,0.257781876873415,0.812260536398467,0.952198852772467,0.976133651551313,0.967680608365019,0.467520151730678
E02005559,Gaywood Chase & Old Gaywood,King's Lynn and West Norfolk,East of England,1424,4483,372,322,251,414,5842,1386,5259,379,356,249,444,6687,1133,311,328,237,424,2433,0.215440197756227,0.820580474934037,0.921348314606742,0.951807228915663,0.954954954954955,0.363840287124271
E02005560,Fairstead & Springwood,King's Lynn and West Norfolk,East of England,2147,5817,350,326,262,302,7057,2134,6532,387,315,256,300,7790,1771,314,285,231,274,2875,0.27112676056338,0.811369509043928,0.904761904761905,0.90234375,0.913333333333333,0.369062901155327
E02005561,"Town, South Lynn & West Lynn",King's Lynn and West Norfolk,East of England,2208,7242,473,469,348,473,9005,2158,8426,486,470,367,518,10267,1483,348,410,340,480,3061,0.176002848326608,0.716049382716049,0.872340425531915,0.926430517711172,0.926640926640927,0.298139670789909
E02005562,"Grimston, Gayton & East Winch",King's Lynn and West Norfolk,East of England,1137,3952,543,627,411,480,6013,1139,4415,521,627,447,505,6515,1510,486,586,435,486,3503,0.342015855039638,0.932821497120921,0.934609250398724,0.973154362416107,0.962376237623762,0.537682271680737
E02005563,"Marshland, Walpole & Walton",King's Lynn and West Norfolk,East of England,1299,4332,522,544,383,471,6252,1387,5055,538,573,403,517,7086,1013,397,533,382,472,2797,0.200395647873393,0.737918215613383,0.930191972076789,0.947890818858561,0.912959381044487,0.394721987016653
E02005564,"West Winch, Marham & Shouldham",King's Lynn and West Norfolk,East of England,1901,5738,604,612,485,590,8029,1529,5970,600,627,505,667,8369,1285,520,605,484,647,3541,0.215242881072027,0.866666666666667,0.964912280701754,0.958415841584158,0.970014992503748,0.423109093081611
E02005565,"Watlington, Wiggenhall & Terrington St John",King's Lynn and West Norfolk,East of England,1216,4073,457,502,341,407,5780,1220,4534,457,473,365,444,6273,1113,346,452,351,415,2677,0.24547860608734,0.75711159737418,0.955602536997886,0.961643835616438,0.934684684684685,0.426749561613263
E02005566,"Upwell, Delph & Emneth",King's Lynn and West Norfolk,East of England,1715,5620,684,693,483,652,8132,1773,6507,720,694,544,661,9126,1246,610,658,515,625,3654,0.19148609190103,0.847222222222222,0.948126801152738,0.946691176470588,0.94553706505295,0.400394477317554
E02005567,Downham Market,King's Lynn and West Norfolk,East of England,1921,5724,657,806,698,1199,9084,1830,6162,682,796,694,1234,9568,1257,606,765,660,1198,4486,0.203992210321324,0.888563049853372,0.96105527638191,0.951008645533141,0.970826580226904,0.468854515050167
E02005568,"Stoke Ferry, Hilgay & Wimbotsham",King's Lynn and West Norfolk,East of England,1263,4038,576,581,427,538,6160,1111,4405,528,591,415,571,6510,932,457,552,391,539,2871,0.211577752553916,0.865530303030303,0.934010152284264,0.942168674698795,0.943957968476357,0.441013824884793
E02005569,"Southery, Feltwell & Hockwold",King's Lynn and West Norfolk,East of England,1579,4882,523,525,326,393,6649,1265,4715,551,525,376,468,6635,1024,420,487,357,448,2736,0.217179215270414,0.762250453720508,0.927619047619048,0.949468085106383,0.957264957264957,0.412358703843255
E02005570,Sheringham,North Norfolk,East of England,943,3453,660,727,587,995,6422,878,3534,578,758,609,942,6421,767,521,731,588,913,3520,0.217034521788342,0.901384083044983,0.964379947229551,0.96551724137931,0.969214437367304,0.548201214764056
E02005571,Wells & Blakeney,North Norfolk,East of England,746,2974,584,599,407,680,5244,747,3174,544,558,450,668,5394,600,484,526,432,647,2689,0.189035916824197,0.889705882352941,0.942652329749104,0.96,0.968562874251497,0.49851687059696
E02005572,Cromer,North Norfolk,East of England,949,4005,675,741,492,876,6789,948,4102,646,788,587,822,6945,1003,512,742,556,774,3587,0.244514870794734,0.792569659442725,0.941624365482233,0.947189097103918,0.941605839416058,0.516486681065515
E02005573,Holt & Weybourne,North Norfolk,East of England,746,2699,550,593,503,783,5128,790,2969,492,626,513,800,5400,558,444,603,494,778,2877,0.187942068036376,0.902439024390244,0.963258785942492,0.962962962962963,0.9725,0.532777777777778
E02005574,"Overstrand, Roughton & the Runtons",North Norfolk,East of England,843,3810,658,707,476,623,6274,843,3790,671,692,503,634,6290,927,540,655,477,595,3194,0.244591029023747,0.804769001490313,0.946531791907514,0.94831013916501,0.938485804416404,0.507790143084261
E02005575,"Beeston Regis, Saxthorpe & Aldborough",North Norfolk,East of England,1057,3818,657,672,404,561,6112,947,3955,632,698,469,565,6319,856,527,667,452,546,3048,0.216434892541087,0.833860759493671,0.955587392550143,0.963752665245203,0.966371681415929,0.482354802975154
E02005576,"Mundesley, Trunch & Bacton",North Norfolk,East of England,870,3380,592,707,493,688,5860,858,3572,612,713,499,648,6044,868,465,683,474,631,3121,0.243001119820829,0.759803921568627,0.957924263674614,0.949899799599198,0.973765432098766,0.516379880873594
E02005577,"Melton Constable, Briston & Little Snoring",North Norfolk,East of England,913,3417,496,534,307,417,5171,849,3408,470,544,351,450,5223,700,413,515,339,437,2404,0.205399061032864,0.878723404255319,0.946691176470588,0.965811965811966,0.971111111111111,0.460271874401685
E02005578,Walsingham & Raynham,North Norfolk,East of England,961,3399,413,434,284,352,4882,953,3631,398,435,324,362,5150,752,353,403,300,351,2159,0.207105480583861,0.886934673366834,0.926436781609195,0.925925925925926,0.969613259668508,0.419223300970874
E02005579,North Walsham,North Norfolk,East of England,2044,6994,886,1024,669,1284,10857,1950,7305,820,999,769,1248,11141,1995,568,948,756,1215,5482,0.273100616016427,0.692682926829268,0.948948948948949,0.983094928478543,0.973557692307692,0.492056368369087
E02005580,Fakenham,North Norfolk,East of England,1238,4301,557,592,485,764,6699,1197,4506,545,624,509,748,6932,950,507,596,487,732,3272,0.210830004438526,0.930275229357798,0.955128205128205,0.956777996070727,0.978609625668449,0.47201384881708
E02005581,"Felmingham, Worstead & Happisburgh",North Norfolk,East of England,1133,5067,653,637,421,451,7229,1059,4945,647,633,417,427,7069,1118,492,601,404,398,3013,0.226086956521739,0.760432766615147,0.949447077409163,0.968824940047962,0.93208430913349,0.426227189135663
E02005582,Stalham & Sea Palling,North Norfolk,East of England,1071,3862,544,570,375,569,5920,978,3851,544,564,417,578,5954,779,403,524,396,541,2643,0.202285120747858,0.740808823529412,0.929078014184397,0.949640287769784,0.93598615916955,0.443903258313739
E02005583,"Hoveton, Horning & Potter Heigham",North Norfolk,East of England,982,4390,835,934,634,961,7754,1002,4635,806,916,693,964,8014,1019,663,876,655,935,4148,0.219848975188781,0.82258064516129,0.956331877729258,0.945165945165945,0.969917012448133,0.517594210132269
E02005584,Catton Grove & Airport,Norwich,East of England,2185,7155,447,421,303,444,8770,2312,8171,515,444,308,399,9837,1542,436,396,285,373,3032,0.18871619140864,0.846601941747573,0.891891891891892,0.925324675324675,0.93483709273183,0.308224052048389
E02005585,Mile Cross,Norwich,East of England,2503,7133,390,369,282,340,8514,2474,8320,416,368,294,353,9751,1345,327,332,270,336,2610,0.161658653846154,0.786057692307692,0.902173913043478,0.918367346938776,0.951841359773371,0.267664854886678
E02005586,New Catton & Mousehold North,Norwich,East of England,1742,7143,321,286,194,203,8147,1674,8091,404,334,205,260,9294,1614,320,306,193,243,2676,0.199480904708936,0.792079207920792,0.916167664670659,0.941463414634146,0.934615384615385,0.287927695287282
E02005587,Heartsease & Pilling Park,Norwich,East of England,2126,5967,379,411,389,713,7859,2164,7180,407,430,360,682,9059,1511,336,392,345,656,3240,0.210445682451253,0.825552825552826,0.911627906976744,0.958333333333333,0.961876832844575,0.357655370349928
E02005588,Bowthorpe & West Earlham,Norwich,East of England,2316,8265,451,399,270,353,9738,2549,9350,503,491,323,464,11131,2295,386,453,298,435,3867,0.245454545454545,0.767395626242545,0.922606924643584,0.922600619195046,0.9375,0.34740813943042
E02005589,Earlham,Norwich,East of England,2454,7908,405,397,252,425,9387,2629,8986,432,443,292,394,10547,1964,352,401,281,372,3370,0.218562207878923,0.814814814814815,0.905191873589165,0.962328767123288,0.944162436548223,0.319522138996871
E02005590,City Centre West,Norwich,East of England,1288,7895,487,505,332,579,9798,1376,9772,539,502,393,484,11690,1552,414,452,346,450,3214,0.158821121571838,0.768089053803339,0.900398406374502,0.880407124681934,0.929752066115702,0.274935842600513
E02005592,Earlham Road & College Road,Norwich,East of England,1340,6885,403,343,182,241,8054,1293,7304,445,406,217,293,8665,1307,376,366,201,279,2529,0.1789430449069,0.844943820224719,0.901477832512315,0.926267281105991,0.95221843003413,0.291863819965378
E02005593,University & Avenues,Norwich,East of England,1347,9929,306,244,186,402,11067,1331,13636,281,262,191,368,14738,1922,237,244,179,354,2936,0.140950425344676,0.843416370106761,0.931297709923664,0.93717277486911,0.96195652173913,0.199212918984937
E02005594,Town Close,Norwich,East of England,1522,7573,576,523,361,550,9583,1473,8442,616,588,371,564,10581,1466,505,553,343,535,3402,0.173655531864487,0.819805194805195,0.940476190476191,0.924528301886792,0.948581560283688,0.32151970513184
E02005595,Eaton,Norwich,East of England,1443,4887,524,635,534,929,7509,1516,5829,591,647,571,878,8516,1369,539,616,552,857,3933,0.234860181849374,0.912013536379019,0.952086553323029,0.966725043782837,0.976082004555809,0.461836542977924
E02005596,Lakenham & Tuckswood,Norwich,East of England,1957,5643,404,458,312,596,7413,2079,6814,460,487,321,505,8587,1551,387,449,304,483,3174,0.227619606692105,0.841304347826087,0.921971252566735,0.947040498442368,0.956435643564356,0.369628508210085
E02006907,City Centre East,Norwich,East of England,644,5237,212,230,184,289,6152,668,5923,262,237,219,315,6956,871,214,214,200,297,1796,0.14705385784231,0.816793893129771,0.90295358649789,0.91324200913242,0.942857142857143,0.258194364577343
E02006908,Thorpe Hamlet & Mousehold South,Norwich,East of England,902,3939,281,253,122,218,4813,755,4063,293,247,163,186,4952,742,240,218,156,178,1534,0.182623677085897,0.819112627986348,0.882591093117409,0.957055214723926,0.956989247311828,0.309773828756058
E02005597,Costessey & Queens Hills,South Norfolk,East of England,3414,10296,737,798,576,839,13246,3309,10561,725,836,615,852,13589,2732,605,792,591,815,5535,0.258687624278004,0.83448275862069,0.947368421052632,0.960975609756098,0.956572769953052,0.407314739863125
E02005598,"Cringleford, Little Melton & Easton",South Norfolk,East of England,2072,5825,494,545,418,623,7905,2029,6174,519,577,432,673,8375,1635,432,545,412,652,3676,0.264820213799806,0.832369942196532,0.944540727902946,0.953703703703704,0.968796433878157,0.438925373134328
E02005599,Hethersett,South Norfolk,East of England,1234,3643,417,445,336,494,5335,1347,4102,395,467,374,489,5827,1032,327,450,354,483,2646,0.251584592881521,0.827848101265823,0.963597430406852,0.946524064171123,0.987730061349693,0.454093015273726
E02005600,"Hingham, Morley & Barnham Broom",South Norfolk,East of England,1363,3716,410,455,303,388,5272,1402,3916,415,460,355,421,5567,878,330,447,346,403,2404,0.224208375893769,0.795180722891566,0.971739130434783,0.974647887323944,0.957244655581948,0.43183042931561
E02005601,Wymondham West,South Norfolk,East of England,757,3252,336,497,329,502,4916,702,3257,351,454,398,542,5002,776,276,438,387,516,2393,0.23825606386245,0.786324786324786,0.964757709251101,0.972361809045226,0.952029520295203,0.478408636545382
E02005602,"Trowse, Poringland & Stoke Holy Cross",South Norfolk,East of England,2147,6999,772,812,615,940,10138,2128,7603,755,871,681,932,10842,1789,593,834,664,910,4790,0.235301854531106,0.785430463576159,0.95752009184845,0.97503671071953,0.976394849785408,0.441800405829183
E02005603,Wymondham East & Spooner Row,South Norfolk,East of England,2672,7011,551,535,396,487,8980,2749,7948,532,591,427,596,10094,1809,429,561,414,569,3782,0.227604428787116,0.806390977443609,0.949238578680203,0.969555035128806,0.954697986577181,0.374678026550426
E02005604,"Loddon, Surlingham & Alpington",South Norfolk,East of England,1418,4862,593,595,458,674,7182,1379,5227,608,632,507,671,7645,1176,469,607,490,652,3394,0.224985651425292,0.771381578947369,0.960443037974684,0.96646942800789,0.971684053651267,0.443950294310007
E02005605,"Mulbarton, Tasburgh & Saxlingham Nethergate",South Norfolk,East of England,1956,6272,680,710,526,633,8821,1874,6384,743,686,564,676,9053,1506,603,672,540,657,3978,0.235902255639098,0.81157469717362,0.979591836734694,0.957446808510638,0.97189349112426,0.439412349497404
E02005606,"Thurlton, Haddiscoe & Geldeston",South Norfolk,East of England,928,3411,451,417,283,358,4920,833,3536,444,449,333,346,5108,841,346,430,316,335,2268,0.237839366515837,0.779279279279279,0.957683741648107,0.948948948948949,0.968208092485549,0.444009397024276
E02005607,"Long Stratton, Carlton Rode & Tibenham",South Norfolk,East of England,2027,6800,735,842,483,674,9534,1956,6952,712,816,580,674,9734,1674,552,786,561,651,4224,0.240794016110472,0.775280898876405,0.963235294117647,0.967241379310345,0.965875370919881,0.433942880624615
E02005608,"Hempnall, Ditchingham & Wortwell",South Norfolk,East of England,1162,4336,577,662,410,609,6594,1078,4458,601,653,457,586,6755,1070,448,626,437,565,3146,0.240017945266936,0.745424292845258,0.958652373660031,0.956236323851203,0.964163822525597,0.465729089563286
E02005609,Harleston & Pulham,South Norfolk,East of England,1334,4016,506,621,414,635,6192,1262,4194,498,620,454,652,6418,900,345,585,439,623,2892,0.214592274678112,0.692771084337349,0.943548387096774,0.966960352422907,0.955521472392638,0.450607665939545
E02005610,"Scole, Dickleburgh & Bressingham",South Norfolk,East of England,1227,4619,635,720,399,562,6935,1120,4717,617,717,463,561,7075,1054,497,690,438,544,3223,0.223447106211575,0.805510534846029,0.96234309623431,0.946004319654428,0.96969696969697,0.455547703180212
E02005611,Diss & Roydon,South Norfolk,East of England,1846,6451,680,697,573,952,9353,1753,6726,659,716,594,978,9673,1273,498,674,562,939,3946,0.189265536723164,0.755690440060698,0.941340782122905,0.946127946127946,0.960122699386503,0.407939625762432
E02006227,"Lavenham, Bildeston & Brettenham",Babergh,East of England,823,3399,572,546,396,534,5447,815,3524,556,616,414,540,5650,1042,515,588,399,516,3060,0.295686719636776,0.926258992805755,0.954545454545455,0.963768115942029,0.955555555555556,0.541592920353982
E02006228,Glemsford & Lawshall,Babergh,East of England,1044,3545,439,457,286,350,5077,998,3674,418,484,339,364,5279,974,380,454,321,342,2471,0.265106151333696,0.909090909090909,0.93801652892562,0.946902654867257,0.93956043956044,0.468081075961356
E02006229,North Sudbury & Long Melford,Babergh,East of England,859,3225,460,537,370,486,5078,844,3415,465,543,443,547,5413,1076,417,516,418,521,2948,0.315080527086384,0.896774193548387,0.950276243093923,0.943566591422122,0.952468007312614,0.544614816183263
E02006230,Hadleigh,Babergh,East of England,2126,6064,724,757,549,928,9022,1974,6372,693,810,626,923,9424,1626,641,776,608,893,4544,0.255178907721281,0.924963924963925,0.958024691358025,0.971246006389776,0.967497291440953,0.482173174872666
E02006231,"Sproughton, Washbrook & Hintlesham",Babergh,East of England,1459,5300,530,530,324,476,7160,1377,5382,542,490,372,448,7234,1431,493,464,352,430,3170,0.265886287625418,0.909594095940959,0.946938775510204,0.946236559139785,0.959821428571429,0.438208460049765
E02006232,"Acton, Great Waldingfield & Bures",Babergh,East of England,1022,3413,477,441,346,408,5085,960,3482,448,512,372,392,5206,1093,423,491,362,380,2749,0.313900057438254,0.944196428571429,0.958984375,0.973118279569892,0.969387755102041,0.528044563964656
E02006233,Sudbury,Babergh,East of England,1955,6875,667,750,584,959,9835,1779,7176,638,710,634,962,10120,1959,569,674,611,917,4730,0.272993311036789,0.891849529780564,0.949295774647887,0.963722397476341,0.953222453222453,0.467391304347826
E02006234,Great Cornard,Babergh,East of England,1922,5900,484,603,400,442,7829,1974,6254,456,576,417,500,8203,1782,419,559,402,484,3646,0.284937639910457,0.918859649122807,0.970486111111111,0.964028776978417,0.968,0.44447153480434
E02006235,"Leavenheath, Nayland & Boxford",Babergh,East of England,1356,4484,612,668,429,651,6844,1255,4838,563,681,497,638,7217,1071,516,655,476,610,3328,0.221372467961968,0.91651865008881,0.961820851688693,0.957746478873239,0.956112852664577,0.461133434945268
E02006236,"East Bergholt, Brantham & Capel St Mary",Babergh,East of England,1738,5620,728,899,588,789,8624,1618,6109,730,864,681,802,9186,1523,683,837,667,782,4492,0.249304305123588,0.935616438356164,0.96875,0.979441997063142,0.975062344139651,0.489005007620292
E02006237,Shotley Peninsula,Babergh,East of England,1329,4354,492,548,383,625,6402,1271,4498,505,548,402,626,6579,1222,467,518,385,592,3184,0.271676300578035,0.924752475247525,0.945255474452555,0.95771144278607,0.945686900958466,0.483964128286974
E02006245,Whitton,Ipswich,East of England,1656,4450,406,423,326,517,6122,1777,5122,447,408,382,569,6928,1403,391,377,363,522,3056,0.273916438891058,0.874720357941835,0.924019607843137,0.950261780104712,0.917398945518453,0.441108545034642
E02006246,Castle Hill,Ipswich,East of England,1230,4096,447,449,292,526,5810,1315,4655,443,443,309,512,6362,1444,407,413,292,486,3042,0.310204081632653,0.918735891647855,0.932279909706546,0.944983818770227,0.94921875,0.478151524677774
E02006247,Whitehouse,Ipswich,East of England,2005,5683,362,356,226,283,6910,2119,6113,356,387,244,322,7422,1485,300,357,225,299,2666,0.242924914117455,0.842696629213483,0.922480620155039,0.922131147540984,0.928571428571429,0.359202371328483
E02006248,Rushmere,Ipswich,East of England,1776,4781,380,413,295,464,6333,1864,5561,405,410,298,443,7117,1644,361,387,282,424,3098,0.295630282323323,0.891358024691358,0.94390243902439,0.946308724832215,0.957110609480813,0.435295770689898
E02006249,Christchurch Park,Ipswich,East of England,1515,4933,448,455,260,574,6670,1586,6062,466,466,321,570,7885,1650,422,431,303,531,3337,0.272187396898713,0.905579399141631,0.924892703862661,0.94392523364486,0.931578947368421,0.423208623969562
E02006250,Westgate,Ipswich,East of England,2200,7683,372,257,186,247,8745,2445,9102,364,295,194,223,10178,1501,273,248,172,182,2376,0.164908811250275,0.75,0.840677966101695,0.88659793814433,0.816143497757848,0.233444684613873
E02006251,Ipswich Central,Ipswich,East of England,1991,7948,322,256,157,254,8937,2106,9557,366,303,169,259,10654,1790,288,265,150,220,2713,0.187297269017474,0.786885245901639,0.874587458745875,0.887573964497041,0.849420849420849,0.254646142293974
E02006252,California,Ipswich,East of England,1991,5820,378,349,236,495,7278,2006,6681,394,368,285,460,8188,2002,344,337,265,427,3375,0.299655740158659,0.873096446700508,0.915760869565217,0.929824561403509,0.928260869565217,0.41218856863703
E02006253,Broke Hall,Ipswich,East of England,1136,3740,505,486,349,679,5759,1233,4472,463,522,371,651,6479,1508,431,487,348,619,3393,0.337209302325581,0.930885529157667,0.932950191570881,0.93800539083558,0.950844854070661,0.523691927766631
E02006254,Gipping & Chantry Park,Ipswich,East of England,1973,6173,399,298,236,420,7526,2169,7298,409,317,229,420,8673,1376,341,272,205,383,2577,0.188544806796383,0.833740831295844,0.858044164037855,0.895196506550218,0.911904761904762,0.297129021099965
E02006255,Holywells,Ipswich,East of England,1490,5632,329,308,159,290,6718,1594,6546,358,337,199,316,7756,1345,314,293,180,286,2418,0.205468988695386,0.877094972067039,0.869436201780416,0.904522613065327,0.905063291139241,0.31175863847344
E02006256,"Maidenhall, Stoke & Port",Ipswich,East of England,2162,6285,414,340,208,345,7592,2307,7203,408,361,231,351,8554,1517,321,319,207,325,2689,0.210606691656254,0.786764705882353,0.883656509695291,0.896103896103896,0.925925925925926,0.314355856909048
E02006257,Belstead Hills,Ipswich,East of England,1245,3675,361,382,264,533,5215,1330,4161,396,363,294,513,5727,1219,361,332,275,495,2682,0.2929584234559,0.911616161616162,0.914600550964187,0.935374149659864,0.964912280701754,0.468308014667365
E02006258,Priory Heath,Ipswich,East of England,2025,5738,437,293,252,337,7057,2173,6646,396,387,238,391,8058,1589,348,355,213,354,2859,0.239091182666265,0.878787878787879,0.917312661498708,0.894957983193277,0.90537084398977,0.354802680565897
E02006259,Stoke Park,Ipswich,East of England,1505,4121,415,438,256,365,5595,1579,4526,447,434,305,342,6054,1192,402,404,286,326,2610,0.26336721166593,0.899328859060403,0.930875576036866,0.937704918032787,0.953216374269006,0.431119920713578
E02006260,"Gainsborough, Greenwich & Orwell",Ipswich,East of England,2055,5168,490,384,238,411,6691,2084,5815,451,376,271,370,7283,1488,400,329,242,342,2801,0.255889939810834,0.886917960088692,0.875,0.892988929889299,0.924324324324324,0.384594260606893
E02006261,"Eye, Palgrave & Occold",Mid Suffolk,East of England,1243,4383,661,722,488,573,6827,1139,4667,620,744,497,635,7163,1199,562,701,470,614,3546,0.256910220698522,0.906451612903226,0.942204301075269,0.945674044265593,0.966929133858268,0.495043975987715
E02006262,"Rickinghall, Walsham le Willows & Gislingham",Mid Suffolk,East of England,1389,5201,695,762,476,595,7729,1334,5400,678,762,552,603,7995,1466,622,734,543,571,3936,0.271481481481482,0.91740412979351,0.963254593175853,0.983695652173913,0.946932006633499,0.492307692307692
E02006263,"Fressingfield, Laxfield & Worlingworth",Mid Suffolk,East of England,1181,4266,576,677,475,537,6531,1072,4299,561,656,503,562,6581,1254,504,634,488,541,3421,0.291695743196092,0.898395721925134,0.966463414634146,0.970178926441352,0.962633451957295,0.519829813098313
E02006264,"Thurston, Badwell Ash & Elmswell North",Mid Suffolk,East of England,1502,5137,549,542,405,537,7170,1457,5293,578,606,426,563,7466,1863,532,586,416,540,3937,0.351974305686756,0.920415224913495,0.966996699669967,0.976525821596244,0.959147424511545,0.527323868202518
E02006265,"Stowupland, Mendlesham & Bacton",Mid Suffolk,East of England,1165,4174,515,514,420,495,6118,1132,4331,521,533,437,522,6344,1229,479,507,421,511,3147,0.283768182867698,0.919385796545106,0.951219512195122,0.963386727688787,0.978927203065134,0.496059268600252
E02006266,"Elmswell South, Haughley, Beyton & Felsham",Mid Suffolk,East of England,1531,5440,717,779,524,662,8122,1382,5377,726,756,558,719,8136,2179,685,726,542,702,4834,0.40524456016366,0.943526170798898,0.96031746031746,0.971326164874552,0.976356050069541,0.594149459193707
E02006267,"Debenham, Stonham & Coddenham",Mid Suffolk,East of England,1440,5014,693,583,362,523,7175,1302,5241,673,675,403,529,7521,1399,627,646,391,506,3569,0.26693379126121,0.931649331352155,0.957037037037037,0.970223325062035,0.956521739130435,0.474537960377609
E02006268,Stowmarket West,Mid Suffolk,East of England,1189,3612,433,404,306,463,5218,1108,3914,395,440,313,549,5611,1068,362,417,303,523,2673,0.27286663260092,0.916455696202532,0.947727272727273,0.968051118210863,0.95264116575592,0.476385671003386
E02006269,"Stowmarket Outer, Finborough & Battisford",Mid Suffolk,East of England,1231,4482,488,456,317,534,6277,1215,4660,479,484,336,475,6434,1293,444,464,327,453,2981,0.277467811158798,0.926931106471816,0.958677685950413,0.973214285714286,0.953684210526316,0.463319863226609
E02006270,Stowmarket East & Needham Market North,Mid Suffolk,East of England,2764,8809,517,520,330,527,10703,2520,8803,539,514,365,517,10738,2155,486,486,349,489,3965,0.244802908099512,0.901669758812616,0.945525291828794,0.956164383561644,0.945841392649903,0.369249394673124
E02006271,Needham Market South & Great Blakenham,Mid Suffolk,East of England,1569,6094,551,601,407,526,8179,1587,6289,534,582,460,597,8462,1430,489,559,438,568,3484,0.227381141675942,0.915730337078652,0.960481099656357,0.952173913043478,0.95142378559464,0.41172299692744
E02006272,Claydon & Bramford,Mid Suffolk,East of England,1189,4320,563,598,393,579,6453,1118,4379,542,602,439,594,6556,1310,514,576,422,579,3401,0.299155058232473,0.948339483394834,0.956810631229236,0.96127562642369,0.974747474747475,0.51876143990238
E02004924,Harpenden North,St Albans,East of England,2075,4607,314,354,244,337,5856,1987,5210,295,336,260,355,6456,613,272,314,246,335,1780,0.117658349328215,0.922033898305085,0.934523809523809,0.946153846153846,0.943661971830986,0.275712515489467
E02004925,Harpenden East,St Albans,East of England,2152,4608,307,270,220,411,5816,2057,5332,331,278,224,387,6552,639,280,258,210,361,1748,0.119842460615154,0.845921450151057,0.928057553956835,0.9375,0.9328165374677,0.266788766788767
E02004926,Harpenden Town,St Albans,East of England,1926,4623,309,407,283,595,6217,1882,5456,329,409,326,613,7133,593,298,386,304,598,2179,0.108687683284457,0.905775075987842,0.943765281173594,0.932515337423313,0.975530179445351,0.305481564559092
E02004927,Wheathampstead,St Albans,East of England,1476,3639,341,396,245,439,5060,1499,4017,348,391,289,442,5487,546,326,371,286,424,1953,0.135922330097087,0.936781609195402,0.948849104859335,0.98961937716263,0.959276018099547,0.355932203389831
E02004928,Harpenden Common,St Albans,East of England,1473,3792,407,359,270,451,5279,1464,4542,376,391,296,424,6029,574,342,372,286,409,1983,0.126376045794804,0.909574468085106,0.951406649616368,0.966216216216216,0.964622641509434,0.328910267042627
E02004929,Redbourn,St Albans,East of England,1353,3586,323,404,297,440,5050,1364,4117,346,420,342,448,5673,622,319,401,327,432,2101,0.151080884138936,0.921965317919075,0.954761904761905,0.956140350877193,0.964285714285714,0.370350784417416
E02004930,Jersey Farm & Sandridge,St Albans,East of England,1428,4280,336,315,219,366,5516,1466,4811,345,317,257,367,6097,808,316,297,240,351,2012,0.167948451465392,0.915942028985507,0.936908517350158,0.933852140077821,0.956403269754768,0.329998359849106
E02004931,Marshalswick,St Albans,East of England,1558,3931,341,307,171,440,5190,1591,4648,352,317,207,396,5920,712,314,295,200,374,1895,0.153184165232358,0.892045454545455,0.930599369085174,0.966183574879227,0.944444444444444,0.320101351351351
E02004932,Townsend & New Greens,St Albans,East of England,1992,4800,294,261,189,252,5796,1879,5474,323,305,229,280,6611,812,281,282,205,263,1843,0.148337595907928,0.869969040247678,0.924590163934426,0.895196506550218,0.939285714285714,0.278777794584783
E02004933,Bernards Heath,St Albans,East of England,1733,4160,331,271,179,327,5268,1667,4723,330,295,211,328,5887,690,301,284,204,319,1798,0.146093584586068,0.912121212121212,0.96271186440678,0.966824644549763,0.972560975609756,0.305418719211823
E02004934,Clarence Park,St Albans,East of England,1768,5549,273,207,118,320,6467,1688,6206,283,268,155,298,7210,735,227,229,137,276,1604,0.118433773767322,0.802120141342756,0.854477611940298,0.883870967741936,0.926174496644295,0.22246879334258
E02004935,St Albans Central,St Albans,East of England,1716,6517,274,177,140,261,7369,1656,7437,304,224,168,277,8410,770,248,190,150,254,1612,0.103536372193089,0.81578947368421,0.848214285714286,0.892857142857143,0.916967509025271,0.191676575505351
E02004936,Longacres,St Albans,East of England,1656,4101,209,225,145,189,4869,1629,4676,249,219,152,201,5497,639,213,206,134,186,1378,0.136655260906758,0.855421686746988,0.940639269406393,0.881578947368421,0.925373134328358,0.25068219028561
E02004937,Verulam Park,St Albans,East of England,1490,4001,394,478,363,631,5867,1477,4641,421,453,383,614,6512,695,382,421,364,588,2450,0.149752208575738,0.907363420427554,0.929359823399558,0.950391644908616,0.957654723127036,0.376228501228501
E02004938,Colney Heath & Tyttenhanger,St Albans,East of England,1418,4092,238,263,166,241,5000,1346,4407,282,281,175,279,5424,685,244,259,165,260,1613,0.155434535965509,0.865248226950355,0.921708185053381,0.942857142857143,0.931899641577061,0.297382005899705
E02004939,The Camp & Cunningham,St Albans,East of England,1538,4273,277,286,209,407,5452,1515,4653,262,287,193,433,5828,690,221,265,176,401,1753,0.14829142488717,0.84351145038168,0.923344947735192,0.911917098445596,0.926096997690531,0.300789293067948
E02004940,Cottonmill & Sopwell,St Albans,East of England,1782,4758,287,220,194,338,5797,1879,5535,297,275,189,315,6611,700,243,246,167,293,1649,0.12646793134598,0.818181818181818,0.894545454545455,0.883597883597884,0.93015873015873,0.249432763575858
E02004941,London Colney,St Albans,East of England,2018,6259,478,366,244,363,7710,2010,7070,501,454,288,385,8698,1197,426,394,257,347,2621,0.169306930693069,0.850299401197605,0.86784140969163,0.892361111111111,0.901298701298701,0.301333639917222
E02004942,How Wood & Park Street,St Albans,East of England,1251,3727,357,375,324,411,5194,1225,4134,358,367,288,425,5572,890,324,348,277,401,2240,0.215287856797291,0.905027932960894,0.948228882833788,0.961805555555556,0.943529411764706,0.402010050251256
E02004943,Bricket Wood & Chiswell Green,St Albans,East of England,1468,4443,460,531,385,589,6408,1536,5274,482,543,439,624,7362,1061,432,503,420,591,3007,0.201175578308684,0.896265560165975,0.926335174953959,0.956719817767654,0.947115384615385,0.408448791089378
E02004980,"Woolmer Green, Oaklands & Digswell",Welwyn Hatfield,East of England,1036,3589,396,414,306,619,5324,1011,3944,367,399,319,429,5458,585,329,380,304,401,1999,0.148326572008114,0.896457765667575,0.952380952380952,0.952978056426332,0.934731934731935,0.366251374129718
E02004981,Welwyn & Hatfield Garden Village,Welwyn Hatfield,East of England,1549,4944,360,359,275,462,6400,1656,5476,370,399,286,465,6996,828,320,370,273,440,2231,0.151205259313367,0.864864864864865,0.927318295739348,0.954545454545455,0.946236559139785,0.318896512292739
E02004982,Knightsfield,Welwyn Hatfield,East of England,1325,3568,273,295,221,377,4734,1259,3911,257,298,235,377,5078,545,217,282,225,364,1633,0.139350549731526,0.844357976653697,0.946308724832215,0.957446808510638,0.96551724137931,0.321583300512013
E02004983,Haldens,Welwyn Hatfield,East of England,1315,3763,277,269,193,334,4836,1291,4043,324,258,204,339,5168,610,253,241,194,320,1618,0.150878060845907,0.780864197530864,0.934108527131783,0.950980392156863,0.943952802359882,0.313080495356037
E02004984,Panshanger,Welwyn Hatfield,East of England,1149,4130,354,262,199,358,5303,1059,4340,414,299,200,355,5608,697,335,279,186,320,1817,0.160599078341014,0.809178743961353,0.933110367892977,0.93,0.901408450704225,0.324001426533524
E02004985,Welwyn Garden City Central & Handside,Welwyn Hatfield,East of England,1236,4050,341,406,352,693,5842,1187,4397,371,418,344,648,6178,576,300,394,319,621,2210,0.130998408005458,0.808625336927224,0.942583732057416,0.927325581395349,0.958333333333333,0.357720945289738
E02004986,Peartree,Welwyn Hatfield,East of England,1996,5467,242,192,115,203,6219,1997,6465,284,216,141,193,7299,832,193,189,127,175,1516,0.128692962103635,0.679577464788732,0.875,0.900709219858156,0.906735751295337,0.207699684888341
E02004987,Hall Grove,Welwyn Hatfield,East of England,1779,4698,285,262,164,335,5744,1795,5196,283,271,173,311,6234,831,222,251,167,298,1769,0.159930715935335,0.784452296819788,0.92619926199262,0.965317919075144,0.958199356913183,0.283766442091755
E02004988,Hollybush,Welwyn Hatfield,East of England,1976,5036,295,226,194,293,6044,1851,5397,309,256,201,289,6452,768,236,227,176,272,1679,0.142301278488049,0.763754045307443,0.88671875,0.875621890547264,0.941176470588235,0.260229386236826
E02004989,Hatfield North & West,Welwyn Hatfield,East of England,2155,11007,322,298,201,320,12148,2032,9936,340,323,237,335,11171,1071,293,293,221,305,2183,0.107789855072464,0.861764705882353,0.907120743034056,0.932489451476793,0.91044776119403,0.195416703965625
E02004990,Hatfield East,Welwyn Hatfield,East of England,1251,4889,313,271,205,417,6095,1358,5320,325,324,206,401,6576,716,256,283,200,381,1836,0.134586466165414,0.787692307692308,0.873456790123457,0.970873786407767,0.950124688279302,0.279197080291971
E02004991,Hatfield Town,Welwyn Hatfield,East of England,1687,6585,206,166,139,287,7383,1620,6548,235,170,134,266,7353,785,198,151,126,240,1500,0.119883934025657,0.842553191489362,0.888235294117647,0.940298507462687,0.902255639097744,0.203998368013056
E02004992,Hatfield South,Welwyn Hatfield,East of England,1794,8811,207,193,164,311,9686,1675,10053,210,199,138,289,10889,921,152,179,121,267,1640,0.0916144434497165,0.723809523809524,0.899497487437186,0.876811594202899,0.923875432525952,0.150610708053999
E02004993,Welham Green,Welwyn Hatfield,East of England,966,3651,294,296,213,312,4766,956,3849,328,291,223,307,4998,603,289,277,213,291,1673,0.156664068589244,0.88109756097561,0.951890034364261,0.955156950672646,0.947882736156352,0.334733893557423
E02004994,Brookmans Park,Welwyn Hatfield,East of England,1090,3473,373,381,253,390,4870,1123,4124,341,336,280,419,5500,719,300,312,269,391,1991,0.174345295829292,0.879765395894428,0.928571428571429,0.960714285714286,0.933174224343675,0.362
E02004995,Cuffley & Northaw,Welwyn Hatfield,East of England,860,3093,323,356,279,434,4485,898,3421,365,346,275,497,4904,533,313,317,260,465,1888,0.155802396959953,0.857534246575342,0.916184971098266,0.945454545454546,0.935613682092555,0.384991843393148
E02004878,Buntingford & Great Hormead,East Hertfordshire,East of England,1700,4877,466,559,317,443,6662,1866,5552,493,546,385,477,7453,932,448,515,369,458,2722,0.167867435158501,0.908722109533469,0.943223443223443,0.958441558441558,0.960167714884696,0.365222058231585
E02004879,"Datchworth, Walkern & Cottered",East Hertfordshire,East of England,1545,4921,486,550,324,445,6726,1422,5208,512,560,370,470,7120,1019,462,544,349,457,2831,0.195660522273426,0.90234375,0.971428571428571,0.943243243243243,0.972340425531915,0.397612359550562
E02004880,Bishop's Stortford West & Braughing,East Hertfordshire,East of England,1900,5927,474,476,298,444,7619,2211,7021,503,508,338,442,8812,1151,461,476,319,422,2829,0.163936761145136,0.916500994035785,0.937007874015748,0.943786982248521,0.954751131221719,0.32103949160236
E02004881,Bishop's Stortford North,East Hertfordshire,East of England,1218,4177,300,286,199,492,5454,1318,4837,295,340,180,492,6144,647,251,320,172,478,1868,0.133760595410378,0.850847457627119,0.941176470588235,0.955555555555556,0.971544715447154,0.304036458333333
E02004882,Bishop's Stortford East,East Hertfordshire,East of England,1951,5689,355,353,261,380,7038,1840,6587,331,383,232,406,7939,943,274,361,223,391,2192,0.143160771216032,0.827794561933535,0.942558746736293,0.961206896551724,0.963054187192118,0.276105302934878
E02004883,Puckeridge & Thundridge,East Hertfordshire,East of England,1227,3693,299,368,270,311,4941,1243,4033,323,374,277,302,5309,595,282,345,261,291,1774,0.147532853954872,0.873065015479876,0.922459893048128,0.942238267148014,0.963576158940397,0.334149557355434
E02004884,Bishop's Stortford Central,East Hertfordshire,East of England,2085,7297,432,384,252,428,8793,1854,7661,462,391,245,455,9214,1305,389,352,231,434,2711,0.170343297219684,0.841991341991342,0.900255754475703,0.942857142857143,0.953846153846154,0.294226177555893
E02004885,Bishop's Stortford South,East Hertfordshire,East of England,1781,5488,341,356,237,326,6748,1753,6157,392,384,272,342,7547,1030,350,362,261,329,2332,0.167289264252071,0.892857142857143,0.942708333333333,0.959558823529412,0.961988304093567,0.30899695243143
E02004886,Much Hadham & Hunsdon,East Hertfordshire,East of England,1265,3885,338,373,226,415,5237,1269,4221,384,385,258,369,5617,744,339,360,244,344,2031,0.176261549395878,0.8828125,0.935064935064935,0.945736434108527,0.932249322493225,0.361580915079224
E02004887,"Watton-at-Stone, Bramfield & Bayford",East Hertfordshire,East of England,1426,4554,510,495,297,401,6257,1326,4936,479,531,323,406,6675,865,440,505,310,391,2511,0.175243111831442,0.918580375782881,0.951035781544256,0.959752321981424,0.963054187192118,0.376179775280899
E02004888,Sawbridgeworth,East Hertfordshire,East of England,1682,5425,511,514,410,529,7389,1629,5627,562,574,410,567,7740,1087,515,543,390,536,3071,0.193175759729874,0.916370106761566,0.945993031358885,0.951219512195122,0.945326278659612,0.396770025839793
E02004889,Ware East,East Hertfordshire,East of England,2385,7072,441,479,367,788,9147,2285,7561,425,497,396,832,9711,1262,372,464,375,793,3266,0.166909139002777,0.875294117647059,0.933601609657948,0.946969696969697,0.953125,0.336319637524457
E02004890,Ware West,East Hertfordshire,East of England,1435,5523,455,440,263,444,7125,1400,5674,450,476,290,374,7264,922,402,449,276,357,2406,0.162495593937258,0.893333333333333,0.94327731092437,0.951724137931035,0.954545454545455,0.331222466960352
E02004891,Hertford Bengeo,East Hertfordshire,East of England,1711,4739,406,440,306,487,6378,1578,5030,430,449,328,479,6716,762,386,432,313,458,2351,0.151491053677932,0.897674418604651,0.962138084632517,0.954268292682927,0.95615866388309,0.350059559261465
E02004892,Hertford West,East Hertfordshire,East of England,1275,3546,259,204,141,268,4418,1285,3879,267,207,189,252,4794,652,239,188,179,239,1497,0.168084557875741,0.895131086142322,0.908212560386474,0.947089947089947,0.948412698412698,0.312265331664581
E02004893,Hertford Foxholes,East Hertfordshire,East of England,1366,4005,193,178,134,107,4617,1322,4169,206,182,140,144,4841,662,181,166,129,131,1269,0.158791076996882,0.878640776699029,0.912087912087912,0.921428571428571,0.909722222222222,0.262135922330097
E02004894,Hertford South,East Hertfordshire,East of England,1783,6293,405,368,304,521,7891,1778,6541,430,421,318,537,8247,913,382,399,305,506,2505,0.139581103806757,0.888372093023256,0.947743467933492,0.959119496855346,0.942271880819367,0.303746817024373
E02004895,Hertford Heath & Stanstead St Margarets,East Hertfordshire,East of England,1822,5925,508,516,384,418,7751,1856,6662,528,513,419,454,8576,1013,473,482,392,434,2794,0.152056439507655,0.895833333333333,0.939571150097466,0.935560859188544,0.955947136563877,0.325792910447761
E02004944,St Nicholas,Stevenage,East of England,1898,4905,249,268,152,170,5744,1946,5817,272,268,161,195,6713,1022,214,241,145,179,1801,0.175691937424789,0.786764705882353,0.899253731343284,0.900621118012422,0.917948717948718,0.268285416356324
E02004945,Woodfield & Old Town,Stevenage,East of England,2358,7951,527,493,372,587,9930,2429,8583,560,530,408,590,10671,1721,479,497,391,555,3643,0.200512641267622,0.855357142857143,0.937735849056604,0.958333333333333,0.940677966101695,0.341392559272795
E02004946,Martins Wood,Stevenage,East of England,1282,4024,287,282,164,301,5058,1306,4556,271,259,203,297,5586,775,214,230,194,278,1691,0.170105355575066,0.789667896678967,0.888030888030888,0.955665024630542,0.936026936026936,0.302721088435374
E02004947,Chells North,Stevenage,East of England,1032,4049,315,293,181,277,5115,1120,4471,400,291,204,256,5622,813,360,275,195,240,1883,0.18183851487363,0.9,0.945017182130584,0.955882352941176,0.9375,0.334934187122021
E02004948,Symonds Green,Stevenage,East of England,1134,3823,351,284,160,273,4891,1149,4072,353,326,193,264,5208,708,306,308,182,243,1747,0.173870333988212,0.86685552407932,0.94478527607362,0.94300518134715,0.920454545454545,0.335445468509985
E02004949,Pin Green,Stevenage,East of England,1691,5498,332,369,330,577,7106,1700,6134,360,375,325,531,7725,1066,294,336,302,504,2502,0.17378545810238,0.816666666666667,0.896,0.929230769230769,0.949152542372881,0.323883495145631
E02004950,Chells South,Stevenage,East of England,1608,4210,260,241,207,290,5208,1565,4713,252,250,201,322,5738,828,214,231,193,309,1775,0.175684277530236,0.849206349206349,0.924,0.960199004975124,0.959627329192547,0.309341233879401
E02004951,Bedwell,Stevenage,East of England,1758,5183,240,230,189,355,6197,1712,6013,266,257,184,344,7064,945,197,222,171,322,1857,0.157159487776484,0.740601503759399,0.863813229571985,0.929347826086957,0.936046511627907,0.262882219705549
E02004952,Poplars,Stevenage,East of England,1372,4275,279,230,161,354,5299,1379,4728,320,247,181,326,5802,856,260,224,163,310,1813,0.181049069373942,0.8125,0.906882591093117,0.900552486187845,0.950920245398773,0.312478455704929
E02004953,Shephall,Stevenage,East of England,1477,4054,212,217,163,255,4901,1509,4549,246,198,179,257,5429,781,187,184,163,234,1549,0.171686084853814,0.760162601626016,0.929292929292929,0.910614525139665,0.910505836575875,0.285319580033155
E02004954,Roebuck,Stevenage,East of England,1474,4401,262,265,177,344,5449,1516,4880,313,287,197,322,5999,844,262,262,181,303,1852,0.172950819672131,0.837060702875399,0.912891986062718,0.918781725888325,0.940993788819876,0.308718119686614
E02004955,Broadwater & Bragbury End,Stevenage,East of England,1223,3644,300,244,143,309,4640,1219,4024,325,285,175,286,5095,765,282,269,159,269,1744,0.190109343936382,0.867692307692308,0.943859649122807,0.908571428571429,0.94055944055944,0.342296368989205
E02006287,"Yoxford, Wenhaston & Walberswick",East Suffolk,East of England,840,3118,631,623,421,546,5339,769,3322,637,640,454,533,5586,1118,600,620,437,518,3293,0.336544250451535,0.941915227629513,0.96875,0.962555066079295,0.971857410881801,0.589509488005729
E02006288,Framlingham & Hacheston,East Suffolk,East of England,1577,5287,716,744,485,753,7985,1605,5929,695,777,556,784,8741,1476,648,749,539,731,4143,0.24894585933547,0.932374100719425,0.963963963963964,0.969424460431655,0.932397959183674,0.473973229607596
E02006289,Saxmundham & Coldfair Green,East Suffolk,East of England,1660,5124,681,766,561,735,7867,1615,5577,705,806,603,775,8466,2801,675,774,584,756,5590,0.502241348395195,0.957446808510638,0.96029776674938,0.96849087893864,0.975483870967742,0.66028821167021
E02006290,Leiston & Aldeburgh,East Suffolk,East of England,1181,4353,586,692,519,798,6948,1243,4692,607,656,540,827,7322,1798,557,626,518,793,4292,0.383205456095482,0.917627677100494,0.954268292682927,0.959259259259259,0.958887545344619,0.586178639715925
E02006291,Wickham Market & Melton,East Suffolk,East of England,1251,4166,620,649,397,598,6430,1198,4531,600,662,480,615,6888,1285,554,626,453,541,3459,0.283601853895387,0.923333333333333,0.945619335347432,0.94375,0.879674796747968,0.502177700348432
E02006292,"Westerfield, Grundisburgh & Bredfield",East Suffolk,East of England,1174,3834,540,517,334,458,5683,1081,4085,528,531,394,459,5997,1233,488,518,387,433,3059,0.301835985312118,0.924242424242424,0.975517890772128,0.982233502538071,0.943355119825708,0.510088377522094
E02006293,"Rendlesham, Orford & Hollesley",East Suffolk,East of England,1905,7086,742,695,472,551,9546,1869,7020,742,721,473,602,9558,1703,668,679,445,542,4037,0.242592592592593,0.900269541778976,0.941747572815534,0.940803382663848,0.900332225913621,0.422368696379996
E02006294,Woodbridge,East Suffolk,East of England,1256,4155,571,685,519,1042,6972,1158,4625,513,664,561,1040,7403,1225,471,624,529,920,3769,0.264864864864865,0.91812865497076,0.939759036144578,0.942959001782531,0.884615384615385,0.509117925165474
E02006295,Kesgrave West & Rushmere,East Suffolk,East of England,1840,5470,522,657,490,817,7956,1646,5651,486,650,514,792,8093,1733,456,626,498,763,4076,0.30667138559547,0.938271604938272,0.963076923076923,0.968871595330739,0.963383838383838,0.503645125417027
E02006296,Kesgrave East & Martlesham,East Suffolk,East of England,2694,7933,777,812,504,769,10795,2475,8199,770,845,577,737,11128,2294,716,798,552,695,5055,0.279790218319307,0.92987012987013,0.944378698224852,0.956672443674177,0.943012211668928,0.454259525521208
E02006297,"Bixley, Warren Heath & Nacton",East Suffolk,East of England,1331,4725,548,555,390,677,6895,1249,5022,553,595,442,678,7290,1610,509,556,416,641,3732,0.320589406610912,0.920433996383363,0.934453781512605,0.941176470588235,0.945427728613569,0.511934156378601
E02006298,Trimley & Kirton,East Suffolk,East of England,1600,5504,666,655,395,470,7690,1475,5728,679,696,437,482,8022,1855,617,666,416,466,4020,0.323847765363128,0.908689248895434,0.956896551724138,0.951945080091533,0.966804979253112,0.50112191473448
E02006299,Felixstowe East,East Suffolk,East of England,1005,4018,764,896,661,1037,7376,944,4260,738,876,731,1086,7691,1603,677,850,715,1061,4906,0.376291079812207,0.917344173441735,0.970319634703196,0.978112175102599,0.976979742173112,0.637888441034976
E02006300,Felixstowe West,East Suffolk,East of England,1489,4666,434,462,329,401,6292,1483,5248,442,450,359,390,6889,1479,381,419,341,373,2993,0.281821646341463,0.861990950226245,0.931111111111111,0.949860724233983,0.956410256410256,0.434460734504282
E02006301,Felixstowe Seafront,East Suffolk,East of England,976,3611,474,455,306,629,5475,928,4116,430,524,326,577,5973,1143,374,482,311,550,2860,0.277696793002915,0.869767441860465,0.919847328244275,0.95398773006135,0.953206239168111,0.478821362799263
E02006302,"Gunton East, Corton & Somerleyton",East Suffolk,East of England,845,3655,570,665,439,568,5897,846,3804,538,628,485,620,6075,904,443,596,470,593,3006,0.237644584647739,0.823420074349443,0.949044585987261,0.969072164948454,0.956451612903226,0.494814814814815
E02006303,Gunton West,East Suffolk,East of England,1712,4876,396,447,296,425,6440,1773,5154,380,392,329,392,6647,1209,296,362,305,368,2540,0.234575087310827,0.778947368421053,0.923469387755102,0.927051671732523,0.938775510204082,0.382127275462615
E02006304,Oulton,East Suffolk,East of England,1252,3990,584,723,533,692,6522,1227,4348,569,728,586,726,6957,1088,494,703,576,704,3565,0.250229990800368,0.868189806678383,0.965659340659341,0.982935153583618,0.96969696969697,0.512433520195487
E02006305,Lowestoft Central,East Suffolk,East of England,2176,6425,388,416,314,305,7848,2278,7516,399,391,282,324,8912,1442,278,337,264,295,2616,0.19185737094199,0.696741854636592,0.861892583120205,0.936170212765957,0.910493827160494,0.293536804308797
E02006306,Normanston & Oulton Broad East,East Suffolk,East of England,1383,4144,456,592,387,548,6127,1298,4485,494,541,411,526,6457,1140,395,514,394,509,2952,0.254180602006689,0.799595141700405,0.950092421441775,0.958637469586375,0.967680608365019,0.45717825615611
E02006307,Oulton Broad West,East Suffolk,East of England,1045,3681,617,767,430,763,6258,925,3985,535,778,526,745,6569,979,442,747,508,726,3402,0.245671267252196,0.826168224299065,0.960154241645244,0.965779467680608,0.974496644295302,0.517887045212361
E02006308,Lowestoft Harbour & Kirkley,East Suffolk,East of England,1413,4894,438,380,224,387,6323,1422,5585,451,418,273,377,7104,1327,319,373,252,352,2623,0.237600716204118,0.707317073170732,0.892344497607656,0.923076923076923,0.93368700265252,0.369228603603604
E02006309,Pakefield North,East Suffolk,East of England,1203,3671,485,517,335,688,5696,1183,3884,457,530,407,637,5915,1006,342,494,392,607,2841,0.259011328527291,0.74835886214442,0.932075471698113,0.963144963144963,0.952904238618524,0.480304311073542
E02006310,Carlton Colville,East Suffolk,East of England,1722,5059,419,513,349,460,6800,1539,5103,396,469,390,504,6862,1262,292,443,377,489,2863,0.247305506564766,0.737373737373737,0.94456289978678,0.966666666666667,0.970238095238095,0.417225298746721
E02006311,Beccles,East Suffolk,East of England,1417,4491,593,667,500,803,7054,1315,4662,562,670,555,783,7232,1051,477,623,528,748,3427,0.225439725439725,0.848754448398577,0.929850746268657,0.951351351351351,0.955300127713921,0.473866150442478
E02006312,Worlingham & Barnby,East Suffolk,East of England,1475,4975,606,700,479,595,7355,1289,5081,625,689,504,625,7524,1153,524,658,487,598,3420,0.226923833890966,0.8384,0.955007256894049,0.966269841269841,0.9568,0.454545454545455
E02006313,Pakefield South & Kessingland,East Suffolk,East of England,1507,5401,765,943,612,805,8526,1481,5735,703,888,695,816,8837,1456,558,833,661,770,4278,0.253879686137751,0.793741109530583,0.938063063063063,0.951079136690647,0.943627450980392,0.484100939232771
E02006314,Bungay & the Saints,East Suffolk,East of England,1166,4105,589,527,401,595,6217,1116,4254,580,576,386,636,6432,1035,503,548,365,598,3049,0.243300423131171,0.867241379310345,0.951388888888889,0.94559585492228,0.940251572327044,0.474036069651741
E02006315,"Southwold, Reydon & Wrentham",East Suffolk,East of England,746,2935,550,560,396,661,5102,748,3221,541,532,440,598,5332,742,486,515,419,577,2739,0.230363241229432,0.898336414048059,0.968045112781955,0.952272727272727,0.964882943143813,0.513690922730683
E02006316,Halesworth & Wangford,East Suffolk,East of England,1075,3644,547,651,490,799,6131,1027,3823,555,643,517,777,6315,991,516,615,501,756,3379,0.259220507454878,0.92972972972973,0.956454121306376,0.969052224371373,0.972972972972973,0.53507521773555
E02006238,Brandon,West Suffolk,East of England,1800,5538,602,726,473,646,7985,1545,5936,613,653,512,697,8411,1330,541,614,480,656,3621,0.224056603773585,0.882544861337684,0.940275650842267,0.9375,0.941176470588235,0.430507668529307
E02006239,Lakenheath,West Suffolk,East of England,1657,4875,299,339,231,318,6062,814,2957,290,333,238,335,4153,767,254,312,226,313,1872,0.25938451132905,0.875862068965517,0.936936936936937,0.949579831932773,0.934328358208955,0.450758487840116
E02006240,"Beck Row, Eriswell & Barton Mills",West Suffolk,East of England,2969,6045,454,437,247,333,7516,1504,4955,470,455,270,324,6474,1225,420,424,256,308,2633,0.247225025227043,0.893617021276596,0.931868131868132,0.948148148148148,0.950617283950617,0.406703738029039
E02006241,Mildenhall,West Suffolk,East of England,1872,5234,511,479,375,583,7182,1434,5165,473,500,372,549,7059,1278,415,467,355,516,3031,0.247434656340755,0.877378435517971,0.934,0.954301075268817,0.939890710382514,0.429380932143363
E02006242,"Red Lodge, Icklingham & Moulton",West Suffolk,East of England,2536,6019,374,434,210,421,7458,2030,6125,413,446,300,337,7621,1346,357,420,285,320,2728,0.219755102040816,0.864406779661017,0.941704035874439,0.95,0.949554896142433,0.357958273192494
E02006243,"North Newmarket, Studlands & Exning",West Suffolk,East of England,1792,5616,444,425,278,411,7174,1667,6745,427,423,321,408,8324,1462,372,402,307,393,2936,0.216753150481838,0.871194379391101,0.950354609929078,0.956386292834891,0.963235294117647,0.352715040845747
E02006273,Stanton & Barningham,West Suffolk,East of England,1130,3622,546,556,377,495,5596,1045,3783,488,582,434,494,5781,1071,435,559,421,483,2969,0.283108643933386,0.891393442622951,0.960481099656357,0.970046082949309,0.977732793522267,0.51357896557689
E02006274,"Ixworth, Honington & Barnham",West Suffolk,East of England,1227,4243,345,375,261,369,5593,1067,4305,345,381,295,402,5728,787,277,369,286,393,2112,0.18281068524971,0.802898550724638,0.968503937007874,0.969491525423729,0.977611940298507,0.368715083798883
E02006275,Howard Estate & Northgate,West Suffolk,East of England,1532,4337,293,367,256,357,5610,1431,4913,297,326,261,347,6144,1292,262,291,253,325,2423,0.262975778546713,0.882154882154882,0.892638036809816,0.969348659003831,0.936599423631124,0.394368489583333
E02006276,"Fornham, Great Barton & Rougham",West Suffolk,East of England,1107,3543,531,573,439,681,5767,1248,4329,510,562,457,661,6519,1142,480,544,436,637,3239,0.263802263802264,0.941176470588235,0.96797153024911,0.954048140043764,0.963691376701967,0.49685534591195
E02006277,Moreton Hall,West Suffolk,East of England,1736,5240,305,317,184,212,6258,1557,5158,326,322,211,272,6289,1277,298,301,200,266,2342,0.247576580069795,0.914110429447853,0.934782608695652,0.947867298578199,0.977941176470588,0.372396247416123
E02006278,Bury St Edmunds Central,West Suffolk,East of England,1156,5681,440,483,369,664,7637,984,5508,447,462,386,565,7368,1307,386,427,361,526,3007,0.237291212781409,0.863534675615213,0.924242424242424,0.935233160621762,0.930973451327434,0.408116178067318
E02006279,Bury St Edmunds West,West Suffolk,East of England,1455,4977,556,666,465,706,7370,1354,5274,535,644,496,715,7664,1441,503,620,469,692,3725,0.273227152066743,0.94018691588785,0.962732919254658,0.945564516129032,0.967832167832168,0.486038622129436
E02006280,"Barrow, Chedburgh & Sicklesmere",West Suffolk,East of England,1761,5380,634,741,513,760,8028,1723,5849,651,734,602,752,8588,1353,602,700,582,720,3957,0.231321593434775,0.924731182795699,0.953678474114441,0.966777408637874,0.957446808510638,0.460759198882161
E02006281,Eastgate & Southgate,West Suffolk,East of England,1256,4658,571,672,546,1097,7544,1140,4958,520,656,578,967,7679,1482,477,612,552,925,4048,0.298910851149657,0.917307692307692,0.932926829268293,0.955017301038062,0.956566701137539,0.52715197291314
E02006282,"Clare, Cavendish & Wickhambrook",West Suffolk,East of England,978,3355,506,578,401,550,5390,914,3559,526,567,466,549,5667,734,468,542,446,517,2707,0.20623770722113,0.889733840304183,0.955908289241622,0.957081545064378,0.941712204007286,0.477677783659785
E02006283,"Kedington, Hundon & Withersfield",West Suffolk,East of England,1087,4864,437,516,351,371,6539,1162,5226,454,490,409,409,6988,915,397,450,382,383,2527,0.175086107921929,0.874449339207049,0.918367346938776,0.93398533007335,0.936430317848411,0.361619919862622
E02006284,Haverhill North,West Suffolk,East of England,1671,4704,392,443,294,429,6262,1526,5017,380,412,313,409,6531,1205,332,384,283,389,2593,0.240183376519833,0.873684210526316,0.932038834951456,0.904153354632588,0.951100244498777,0.397029551370387
E02006285,Haverhill West,West Suffolk,East of England,1800,4928,302,280,219,244,5973,1582,5292,276,295,224,289,6376,1192,233,269,204,261,2159,0.225245653817082,0.844202898550725,0.911864406779661,0.910714285714286,0.903114186851211,0.338613550815558
E02006286,Haverhill East & South,West Suffolk,East of England,2530,7241,536,565,354,549,9245,2341,7669,523,593,412,501,9698,1620,437,555,386,451,3449,0.211240057373843,0.835564053537285,0.935919055649241,0.936893203883495,0.900199600798403,0.355640338214065
E02006826,South Newmarket & Racecourse,West Suffolk,East of England,1721,6154,481,473,346,629,8083,1659,7062,458,503,329,612,8964,1414,398,465,303,594,3174,0.200226564712546,0.868995633187773,0.924453280318092,0.9209726443769,0.970588235294118,0.354082998661312
E02000001,City of London,City of London,London,1494,6585,491,439,281,431,8227,661,7568,377,346,231,302,8824,704,308,296,197,246,1751,0.0930232558139535,0.816976127320955,0.855491329479769,0.852813852813853,0.814569536423841,0.198436083408885
E02000002,Marks Gate,Barking and Dagenham,London,2132,4594,235,204,197,373,5603,2233,5360,247,206,191,333,6337,851,149,169,160,295,1624,0.158768656716418,0.603238866396761,0.820388349514563,0.837696335078534,0.885885885885886,0.256272684235443
E02000003,Chadwell Heath East,Barking and Dagenham,London,2622,7244,354,348,227,379,8552,2721,8192,396,334,250,379,9551,1208,246,272,206,324,2256,0.1474609375,0.621212121212121,0.81437125748503,0.824,0.854881266490765,0.236205632918019
E02000004,Eastbrookend,Barking and Dagenham,London,1380,4256,229,237,207,378,5307,1368,4530,284,242,189,332,5577,949,192,202,165,285,1793,0.209492273730684,0.676056338028169,0.834710743801653,0.873015873015873,0.858433734939759,0.321499013806706
E02000005,Becontree Heath,Barking and Dagenham,London,2896,6612,247,248,165,264,7536,3176,7798,284,238,170,255,8745,1228,196,199,147,216,1986,0.157476275968197,0.690140845070423,0.836134453781513,0.864705882352941,0.847058823529412,0.227101200686106
E02000007,Central Park & Frizlands Lane,Barking and Dagenham,London,2775,6202,282,263,183,343,7273,2883,6944,309,278,181,304,8016,1134,194,236,146,252,1962,0.163306451612903,0.627831715210356,0.848920863309353,0.806629834254144,0.828947368421053,0.244760479041916
E02000008,Becontree East,Barking and Dagenham,London,3383,7949,425,324,228,353,9279,3739,9453,437,319,224,330,10763,1598,297,261,189,277,2622,0.169046863429599,0.679633867276888,0.818181818181818,0.84375,0.839393939393939,0.243612375731673
E02000009,Becontree West,Barking and Dagenham,London,3400,7556,315,191,147,220,8429,3659,9509,345,235,155,234,10478,1325,220,179,118,176,2018,0.139341676306657,0.63768115942029,0.761702127659575,0.761290322580645,0.752136752136752,0.192594006489788
E02000010,Dagenham North,Barking and Dagenham,London,2463,5870,264,207,127,273,6741,2663,7040,309,204,152,243,7948,1175,203,164,121,204,1867,0.166903409090909,0.656957928802589,0.803921568627451,0.796052631578947,0.839506172839506,0.234901862103674
E02000011,Dagenham Eastbrook,Barking and Dagenham,London,1666,4480,240,186,144,278,5328,1773,5062,253,212,183,311,6021,760,175,177,150,279,1541,0.150138285262742,0.691699604743083,0.834905660377359,0.819672131147541,0.897106109324759,0.255937551901677
E02000012,Longbridge & Barking Park,Barking and Dagenham,London,2745,7327,372,280,201,366,8546,2786,8259,378,292,185,352,9466,1369,289,243,156,304,2361,0.165758566412399,0.764550264550265,0.832191780821918,0.843243243243243,0.863636363636364,0.249418973167124
E02000013,Becontree South,Barking and Dagenham,London,2492,5563,306,231,154,202,6456,2540,6800,313,268,151,221,7753,1067,209,211,125,188,1800,0.156911764705882,0.667731629392971,0.787313432835821,0.827814569536424,0.850678733031674,0.232168192957565
E02000014,Dagenham Central,Barking and Dagenham,London,2636,6242,324,297,165,285,7313,2622,7481,349,332,215,284,8661,1199,237,255,165,230,2086,0.160272690816736,0.679083094555874,0.768072289156627,0.767441860465116,0.809859154929578,0.240849786398799
E02000015,Old Dagenham Park & Village,Barking and Dagenham,London,2230,5203,245,188,117,207,5960,2449,5957,274,219,135,202,6787,932,178,180,117,170,1577,0.1564545912372,0.64963503649635,0.821917808219178,0.866666666666667,0.841584158415842,0.232355974657433
E02000016,Barking Central,Barking and Dagenham,London,3002,6672,124,112,47,64,7019,3517,9249,165,122,74,76,9686,923,78,80,52,44,1177,0.0997945723862039,0.472727272727273,0.655737704918033,0.702702702702703,0.578947368421053,0.121515589510634
E02000017,Barking East,Barking and Dagenham,London,2181,6303,246,191,124,230,7094,2541,8416,364,216,149,214,9359,960,234,158,110,155,1617,0.114068441064639,0.642857142857143,0.731481481481482,0.738255033557047,0.724299065420561,0.172774869109948
E02000018,Mayesbrook Park & Rippleside,Barking and Dagenham,London,2760,6076,263,181,145,224,6889,2774,7206,308,226,147,212,8099,1062,211,183,111,172,1739,0.147377185678601,0.685064935064935,0.809734513274336,0.755102040816326,0.811320754716981,0.21471786640326
E02000019,Goresbrook & Scrattons Farm,Barking and Dagenham,London,2527,5798,300,228,142,179,6647,2697,6825,313,259,152,204,7753,1088,222,204,122,168,1804,0.159413919413919,0.70926517571885,0.787644787644788,0.802631578947369,0.823529411764706,0.232684122275248
E02000020,Creekmouth & Barking Riverside,Barking and Dagenham,London,3795,8556,279,243,173,309,9560,3924,10550,353,273,175,283,11634,1397,250,200,129,228,2204,0.132417061611374,0.708215297450425,0.732600732600733,0.737142857142857,0.80565371024735,0.189444730960976
E02000021,Rylands Estate & Dagenham Dock,Barking and Dagenham,London,2472,5558,270,224,161,259,6472,2662,6410,292,237,151,238,7328,950,186,183,110,183,1612,0.14820592823713,0.636986301369863,0.772151898734177,0.728476821192053,0.76890756302521,0.219978165938865
E02000022,Gascoigne Estate & Roding Riverside,Barking and Dagenham,London,2739,5116,112,95,52,69,5444,2534,6256,158,83,74,64,6635,729,85,56,43,46,959,0.116528132992327,0.537974683544304,0.674698795180723,0.581081081081081,0.71875,0.144536548605878
E02000023,Thames View,Barking and Dagenham,London,2628,4970,162,109,41,114,5396,2566,6077,182,137,53,100,6549,871,111,92,38,73,1185,0.143327299654435,0.60989010989011,0.671532846715328,0.716981132075472,0.73,0.180943655519927
E02006799,Becontree North,Barking and Dagenham,London,3057,6998,326,249,192,316,8081,3300,8716,377,273,207,312,9885,1464,247,218,176,252,2357,0.167966957319871,0.655172413793103,0.798534798534799,0.85024154589372,0.807692307692308,0.238442083965604
E02000024,High Barnet & Hadley,Barnet,London,1974,6877,565,569,383,689,9083,1914,7334,584,581,427,641,9567,1513,489,539,393,584,3518,0.206299427324789,0.837328767123288,0.927710843373494,0.920374707259953,0.911076443057722,0.367722379011184
E02000025,Hadley Wood,Barnet,London,1633,5312,362,407,233,400,6714,1569,5530,370,376,262,387,6925,1146,320,336,239,337,2378,0.207233273056058,0.864864864864865,0.893617021276596,0.912213740458015,0.870801033591731,0.343393501805054
E02000026,Oak Hill,Barnet,London,1354,3972,333,331,242,361,5239,1291,4424,343,347,265,377,5756,1128,278,292,238,331,2267,0.25497287522604,0.810495626822157,0.84149855907781,0.89811320754717,0.877984084880637,0.393849895760945
E02000027,Ducks Island & Underhill,Barnet,London,2024,6002,522,397,276,417,7614,1968,6733,485,428,310,430,8386,1398,390,373,271,392,2824,0.207634041289173,0.804123711340206,0.871495327102804,0.874193548387097,0.911627906976744,0.336751729072263
E02000028,New Barnet West,Barnet,London,1388,4332,281,262,194,352,5421,1332,4595,289,292,207,363,5746,981,247,247,191,329,1995,0.213492927094668,0.854671280276817,0.845890410958904,0.922705314009662,0.90633608815427,0.34719805081796
E02000029,New Barnet Town & East Barnet,Barnet,London,2246,5959,365,325,239,317,7205,2126,6456,396,346,253,312,7763,1203,325,290,221,272,2311,0.186338289962825,0.820707070707071,0.838150289017341,0.873517786561265,0.871794871794872,0.297694190390313
E02000030,Totteridge & Barnet Gate,Barnet,London,1684,5436,527,530,376,688,7557,1684,6291,556,549,406,633,8435,1680,457,491,361,563,3552,0.267048164043872,0.821942446043165,0.894353369763206,0.889162561576355,0.889415481832543,0.421102548903379
E02000031,Oakleigh Park,Barnet,London,1483,4752,370,357,307,587,6373,1637,5893,415,397,313,603,7621,1176,347,344,266,530,2663,0.19955879857458,0.836144578313253,0.866498740554156,0.849840255591054,0.87893864013267,0.349429208765254
E02000032,Osidge,Barnet,London,1576,4749,386,355,314,391,6195,1576,5572,424,437,306,486,7225,1472,338,384,267,396,2857,0.264178033022254,0.797169811320755,0.878718535469108,0.872549019607843,0.814814814814815,0.395432525951557
E02000033,Brunswick Park Road,Barnet,London,1786,5751,395,339,221,411,7117,1772,6229,408,356,252,370,7615,1293,331,305,219,319,2467,0.207577460266495,0.811274509803922,0.856741573033708,0.869047619047619,0.862162162162162,0.323965856861458
E02000034,Whetstone East,Barnet,London,1899,5953,376,433,279,416,7457,1936,6682,454,398,316,427,8277,1261,369,344,280,365,2619,0.188715953307393,0.812775330396476,0.864321608040201,0.886075949367089,0.85480093676815,0.316418992388547
E02000035,Woodside Park,Barnet,London,1740,5817,382,401,232,505,7337,1750,6475,389,410,311,491,8076,1190,314,323,270,425,2522,0.183783783783784,0.80719794344473,0.787804878048781,0.868167202572347,0.865580448065173,0.312283308568598
E02000036,Edgware East,Barnet,London,2771,7194,444,453,300,483,8874,2854,8356,511,446,355,467,10135,1990,401,372,301,404,3468,0.238152225945428,0.784735812133072,0.834080717488789,0.847887323943662,0.865096359743041,0.342180562407499
E02000037,Edgware Park,Barnet,London,2703,6021,517,502,334,475,7849,2695,7205,540,560,348,501,9154,2080,451,484,306,435,3756,0.288688410825815,0.835185185185185,0.864285714285714,0.879310344827586,0.868263473053892,0.410312431723837
E02000038,Friern Barnet,Barnet,London,2317,7529,484,390,271,488,9162,2155,7815,533,417,295,518,9578,1391,425,349,256,438,2859,0.177991042866283,0.797373358348968,0.836930455635492,0.867796610169492,0.845559845559846,0.298496554604302
E02000039,Mill Hill Park,Barnet,London,1562,4527,289,330,214,333,5693,1499,5287,318,363,225,332,6525,1350,265,311,201,277,2404,0.25534329487422,0.833333333333333,0.856749311294766,0.893333333333333,0.83433734939759,0.368429118773946
E02000040,Mill Hill East,Barnet,London,1975,5150,384,345,238,360,6477,1997,6425,379,362,300,380,7846,1177,304,313,268,336,2398,0.183190661478599,0.802110817941952,0.864640883977901,0.893333333333333,0.884210526315789,0.305633443793016
E02000041,Edgware Central,Barnet,London,2340,6181,431,312,266,504,7694,2346,7695,493,381,269,461,9299,1577,367,317,221,379,2861,0.204938271604938,0.744421906693712,0.832020997375328,0.821561338289963,0.822125813449024,0.307667491128078
E02000042,North Finchley,Barnet,London,2454,8076,435,383,325,574,9793,2282,8686,478,419,341,566,10490,1443,365,353,288,476,2925,0.166129403638038,0.763598326359833,0.842482100238664,0.844574780058651,0.840989399293286,0.278836987607245
E02000043,West Finchley,Barnet,London,1929,4961,384,341,194,397,6277,1952,5715,380,362,232,375,7064,1093,318,306,204,317,2238,0.191251093613298,0.836842105263158,0.845303867403315,0.879310344827586,0.845333333333333,0.316817667044168
E02000044,Mill Hill Broadway,Barnet,London,2126,5801,287,275,180,207,6750,2176,7143,343,271,187,224,8168,1744,237,222,150,175,2528,0.244155116897662,0.690962099125365,0.819188191881919,0.802139037433155,0.78125,0.309500489715965
E02000045,Colney Hatch,Barnet,London,2363,7373,366,337,233,273,8582,2352,8004,395,377,222,301,9299,1399,306,286,177,237,2405,0.174787606196902,0.774683544303798,0.758620689655172,0.797297297297297,0.787375415282392,0.258629960210775
E02000046,Church End,Barnet,London,1391,5300,262,213,183,274,6232,1392,5928,269,255,186,268,6906,970,209,212,167,231,1789,0.163630229419703,0.776951672862453,0.831372549019608,0.897849462365591,0.861940298507463,0.259050101361135
E02000047,Burnt Oak & Watling Park,Barnet,London,2870,8162,425,359,258,348,9552,2978,10050,490,394,229,408,11571,2172,347,312,177,307,3315,0.216119402985075,0.708163265306123,0.791878172588833,0.77292576419214,0.752450980392157,0.286492092299715
E02000048,Copthall & Downage,Barnet,London,2323,6608,474,468,308,526,8384,2321,7526,485,490,382,570,9453,1636,396,407,335,490,3264,0.217379750199309,0.816494845360825,0.830612244897959,0.87696335078534,0.859649122807018,0.345287210409394
E02000049,Grahame Park,Barnet,London,2492,6233,266,211,133,141,6984,2626,7965,321,239,166,172,8863,1596,230,165,117,114,2222,0.200376647834275,0.716510903426791,0.690376569037657,0.704819277108434,0.662790697674419,0.250705178833352
E02000050,Fallow Corner,Barnet,London,2320,7173,436,409,281,391,8690,2131,7891,442,407,284,368,9392,1433,342,350,244,308,2677,0.181599290330757,0.773755656108597,0.85995085995086,0.859154929577465,0.836956521739131,0.285029812606474
E02000051,Finchley Central,Barnet,London,1878,6195,414,408,338,639,7994,1846,7315,444,464,393,591,9207,1603,357,397,340,523,3220,0.219138755980861,0.804054054054054,0.855603448275862,0.865139949109415,0.884940778341793,0.349733898120995
E02000052,East Finchley,Barnet,London,1998,7244,406,358,267,340,8615,1984,7376,392,342,284,371,8765,1353,307,291,241,297,2489,0.183432754880694,0.783163265306123,0.850877192982456,0.848591549295775,0.800539083557952,0.283970336565887
E02000053,Colindale,Barnet,London,3647,11915,381,246,211,285,13038,3907,14941,451,337,196,288,16213,2433,285,227,147,228,3320,0.162840505990228,0.631929046563193,0.673590504451039,0.75,0.791666666666667,0.204773946832789
E02000054,North Hendon & Sunny Hill,Barnet,London,1378,5339,297,246,158,230,6270,1576,6439,336,255,207,247,7484,1108,249,208,162,211,1938,0.172076409380339,0.741071428571429,0.815686274509804,0.782608695652174,0.854251012145749,0.258952431854623
E02000055,Hendon Central,Barnet,London,2290,8172,384,342,248,558,9704,2570,10600,426,392,273,486,12177,1640,314,287,232,413,2886,0.154716981132075,0.737089201877934,0.732142857142857,0.84981684981685,0.849794238683128,0.2370041882237
E02000056,Hampstead Garden Suburb,Barnet,London,2142,5663,384,491,363,566,7467,1971,6281,430,521,363,571,8166,2170,348,455,313,510,3796,0.345486387517911,0.809302325581395,0.873320537428023,0.862258953168044,0.893169877408056,0.464854273818271
E02000057,Hendon Park,Barnet,London,2119,5105,237,242,183,279,6046,2284,6617,271,271,188,290,7637,1280,201,208,157,237,2083,0.193441136466677,0.74169741697417,0.767527675276753,0.835106382978723,0.817241379310345,0.272751080267121
E02000058,Temple Fortune,Barnet,London,2388,6655,465,513,393,537,8563,2496,7795,475,524,422,578,9794,2125,377,440,370,501,3813,0.272610647851187,0.793684210526316,0.83969465648855,0.876777251184834,0.866782006920415,0.389319991831734
E02000059,West Hendon,Barnet,London,2358,8183,422,291,245,374,9515,2261,9642,489,345,241,423,11140,1793,339,272,194,337,2935,0.185957270275876,0.693251533742331,0.788405797101449,0.804979253112033,0.796690307328605,0.263464991023339
E02000060,Golders Green North,Barnet,London,3571,7182,397,336,227,640,8782,3747,8922,487,385,275,596,10665,1852,367,299,219,507,3244,0.20757677650751,0.753593429158111,0.776623376623377,0.796363636363636,0.850671140939597,0.304172526957337
E02000061,Golders Green South,Barnet,London,1656,6152,369,308,193,497,7519,1668,7310,362,374,245,484,8775,1576,264,294,203,412,2749,0.215595075239398,0.729281767955801,0.786096256684492,0.828571428571429,0.851239669421488,0.313276353276353
E02000062,Brent Cross & Staples Corner,Barnet,London,1485,4835,255,177,104,165,5536,1522,6286,283,216,107,173,7065,879,174,157,77,134,1421,0.139834552974865,0.614840989399293,0.726851851851852,0.719626168224299,0.774566473988439,0.201132342533616
E02000063,North Cricklewood,Barnet,London,1620,5385,284,215,188,263,6335,1711,7002,379,277,184,274,8116,1071,272,216,138,231,1928,0.152956298200514,0.717678100263852,0.779783393501805,0.75,0.843065693430657,0.237555446032528
E02000064,Childs Hill,Barnet,London,1305,4781,255,203,154,229,5622,1251,5613,235,213,167,222,6450,890,175,161,128,182,1536,0.158560484589346,0.74468085106383,0.755868544600939,0.766467065868264,0.81981981981982,0.238139534883721
E02000065,Crossway Park,Bexley,London,2393,5851,246,169,98,194,6558,2219,6005,272,187,125,118,6707,1117,179,145,105,96,1642,0.18601165695254,0.658088235294118,0.775401069518717,0.84,0.813559322033898,0.24481884598181
E02000066,South Thamesmead,Bexley,London,2446,6595,337,321,210,273,7736,2328,6938,396,319,202,226,8081,1315,291,270,170,183,2229,0.189535889305275,0.734848484848485,0.846394984326019,0.841584158415842,0.809734513274336,0.275832198985274
E02000067,Belvedere & Lessness Heath,Bexley,London,2545,6837,288,291,206,287,7909,2476,7156,357,319,205,272,8309,1166,281,278,174,245,2144,0.162940190050307,0.787114845938375,0.871473354231975,0.848780487804878,0.900735294117647,0.258033457696474
E02000068,Erith East,Bexley,London,2086,5358,229,166,127,237,6117,2125,5532,277,197,142,245,6393,906,208,168,122,218,1622,0.163774403470716,0.750902527075812,0.852791878172589,0.859154929577465,0.889795918367347,0.253715000782105
E02000069,Erith West,Bexley,London,1510,4286,275,269,206,365,5401,1513,4482,319,282,233,363,5679,847,271,249,212,325,1904,0.188978134761267,0.849529780564263,0.882978723404255,0.909871244635193,0.895316804407714,0.335270294065857
E02000070,Lesnes Abbey,Bexley,London,1503,5050,371,394,290,471,6576,1543,5258,409,411,327,475,6880,1194,358,384,310,446,2692,0.227082540890072,0.875305623471883,0.934306569343066,0.948012232415902,0.938947368421053,0.391279069767442
E02000071,Northumberland Heath,Bexley,London,1623,4932,334,285,168,304,6023,1703,5236,380,327,208,307,6458,1030,333,307,187,282,2139,0.196715049656226,0.876315789473684,0.938837920489297,0.899038461538462,0.9185667752443,0.331217095075875
E02000072,Slade Green & Crayford Marshes,Bexley,London,3579,8372,311,285,192,300,9460,3465,8732,366,295,178,294,9865,1453,277,239,137,255,2361,0.166399450297755,0.756830601092896,0.810169491525424,0.769662921348315,0.86734693877551,0.239330968068931
E02000073,Bostall,Bexley,London,2078,6695,535,534,417,600,8781,2030,7052,539,586,425,637,9239,1629,478,547,398,591,3643,0.230998298355077,0.88682745825603,0.933447098976109,0.936470588235294,0.927786499215071,0.394306743154021
E02000074,Lesney Farm & Colyers East,Bexley,London,1979,5513,331,308,228,324,6704,2038,5953,351,325,232,327,7188,1100,297,293,208,299,2197,0.184780782798589,0.846153846153846,0.901538461538462,0.896551724137931,0.914373088685015,0.305648302726767
E02000075,Bursted Wood,Bexley,London,1409,4869,476,533,353,581,6812,1401,5082,486,513,370,564,7015,1157,438,471,344,517,2927,0.227666273120819,0.901234567901234,0.91812865497076,0.92972972972973,0.916666666666667,0.417248752672844
E02000077,St Michael's,Bexley,London,1569,5304,341,329,237,434,6645,1569,5551,346,376,247,451,6971,1330,306,348,226,419,2629,0.239596469104666,0.884393063583815,0.925531914893617,0.91497975708502,0.929046563192905,0.377133840195094
E02000078,Barnehurst North,Bexley,London,1482,4924,399,389,265,463,6440,1527,5146,423,398,301,441,6709,1030,381,373,291,409,2484,0.200155460551885,0.900709219858156,0.937185929648241,0.966777408637874,0.927437641723356,0.370248919362051
E02000079,Bexleyheath Broadway,Bexley,London,1661,5392,357,353,293,712,7107,1688,5573,392,392,318,679,7354,1141,334,341,289,624,2729,0.204737125426162,0.852040816326531,0.869897959183674,0.908805031446541,0.91899852724595,0.371090562958934
E02000080,Welling,Bexley,London,2004,6599,424,403,347,561,8334,2060,6916,508,454,324,531,8733,1410,447,418,293,498,3066,0.203875072296125,0.87992125984252,0.920704845814978,0.904320987654321,0.937853107344633,0.35108210237032
E02000081,Barnehurst South,Bexley,London,1589,4852,380,413,304,548,6497,1648,5271,401,432,308,551,6963,1072,360,400,284,510,2626,0.203376968317207,0.897755610972569,0.925925925925926,0.922077922077922,0.925589836660617,0.377136291828235
E02000082,Falconwood,Bexley,London,1842,5849,391,421,264,461,7386,1880,6245,439,431,288,449,7852,1413,394,405,263,406,2881,0.226261008807046,0.89749430523918,0.939675174013921,0.913194444444444,0.904231625835189,0.366912888436067
E02000083,Crayford,Bexley,London,2527,7495,386,396,353,411,9041,2477,7751,390,434,324,396,9295,1328,332,385,286,342,2673,0.171332731260483,0.851282051282051,0.887096774193548,0.882716049382716,0.863636363636364,0.287573964497041
E02000084,Danson Park,Bexley,London,2162,6796,590,547,375,611,8919,2184,7145,598,582,426,578,9329,1591,524,538,402,537,3592,0.222673198040588,0.876254180602007,0.924398625429553,0.943661971830986,0.929065743944637,0.385035909529424
E02000085,Blackfen,Bexley,London,1591,5093,334,376,250,400,6453,1609,5358,376,372,288,391,6785,1145,334,348,264,355,2446,0.213699141470698,0.888297872340426,0.935483870967742,0.916666666666667,0.907928388746803,0.360501105379514
E02000086,Lamorbey,Bexley,London,1339,4542,386,398,264,352,5942,1360,4699,395,402,301,344,6141,1167,362,378,286,323,2516,0.248350712917642,0.916455696202532,0.940298507462687,0.950166112956811,0.938953488372093,0.409705259729686
E02000087,Bexley Village,Bexley,London,1380,4921,389,400,352,591,6653,1414,5238,400,422,362,627,7049,1157,357,394,334,595,2837,0.220885834287896,0.8925,0.933649289099526,0.922651933701657,0.94896331738437,0.402468435239041
E02000088,Albany Park,Bexley,London,1508,4779,389,379,315,428,6290,1472,5000,379,378,354,434,6545,1107,336,348,333,403,2527,0.2214,0.886543535620053,0.920634920634921,0.940677966101695,0.928571428571429,0.386096256684492
E02000089,Longlands & Halfway,Bexley,London,1548,4669,393,347,282,565,6256,1557,4994,403,393,319,552,6661,1229,375,371,303,522,2800,0.246095314377253,0.930521091811414,0.944020356234097,0.949843260188088,0.945652173913043,0.420357303708152
E02000090,Sidcup West,Bexley,London,1568,6008,386,436,339,746,7915,1525,5956,400,454,389,677,7876,1379,360,431,366,638,3174,0.23153122901276,0.9,0.949339207048458,0.940874035989717,0.942392909896603,0.402996444895886
E02000091,Sidcup East,Bexley,London,1657,6038,459,552,383,888,8320,1706,6055,500,584,434,865,8438,1548,457,543,410,829,3787,0.255656482246078,0.914,0.929794520547945,0.944700460829493,0.958381502890173,0.448803033894288
E02000092,Foots Cray Meadows,Bexley,London,1496,4197,293,267,190,340,5287,1444,4348,312,318,205,341,5524,1036,260,287,192,305,2080,0.238270469181233,0.833333333333333,0.90251572327044,0.936585365853659,0.894428152492669,0.376538740043447
E02006785,Wickham Street & East Wickham,Bexley,London,1245,4184,323,289,226,384,5406,1242,4447,318,302,245,359,5671,1036,282,274,224,331,2147,0.232966044524399,0.886792452830189,0.907284768211921,0.914285714285714,0.922005571030641,0.378592840768824
E02000093,Queensbury South,Brent,London,2496,6916,475,429,285,458,8563,2695,10067,599,437,349,520,11972,2248,482,362,290,437,3819,0.22330386411046,0.804674457429048,0.82837528604119,0.830945558739255,0.840384615384615,0.318994320080187
E02000094,Kingsbury East & Colindale,Brent,London,2043,5976,392,328,232,306,7234,2308,8867,422,313,240,376,10218,1803,316,242,202,278,2841,0.203338220367655,0.748815165876777,0.773162939297125,0.841666666666667,0.73936170212766,0.278038755137992
E02000095,Kingsbury West,Brent,London,2099,6091,475,374,293,562,7795,2219,8964,542,413,303,421,10643,1905,423,347,243,359,3277,0.212516733601071,0.780442804428044,0.840193704600484,0.801980198019802,0.852731591448931,0.307901907356948
E02000096,Kenton Woodcock Park,Brent,London,1467,4278,463,456,310,480,5987,1529,5878,465,471,327,480,7621,1562,386,412,282,422,3064,0.265736645117387,0.83010752688172,0.874734607218684,0.862385321100918,0.879166666666667,0.402046975462538
E02000097,Kingsbury South,Brent,London,1988,5731,395,316,222,375,7039,2033,7799,448,323,260,393,9223,1918,344,270,226,324,3082,0.245928965251955,0.767857142857143,0.835913312693499,0.869230769230769,0.824427480916031,0.334164588528678
E02000098,Barnhill The Avenue,Brent,London,1845,5239,373,326,219,345,6502,1907,7215,417,373,259,439,8703,1339,297,307,216,364,2523,0.185585585585586,0.712230215827338,0.823056300268097,0.833976833976834,0.829157175398633,0.289900034470872
E02000099,Preston Park & East Lane,Brent,London,2069,5695,301,229,178,400,6803,2245,7509,329,246,181,312,8577,1285,251,209,157,262,2164,0.171127979757624,0.762917933130699,0.849593495934959,0.867403314917127,0.83974358974359,0.252302669931211
E02000100,Northwick Park,Brent,London,1324,5917,439,385,272,388,7401,1362,6819,471,387,328,440,8445,1982,381,326,286,384,3359,0.290658454318815,0.808917197452229,0.842377260981912,0.871951219512195,0.872727272727273,0.397750148016578
E02000101,Forty Lane,Brent,London,2201,5963,391,347,251,409,7361,2415,8890,423,364,270,402,10349,1331,286,267,219,308,2411,0.149718785151856,0.67612293144208,0.733516483516484,0.811111111111111,0.766169154228856,0.232969369021162
E02000102,Welsh Harp,Brent,London,1924,4749,293,196,194,221,5653,2133,6768,319,219,176,272,7754,1069,212,166,127,200,1774,0.157949172576832,0.664576802507837,0.757990867579909,0.721590909090909,0.735294117647059,0.228785143151922
E02000103,Dollis Hill,Brent,London,2196,5815,342,257,238,384,7036,2357,8096,367,296,244,354,9357,1416,248,222,185,273,2344,0.174901185770751,0.67574931880109,0.75,0.758196721311475,0.771186440677966,0.250507641338036
E02000104,Wembley North,Brent,London,1471,4548,322,270,217,427,5784,1575,6413,328,277,232,388,7638,1302,249,214,196,328,2289,0.203025105254951,0.759146341463415,0.772563176895307,0.844827586206897,0.845360824742268,0.299685781618225
E02000105,Sudbury East,Brent,London,2214,6351,382,291,194,314,7532,2333,8836,373,308,202,328,10047,1591,273,237,164,257,2522,0.180058850158443,0.731903485254692,0.76948051948052,0.811881188118812,0.783536585365854,0.251020205036329
E02000106,Neasden,Brent,London,2453,7028,385,278,222,328,8241,2544,9846,427,346,220,333,11172,1235,273,252,156,255,2171,0.12543164736949,0.639344262295082,0.728323699421965,0.709090909090909,0.765765765765766,0.194325098460437
E02000107,Cricklewood Anson Road,Brent,London,2049,8256,404,368,217,257,9502,2057,10703,453,366,242,270,12034,1310,299,259,189,196,2253,0.122395590021489,0.660044150110375,0.707650273224044,0.78099173553719,0.725925925925926,0.187219544623567
E02000108,Sudbury West,Brent,London,1465,4173,301,237,158,222,5091,1575,6009,313,243,157,260,6982,1228,233,205,135,207,2008,0.204360126476951,0.744408945686901,0.843621399176955,0.859872611464968,0.796153846153846,0.287596677169865
E02000109,Tokyngton,Brent,London,2498,9698,388,294,267,379,11026,2867,15157,433,301,273,420,16584,1926,308,226,205,312,2977,0.127070000659761,0.711316397228637,0.750830564784053,0.750915750915751,0.742857142857143,0.179510371442354
E02000110,Dudden Hill,Brent,London,1510,5967,389,278,197,237,7068,1533,7552,362,333,219,266,8732,1169,265,257,167,196,2054,0.15479343220339,0.732044198895028,0.771771771771772,0.762557077625571,0.736842105263158,0.235226752175905
E02000111,Wembley West,Brent,London,2412,7194,464,290,224,362,8534,2819,11428,522,352,215,376,12893,1673,384,288,175,289,2809,0.146394819740987,0.735632183908046,0.818181818181818,0.813953488372093,0.768617021276596,0.217870162103467
E02000112,Wembley East,Brent,London,2000,7280,419,245,202,384,8530,2497,11632,521,299,226,429,13107,1982,372,222,185,325,3086,0.170392022008253,0.714011516314779,0.74247491638796,0.81858407079646,0.757575757575758,0.235446707866026
E02000113,St Raphaels,Brent,London,2600,5995,370,259,161,261,7046,2522,8129,366,269,183,256,9203,1331,212,175,118,175,2011,0.163734776725304,0.579234972677596,0.650557620817844,0.644808743169399,0.68359375,0.218515701401717
E02000114,Willesden Green,Brent,London,1657,7286,323,252,181,269,8311,1625,9115,345,269,163,261,10153,1073,234,198,117,186,1808,0.117718047174986,0.678260869565217,0.736059479553903,0.717791411042945,0.71264367816092,0.17807544568108
E02000115,Brondesbury,Brent,London,1277,6404,320,239,178,298,7439,1423,8406,347,286,191,291,9521,901,236,216,134,212,1699,0.107185343802046,0.680115273775216,0.755244755244755,0.701570680628272,0.728522336769759,0.178447642054406
E02000116,Roundwood Park,Brent,London,2101,6547,240,199,130,190,7306,2028,8351,298,211,163,208,9231,1066,181,141,114,128,1630,0.127649383307388,0.60738255033557,0.66824644549763,0.699386503067485,0.615384615384615,0.176578918860362
E02000117,Church End,Brent,London,3274,8193,429,267,290,415,9594,3240,10895,474,333,253,407,12362,1650,246,208,170,262,2536,0.151445617255622,0.518987341772152,0.624624624624625,0.671936758893281,0.643734643734644,0.205144798576282
E02000118,Alperton East,Brent,London,2259,7032,371,271,197,315,8186,2447,10236,488,293,207,316,11540,1659,346,231,165,255,2656,0.162075029308324,0.709016393442623,0.78839590443686,0.797101449275362,0.806962025316456,0.230155979202773
E02000119,Stonebridge,Brent,London,2512,5647,266,240,161,234,6548,2507,7886,320,243,170,295,8914,1380,184,151,107,185,2007,0.174993659650013,0.575,0.621399176954733,0.629411764705882,0.627118644067797,0.225151447161768
E02000120,Kilburn West,Brent,London,1619,6637,313,256,211,211,7628,1720,10055,327,320,165,244,11111,962,194,229,132,184,1701,0.0956737941322725,0.593272171253823,0.715625,0.8,0.754098360655738,0.153091530915309
E02000121,Alperton West,Brent,London,2372,7102,448,297,229,313,8389,2898,11479,470,323,222,327,12821,1635,339,270,176,259,2679,0.142434009931179,0.721276595744681,0.835913312693499,0.792792792792793,0.792048929663609,0.20895405974573
E02000122,Brondesbury Park,Brent,London,1462,5078,333,288,201,348,6248,1671,7423,383,322,215,352,8695,1111,259,230,165,259,2024,0.149669944766267,0.676240208877285,0.714285714285714,0.767441860465116,0.735795454545455,0.232777458309373
E02000123,Harlesden,Brent,London,3506,10779,440,304,239,347,12109,3412,13432,539,339,224,350,14884,1619,297,212,152,207,2487,0.120533055390113,0.551020408163265,0.625368731563422,0.678571428571429,0.591428571428572,0.167092179521634
E02000124,Queens Park,Brent,London,2020,6906,321,296,201,262,7986,2049,9036,419,306,237,276,10274,1029,264,231,155,207,1886,0.113877822045153,0.630071599045346,0.754901960784314,0.654008438818566,0.75,0.183570177146194
E02000125,Kensal Green,Brent,London,2008,6866,400,276,215,391,8148,2103,9062,421,311,224,389,10407,1247,284,216,160,275,2182,0.137607592143015,0.67458432304038,0.694533762057878,0.714285714285714,0.70694087403599,0.209666570577496
E02000126,Kilburn Park,Brent,London,1906,5049,230,207,153,215,5854,1866,7180,278,228,170,215,8071,750,146,135,103,127,1261,0.104456824512535,0.525179856115108,0.592105263157895,0.605882352941176,0.590697674418605,0.156238384338991
E02000127,Mottingham,Bromley,London,2229,5931,361,305,200,370,7167,2197,6529,368,356,221,368,7842,1298,283,307,200,313,2401,0.19880533006586,0.769021739130435,0.862359550561798,0.904977375565611,0.85054347826087,0.306171894924764
E02000128,Chislehurst North,Bromley,London,1626,4807,321,379,267,363,6137,1659,5120,344,402,270,380,6516,1172,301,367,253,351,2444,0.22890625,0.875,0.912935323383085,0.937037037037037,0.923684210526316,0.375076734192756
E02000130,Penge East,Bromley,London,1805,5789,365,345,193,260,6952,1770,6187,350,333,232,265,7367,1336,296,298,207,230,2367,0.215936641344755,0.845714285714286,0.894894894894895,0.892241379310345,0.867924528301887,0.321297678838062
E02000131,Crystal Palace Park,Bromley,London,1902,8039,239,238,124,145,8785,1876,8225,258,251,134,157,9025,1465,197,197,106,132,2097,0.178115501519757,0.763565891472868,0.784860557768924,0.791044776119403,0.840764331210191,0.232354570637119
E02000132,New Beckenham,Bromley,London,1764,7008,422,364,257,448,8499,1761,7274,397,429,273,419,8792,1526,327,372,240,382,2847,0.209788287049766,0.82367758186398,0.867132867132867,0.879120879120879,0.911694510739857,0.323817106460419
E02000133,Chislehurst West & Elmstead,Bromley,London,2040,6382,449,518,413,818,8580,2124,7072,535,530,464,752,9353,1592,469,491,428,702,3682,0.225113122171946,0.876635514018692,0.926415094339623,0.922413793103448,0.933510638297872,0.393670480059874
E02000134,Bromley North & Sundridge,Bromley,London,2407,8133,453,380,318,408,9692,2555,8842,475,461,313,402,10493,1579,368,399,276,354,2976,0.178579506898892,0.774736842105263,0.865509761388286,0.881789137380192,0.880597014925373,0.283617649861813
E02000135,Anerley North & Penge West,Bromley,London,2188,7457,345,237,157,306,8502,2036,7949,365,258,170,298,9040,1654,268,198,144,240,2504,0.208076487608504,0.734246575342466,0.767441860465116,0.847058823529412,0.805369127516778,0.276991150442478
E02000136,Chislehurst East & Hoblingwell Wood,Bromley,London,1122,3358,267,323,207,511,4666,1056,3653,275,281,264,545,5018,910,224,254,243,511,2142,0.249110320284698,0.814545454545455,0.903914590747331,0.920454545454545,0.937614678899082,0.426863292148266
E02000137,Shortlands Bromley Road,Bromley,London,1566,5314,372,426,309,552,6973,1585,5463,396,440,333,567,7199,1186,333,403,308,521,2751,0.217096833241809,0.840909090909091,0.915909090909091,0.924924924924925,0.918871252204586,0.382136407834421
E02000138,Beckenham East & Kelsey Park,Bromley,London,1246,5312,399,481,389,724,7305,1372,5775,440,485,431,721,7852,1429,379,426,400,681,3315,0.247445887445887,0.861363636363636,0.878350515463918,0.928074245939675,0.944521497919556,0.422185430463576
E02000139,Clock House & Cator Park,Bromley,London,1706,5358,270,252,155,251,6286,1689,5805,332,261,165,224,6787,1434,287,236,151,194,2302,0.24702842377261,0.864457831325301,0.904214559386973,0.915151515151515,0.866071428571429,0.339177839988213
E02000140,St Mary Cray North,Bromley,London,2319,5405,298,308,218,285,6514,2108,5863,313,310,209,293,6988,1377,249,273,180,265,2344,0.234862698277332,0.795527156549521,0.880645161290323,0.861244019138756,0.904436860068259,0.335432169433314
E02000141,Anerley South,Bromley,London,1505,5061,270,233,150,230,5944,1506,5280,279,253,166,235,6213,1223,221,214,144,203,2005,0.231628787878788,0.792114695340502,0.845849802371541,0.867469879518072,0.863829787234043,0.322710445839369
E02000142,Widmore,Bromley,London,1888,5388,440,396,272,468,6964,1826,6013,414,444,290,459,7620,1307,350,392,263,418,2730,0.217362381506735,0.845410628019324,0.882882882882883,0.906896551724138,0.910675381263617,0.358267716535433
E02000144,Bromley South,Bromley,London,1947,6663,351,393,269,401,8077,1983,7286,346,376,272,429,8709,1315,266,339,242,397,2559,0.180483118309086,0.76878612716763,0.901595744680851,0.889705882352941,0.925407925407925,0.293833964863934
E02000145,St Mary Cray East,Bromley,London,2433,5560,323,333,199,274,6689,2199,5932,343,324,244,289,7132,1304,268,279,211,265,2327,0.219824679703304,0.78134110787172,0.861111111111111,0.864754098360656,0.916955017301038,0.32627593942793
E02000146,Bickley West,Bromley,London,1954,6217,345,335,272,501,7670,2037,6783,363,351,259,523,8279,1404,287,304,234,471,2700,0.206988058381247,0.790633608815427,0.866096866096866,0.903474903474903,0.90057361376673,0.326126343761324
E02000147,Langley Park,Bromley,London,1673,4903,426,458,301,491,6579,1620,5445,444,513,343,520,7265,1343,388,475,319,486,3011,0.246648301193756,0.873873873873874,0.925925925925926,0.93002915451895,0.934615384615385,0.41445285615967
E02000148,Bickley East,Bromley,London,1366,3908,378,379,292,426,5383,1310,4297,378,403,319,446,5843,1029,333,374,303,409,2448,0.239469397253898,0.880952380952381,0.928039702233251,0.949843260188088,0.917040358744395,0.418962861543728
E02000149,St Mary Cray South,Bromley,London,1775,5130,333,355,226,364,6408,1754,5545,339,358,223,378,6843,1255,266,320,202,347,2390,0.226330027051398,0.784660766961652,0.893854748603352,0.905829596412556,0.917989417989418,0.349262019582055
E02000150,Eden Park & Bethlem,Bromley,London,1837,5419,381,367,265,434,6866,1758,5904,377,403,280,435,7399,1609,329,370,259,406,2973,0.272527100271003,0.872679045092838,0.918114143920596,0.925,0.933333333333333,0.401811055548047
E02000151,Petts Wood,Bromley,London,1619,4344,405,472,347,460,6028,1591,4779,424,445,380,515,6543,1022,372,413,360,489,2656,0.213852270349445,0.877358490566038,0.928089887640449,0.947368421052632,0.949514563106796,0.405930001528351
E02000152,Bromley Common,Bromley,London,1979,4947,277,297,173,330,6024,1859,5512,307,303,206,334,6662,1203,240,252,188,299,2182,0.218251088534107,0.781758957654723,0.831683168316832,0.912621359223301,0.895209580838323,0.327529270489343
E02000153,Hayes North,Bromley,London,1679,4650,424,435,254,404,6167,1754,5378,390,483,288,418,6957,1235,350,455,265,397,2702,0.2296392711045,0.897435897435897,0.942028985507246,0.920138888888889,0.949760765550239,0.388385798476355
E02000154,Orpington West,Bromley,London,1638,5250,418,430,335,446,6879,1620,5943,451,447,366,478,7685,1247,376,401,333,434,2791,0.209826686858489,0.83370288248337,0.897091722595078,0.909836065573771,0.907949790794979,0.363175016265452
E02000155,Orpington East,Bromley,London,1162,4068,379,440,327,554,5768,1218,4661,420,409,358,568,6416,1139,365,378,341,533,2756,0.244368161338769,0.869047619047619,0.924205378973105,0.952513966480447,0.938380281690141,0.429551122194514
E02000156,West Wickham,Bromley,London,2354,7067,659,687,467,983,9863,2265,7931,702,732,558,997,10920,2032,631,690,527,921,4801,0.256209809607868,0.898860398860399,0.942622950819672,0.944444444444444,0.923771313941825,0.439652014652015
E02000157,Crofton,Bromley,London,1661,4633,410,493,336,676,6548,1639,5297,433,481,393,694,7298,1301,390,455,373,644,3163,0.245610723050783,0.900692840646651,0.945945945945946,0.94910941475827,0.927953890489914,0.433406412715813
E02000158,Goddington,Bromley,London,1810,4460,359,432,299,503,6053,1747,5081,366,431,356,519,6753,1104,313,394,325,476,2612,0.217280062979728,0.855191256830601,0.91415313225058,0.912921348314607,0.917148362235067,0.38679105582704
E02000159,Keston,Bromley,London,1243,4062,407,437,303,508,5717,1227,4701,404,497,309,528,6439,1228,369,456,279,494,2826,0.261221016804935,0.913366336633663,0.917505030181086,0.902912621359223,0.935606060606061,0.438888026091008
E02000160,Hayes South & Coney Hall,Bromley,London,1538,4842,384,486,265,513,6490,1540,5275,429,495,300,530,7029,1353,394,467,290,486,2990,0.256492890995261,0.918414918414918,0.943434343434343,0.966666666666667,0.916981132075472,0.425380566225637
E02000161,Orpington South,Bromley,London,1905,5191,400,477,352,463,6883,1835,5736,421,501,360,513,7531,1340,365,478,339,477,2999,0.233612273361227,0.866983372921615,0.954091816367266,0.941666666666667,0.929824561403509,0.398220687823662
E02000162,Farnborough,Bromley,London,1334,3909,361,418,355,626,5669,1324,4556,373,416,339,644,6328,1072,313,386,321,605,2697,0.235294117647059,0.839142091152815,0.927884615384615,0.946902654867257,0.93944099378882,0.426201011378003
E02000163,Chelsfield & Green Street Green,Bromley,London,1480,4495,436,444,344,522,6241,1499,5108,474,475,372,531,6960,1156,406,438,356,496,2852,0.226311667971809,0.856540084388186,0.922105263157895,0.956989247311828,0.934086629001883,0.409770114942529
E02000165,Biggin Hill West,Bromley,London,1403,4339,398,391,206,240,5574,1393,4722,413,413,269,280,6097,1073,353,391,251,259,2327,0.227234222786955,0.854721549636804,0.946731234866828,0.933085501858736,0.925,0.381663113006397
E02006782,Plaistow (Bromley),Bromley,London,1679,4923,378,351,289,431,6372,1688,5709,398,410,277,456,7250,1151,306,370,252,400,2479,0.201611490628832,0.768844221105528,0.902439024390244,0.909747292418773,0.87719298245614,0.341931034482759
E02006787,Elmers End,Bromley,London,1867,5063,363,332,199,324,6281,1918,5664,370,379,219,328,6960,1484,322,344,205,306,2661,0.262005649717514,0.87027027027027,0.907651715039578,0.936073059360731,0.932926829268293,0.382327586206897
E02006789,Biggin Hill East & Cudham,Bromley,London,1112,3613,405,556,401,405,5380,1091,4089,418,575,428,533,6043,941,363,532,405,494,2735,0.230129616043042,0.868421052631579,0.925217391304348,0.946261682242991,0.926829268292683,0.452589773291412
E02000166,Highgate West,Camden,London,1735,5783,479,504,349,470,7585,1335,6571,439,439,293,370,8112,1223,350,367,260,313,2513,0.186120833967433,0.797266514806378,0.835990888382688,0.887372013651877,0.845945945945946,0.309787968441815
E02000167,Hampstead Town,Camden,London,2014,5901,392,464,362,551,7670,1512,6324,358,386,303,437,7808,1010,294,325,253,378,2260,0.159709044908286,0.82122905027933,0.841968911917098,0.834983498349835,0.864988558352403,0.289446721311475
E02000168,Tufnell Park West,Camden,London,1649,6724,386,387,237,304,8038,1268,7284,371,297,241,269,8462,1203,288,241,208,235,2175,0.165156507413509,0.776280323450135,0.811447811447811,0.863070539419087,0.87360594795539,0.257031434649019
E02000169,Frognal,Camden,London,2340,5883,345,395,282,526,7431,1763,6126,307,335,278,394,7440,897,232,264,233,347,1973,0.146425073457395,0.755700325732899,0.788059701492537,0.838129496402878,0.880710659898477,0.265188172043011
E02000170,Fortune Green,Camden,London,1852,6949,348,294,241,309,8141,1555,7831,333,289,219,266,8938,995,239,220,181,230,1865,0.127059123994381,0.717717717717718,0.761245674740485,0.82648401826484,0.864661654135338,0.208659655403893
E02000171,Mansfield Road & Park Hill Road,Camden,London,1805,6341,388,382,248,349,7708,1445,6909,327,334,234,260,8064,1174,251,278,196,231,2130,0.169923288464322,0.767584097859327,0.832335329341317,0.837606837606838,0.888461538461538,0.264136904761905
E02000172,Kentish Town West,Camden,London,2625,8432,358,343,247,397,9777,2151,9934,388,307,200,322,11151,1513,275,257,162,260,2467,0.15230521441514,0.708762886597938,0.8371335504886,0.81,0.807453416149068,0.221235763608645
E02000173,Fitzjohns & Royal Free,Camden,London,2066,6919,341,284,231,389,8164,1706,7633,242,261,226,305,8667,1172,179,201,184,258,1994,0.153543822874361,0.739669421487603,0.770114942528736,0.814159292035398,0.845901639344262,0.230068074304834
E02000174,Kentish Town East,Camden,London,1718,7619,379,300,192,259,8749,1423,8862,339,241,196,220,9858,1196,241,197,167,181,1982,0.134958248702325,0.710914454277286,0.817427385892116,0.852040816326531,0.822727272727273,0.201054980726314
E02000175,West Hampstead,Camden,London,1625,8935,367,324,191,259,10076,1428,9351,305,278,180,189,10303,1057,208,214,151,152,1782,0.113036038926318,0.681967213114754,0.769784172661871,0.838888888888889,0.804232804232804,0.17295933223333
E02000176,Belsize Park,Camden,London,1380,5466,271,325,218,280,6560,1168,5860,226,249,177,230,6742,754,158,193,146,202,1453,0.128668941979522,0.699115044247788,0.775100401606426,0.824858757062147,0.878260869565217,0.215514684070009
E02000177,Chalk Farm,Camden,London,1964,7101,337,343,251,462,8494,1576,8295,322,294,212,353,9476,1229,239,240,181,268,2157,0.148161543098252,0.742236024844721,0.816326530612245,0.85377358490566,0.759206798866856,0.227627691008865
E02000178,Kilburn Grange,Camden,London,1801,7832,335,327,149,229,8872,1457,9116,303,282,181,199,10081,999,199,208,133,155,1694,0.109587538394032,0.656765676567657,0.73758865248227,0.734806629834254,0.778894472361809,0.168038885031247
E02000179,Adelaide Road,Camden,London,1618,4885,243,324,191,335,5978,1202,5442,248,230,159,243,6322,795,172,181,133,205,1486,0.146085997794928,0.693548387096774,0.786956521739131,0.836477987421384,0.843621399176955,0.235052198671307
E02000180,Camden Road South,Camden,London,1644,7559,303,260,166,229,8517,1246,7403,282,231,164,189,8269,954,215,188,143,143,1643,0.128866675672025,0.762411347517731,0.813852813852814,0.871951219512195,0.756613756613757,0.198693917039545
E02000181,South Hampstead,Camden,London,1754,6740,278,254,162,298,7732,1436,7753,280,270,165,218,8686,1028,196,219,140,178,1761,0.132593834644654,0.7,0.811111111111111,0.848484848484848,0.81651376146789,0.202740041446005
E02000182,Swiss Cottage,Camden,London,1895,6000,244,330,178,427,7179,1670,7397,236,224,197,312,8366,949,143,163,154,267,1676,0.12829525483304,0.605932203389831,0.727678571428571,0.781725888324873,0.855769230769231,0.20033468802295
E02000183,Primrose Hill,Camden,London,1581,5846,421,383,305,349,7304,1330,6613,358,343,275,333,7922,1119,267,275,229,276,2166,0.16921215787086,0.745810055865922,0.801749271137026,0.832727272727273,0.828828828828829,0.273415804089876
E02000184,Camden Street & Elm Village,Camden,London,1670,8324,251,235,113,226,9149,1306,9974,268,214,130,185,10771,1196,196,164,107,150,1813,0.119911770603569,0.73134328358209,0.766355140186916,0.823076923076923,0.810810810810811,0.168322347042986
E02000185,Kilburn East,Camden,London,2009,6787,396,365,277,357,8182,1813,8277,369,342,238,294,9520,1017,252,260,180,228,1937,0.122870605291772,0.682926829268293,0.760233918128655,0.756302521008403,0.775510204081633,0.203466386554622
E02000186,Camden Town & Mornington Crescent,Camden,London,1112,6526,230,215,183,234,7388,852,6220,229,166,146,162,6923,813,180,128,120,130,1371,0.130707395498392,0.786026200873362,0.771084337349398,0.821917808219178,0.802469135802469,0.198035533728153
E02000187,Somers Town,Camden,London,2395,8113,353,223,209,305,9203,1839,9502,308,214,161,220,10405,1414,232,171,131,181,2129,0.148810776678594,0.753246753246753,0.799065420560748,0.813664596273292,0.822727272727273,0.204613166746756
E02000188,Euston,Camden,London,1736,6469,272,165,163,255,7324,1297,7454,259,175,125,182,8195,1139,179,134,97,138,1687,0.152803863697344,0.691119691119691,0.765714285714286,0.776,0.758241758241758,0.205857230018304
E02000189,Gray's Inn Road,Camden,London,1292,5343,190,128,97,177,5935,817,7429,150,147,82,129,7937,622,117,124,67,107,1037,0.0837259388881411,0.78,0.843537414965986,0.817073170731707,0.829457364341085,0.130653899458234
E02000190,Bloomsbury East,Camden,London,1063,6941,310,266,161,233,7911,710,9907,239,216,145,186,10693,795,181,176,118,160,1430,0.0802462905016655,0.757322175732218,0.814814814814815,0.813793103448276,0.860215053763441,0.13373234826522
E02000191,Fitzrovia East & Bloomsbury West,Camden,London,686,7495,227,189,130,158,8199,406,9939,175,135,118,126,10493,862,119,95,84,100,1260,0.0867290471878459,0.68,0.703703703703704,0.711864406779661,0.793650793650794,0.120080053368913
E02000192,Hatton Garden & Theobalds Road,Camden,London,1338,6637,350,248,159,264,7658,1010,7068,297,219,131,189,7904,836,209,175,110,143,1473,0.118279569892473,0.703703703703704,0.799086757990868,0.83969465648855,0.756613756613757,0.186361336032389
E02000193,"Holborn, St Giles & Bloomsbury South",Camden,London,766,6883,318,346,198,227,7972,577,8737,283,242,178,183,9623,901,192,187,146,139,1565,0.103124642325741,0.678445229681979,0.772727272727273,0.820224719101124,0.759562841530055,0.162631196092695
E02000194,Crystal Palace Triangle,Croydon,London,1881,6565,322,257,191,275,7610,1917,7907,342,309,203,307,9068,1270,245,251,161,253,2180,0.160617174655369,0.716374269005848,0.812297734627832,0.793103448275862,0.824104234527687,0.240405822673136
E02000195,Upper Norwood,Croydon,London,1974,6370,459,370,265,434,7898,2015,7577,503,422,305,508,9315,1412,373,333,247,370,2735,0.186353438036162,0.74155069582505,0.789099526066351,0.809836065573771,0.728346456692913,0.293612453032743
E02000196,Norbury East,Croydon,London,1577,5318,348,278,211,323,6478,1656,6764,404,313,235,380,8096,968,259,230,172,278,1907,0.143110585452395,0.641089108910891,0.73482428115016,0.731914893617021,0.731578947368421,0.235548418972332
E02000197,Norbury West,Croydon,London,2131,6186,411,313,240,361,7511,2053,7897,416,367,250,394,9324,1032,254,268,190,288,2032,0.130682537672534,0.610576923076923,0.73024523160763,0.76,0.730964467005076,0.217932217932218
E02000198,Thornton Heath North West,Croydon,London,2212,5718,272,175,166,214,6545,2150,7402,318,242,154,247,8363,1116,206,170,113,168,1773,0.150770062145366,0.647798742138365,0.702479338842975,0.733766233766234,0.680161943319838,0.212005261269879
E02000199,Thornton Heath North East,Croydon,London,1906,5575,317,208,131,205,6436,1876,7237,369,288,191,243,8328,1076,237,222,141,153,1829,0.148680392427802,0.642276422764228,0.770833333333333,0.738219895287958,0.62962962962963,0.21962055715658
E02000200,South Norwood Hill,Croydon,London,1842,6014,271,266,161,332,7044,1775,6988,311,266,189,299,8053,1099,219,206,146,236,1906,0.157269605037207,0.704180064308682,0.774436090225564,0.772486772486773,0.789297658862876,0.236681981870111
E02000201,South Norwood Central,Croydon,London,2416,6060,270,185,121,222,6858,2101,6823,327,233,138,220,7741,768,208,168,106,164,1414,0.112560457276858,0.636085626911315,0.721030042918455,0.768115942028986,0.745454545454546,0.182663738535073
E02000202,Thornton Heath West,Croydon,London,1849,5471,338,265,216,344,6634,1936,7453,399,310,212,360,8734,979,263,215,152,243,1852,0.131356500737958,0.659147869674186,0.693548387096774,0.716981132075472,0.675,0.212044882070071
E02000203,Thornton Heath Central,Croydon,London,1911,5244,301,227,167,256,6195,1851,6776,334,274,183,299,7866,887,211,199,137,206,1640,0.13090318772137,0.631736526946108,0.726277372262774,0.748633879781421,0.688963210702341,0.208492245105517
E02000204,West Thornton North,Croydon,London,2238,6249,402,271,227,324,7473,2258,8547,455,330,251,374,9957,1225,290,228,185,270,2198,0.143325143325143,0.637362637362637,0.690909090909091,0.737051792828685,0.72192513368984,0.220749221653108
E02000206,Selhurst North,Croydon,London,2527,6568,336,210,204,379,7697,2527,8227,397,266,180,279,9349,989,237,193,143,188,1750,0.120213929743527,0.596977329974811,0.725563909774436,0.794444444444444,0.673835125448029,0.187185795272222
E02000207,Woodside & Ashburton,Croydon,London,2094,6141,322,213,173,195,7044,1884,7171,345,226,175,217,8134,920,237,170,127,150,1604,0.128294519592804,0.686956521739131,0.752212389380531,0.725714285714286,0.691244239631336,0.197196951069584
E02000208,University Hospital & Queen's Road,Croydon,London,2898,7219,274,176,162,215,8046,2910,9246,340,241,150,252,10229,1161,198,168,98,159,1784,0.125567813108371,0.582352941176471,0.697095435684647,0.653333333333333,0.630952380952381,0.17440610030306
E02000209,West Thornton South & Ampere Way,Croydon,London,2219,5740,312,195,101,214,6562,2209,7620,333,234,171,208,8566,1173,189,178,130,153,1823,0.153937007874016,0.567567567567568,0.760683760683761,0.760233918128655,0.735576923076923,0.21281811814149
E02000210,Addiscombe North,Croydon,London,1867,5698,301,207,157,224,6587,1904,6682,340,257,157,240,7676,831,233,196,132,184,1576,0.124363962885364,0.685294117647059,0.762645914396887,0.840764331210191,0.766666666666667,0.205315268368942
E02000211,Monks Orchard,Croydon,London,1371,4870,487,474,346,520,6697,1399,5358,491,487,381,526,7243,1018,406,431,339,461,2655,0.189996267263904,0.826883910386965,0.885010266940452,0.889763779527559,0.876425855513308,0.366560817340881
E02000212,Broad Green & Waddon Marsh,Croydon,London,2540,6096,246,165,142,178,6827,2535,8136,293,208,153,192,8982,1028,151,144,100,134,1557,0.126352015732547,0.515358361774744,0.692307692307692,0.65359477124183,0.697916666666667,0.173346693386774
E02000213,Selhurst South & West Croydon,Croydon,London,2908,7786,268,214,139,160,8567,2953,10388,329,282,199,296,11494,1053,176,202,137,210,1778,0.101366961879091,0.534954407294833,0.716312056737589,0.688442211055276,0.70945945945946,0.15468940316687
E02000214,Addiscombe East,Croydon,London,1188,3901,346,276,189,317,5029,1192,4524,358,331,210,338,5761,662,279,289,182,282,1694,0.146330680813439,0.779329608938548,0.873111782477341,0.866666666666667,0.834319526627219,0.29404617253949
E02000215,Addiscombe West,Croydon,London,2230,8069,367,298,251,373,9358,2462,9642,432,351,237,400,11062,1038,269,265,184,293,2049,0.107654013690106,0.622685185185185,0.754985754985755,0.776371308016878,0.7325,0.185228710902188
E02000216,Park Hill & Lloyd Park,Croydon,London,1463,4236,334,301,263,499,5633,1604,5406,323,318,263,473,6783,696,212,250,206,375,1739,0.128745837957825,0.656346749226006,0.786163522012579,0.783269961977186,0.792811839323467,0.256376234704408
E02000217,Croydon Minster & Waddon North,Croydon,London,2996,8549,288,203,152,203,9395,2763,9522,327,246,158,219,10472,969,171,172,107,141,1560,0.101764335223693,0.522935779816514,0.699186991869919,0.677215189873418,0.643835616438356,0.148968678380443
E02000218,Shirley East,Croydon,London,1625,3966,347,244,160,264,4981,1523,4653,339,270,189,269,5720,719,277,238,163,235,1632,0.154523963034601,0.817109144542773,0.881481481481482,0.862433862433863,0.87360594795539,0.285314685314685
E02000219,Shirley West,Croydon,London,1100,4307,502,539,405,609,6362,1175,4916,505,556,427,661,7065,927,448,500,383,581,2839,0.188567941415785,0.887128712871287,0.899280575539568,0.896955503512881,0.878971255673223,0.401840056617127
E02000220,Central Croydon,Croydon,London,2629,9688,300,271,171,333,10763,2777,11374,375,286,203,345,12583,1059,190,207,151,264,1871,0.0931070863372604,0.506666666666667,0.723776223776224,0.74384236453202,0.765217391304348,0.148692680600811
E02000221,Waddon South,Croydon,London,2655,6872,308,328,223,394,8125,2578,7954,363,345,225,431,9318,1028,188,267,167,328,1978,0.129243148101584,0.517906336088154,0.773913043478261,0.742222222222222,0.761020881670534,0.212277312728053
E02000222,Croham,Croydon,London,1687,5595,304,290,196,266,6651,1665,6028,352,291,199,287,7157,833,273,240,170,247,1763,0.138188453881885,0.775568181818182,0.824742268041237,0.85427135678392,0.860627177700349,0.246332262121
E02000223,New Addington North,Croydon,London,2781,5003,219,172,172,238,5804,2557,6236,246,179,171,225,7057,1027,176,142,135,181,1661,0.16468890314304,0.715447154471545,0.793296089385475,0.789473684210526,0.804444444444444,0.235369137027065
E02000224,Purley North,Croydon,London,1829,5296,297,261,155,254,6263,1884,6111,315,292,201,211,7130,879,239,244,170,179,1711,0.143838978890525,0.758730158730159,0.835616438356164,0.845771144278607,0.848341232227488,0.239971949509116
E02000225,New Addington Central,Croydon,London,1820,4665,295,290,208,251,5709,1744,5496,335,301,218,266,6616,1109,262,257,191,208,2027,0.201783114992722,0.782089552238806,0.853820598006645,0.876146788990826,0.781954887218045,0.306378476420798
E02000226,Selsdon,Croydon,London,1258,4548,469,449,312,491,6269,1411,5509,500,480,352,535,7376,968,424,433,318,481,2624,0.175712470502814,0.848,0.902083333333333,0.903409090909091,0.899065420560748,0.355748373101952
E02000227,Forestdale,Croydon,London,2365,7032,582,611,360,507,9092,2403,8058,611,660,422,535,10286,1473,510,583,369,476,3411,0.182799702159345,0.834697217675941,0.883333333333333,0.874407582938389,0.889719626168224,0.331615788450321
E02000228,Sanderstead,Croydon,London,1476,4391,466,531,335,584,6307,1555,4990,472,524,381,617,6984,906,421,490,356,577,2750,0.181563126252505,0.891949152542373,0.935114503816794,0.934383202099738,0.93517017828201,0.393757159221077
E02000229,New Addington South,Croydon,London,1794,4038,262,210,161,264,4935,1719,4718,255,205,149,269,5596,888,189,175,128,215,1595,0.188215345485375,0.741176470588235,0.853658536585366,0.859060402684564,0.799256505576208,0.285025017869907
E02000230,Purley Central,Croydon,London,2083,6644,516,483,319,573,8535,2070,7327,551,483,359,585,9305,1266,438,420,318,523,2965,0.172785587552887,0.79491833030853,0.869565217391304,0.885793871866295,0.894017094017094,0.318645889306824
E02000231,Woodcote,Croydon,London,1327,4565,469,434,294,494,6256,1458,5442,493,448,312,498,7193,1197,406,400,286,453,2742,0.219955898566703,0.823529411764706,0.892857142857143,0.916666666666667,0.909638554216867,0.381203948283053
E02000232,Selsdon Park & Hamsey Green,Croydon,London,1190,3624,403,385,255,410,5077,1168,4183,349,446,263,440,5681,842,302,411,240,402,2197,0.201290939517093,0.865329512893983,0.92152466367713,0.91254752851711,0.913636363636364,0.386727688787185
E02000233,Kenley North,Croydon,London,1413,3951,282,233,151,348,4965,1431,4349,294,248,193,334,5418,753,224,223,171,297,1668,0.173143251322143,0.761904761904762,0.899193548387097,0.886010362694301,0.889221556886228,0.307862679955703
E02000234,Coulsdon,Croydon,London,1941,5560,410,410,240,387,7007,2101,6412,402,442,311,377,7944,1186,303,398,282,348,2517,0.184965689332502,0.753731343283582,0.900452488687783,0.906752411575563,0.923076923076923,0.316842900302115
E02000235,Kenley South,Croydon,London,1349,4321,378,353,234,331,5617,1347,4796,374,361,276,358,6165,799,326,331,263,318,2037,0.166597164303586,0.871657754010695,0.916897506925208,0.952898550724638,0.888268156424581,0.330413625304136
E02000236,Woodmansterne,Croydon,London,1853,4884,438,405,241,315,6283,2041,5743,433,423,273,346,7218,1199,339,396,245,317,2496,0.208775901096988,0.782909930715935,0.936170212765957,0.897435897435897,0.916184971098266,0.345802161263508
E02000237,Old Coulsdon,Croydon,London,1469,4280,464,489,365,522,6120,1509,4843,462,484,398,534,6721,1094,346,441,376,494,2751,0.225893041503201,0.748917748917749,0.911157024793388,0.944723618090452,0.925093632958801,0.409314090165154
E02006788,South Norwood Park,Croydon,London,1790,4968,273,227,125,200,5793,1720,5837,275,261,145,189,6707,793,198,206,96,127,1420,0.135857461024499,0.72,0.789272030651341,0.662068965517241,0.671957671957672,0.211719099448338
E02000238,Whitton Avenue West,Ealing,London,2151,6086,355,312,208,252,7213,2271,8202,385,315,221,263,9386,1348,284,256,185,227,2300,0.164350158497927,0.737662337662338,0.812698412698413,0.83710407239819,0.863117870722433,0.245045812912849
E02000239,Horsenden,Ealing,London,1730,5670,380,341,271,375,7037,1818,7373,428,385,275,407,8868,1411,329,307,237,346,2630,0.191373931913739,0.768691588785047,0.797402597402598,0.861818181818182,0.85012285012285,0.296571944068561
E02000240,Northolt West,Ealing,London,2568,6252,390,286,223,322,7473,2696,8578,430,348,237,296,9889,1557,326,292,208,251,2634,0.181510841688039,0.758139534883721,0.839080459770115,0.877637130801688,0.847972972972973,0.266356557791486
E02000241,Northolt East,Ealing,London,1520,4312,273,208,164,233,5190,1579,5636,308,241,164,253,6602,1013,239,206,141,219,1818,0.179737402413059,0.775974025974026,0.854771784232365,0.859756097560976,0.865612648221344,0.275371099666768
E02000242,Bilton Road,Ealing,London,1425,4495,313,216,143,232,5399,1427,5868,370,242,150,257,6887,1075,262,196,123,219,1875,0.183197000681663,0.708108108108108,0.809917355371901,0.82,0.852140077821012,0.272252069115725
E02000243,Greenford North,Ealing,London,1782,5371,369,270,216,405,6631,1779,7020,411,319,228,355,8333,1258,294,253,199,307,2311,0.179202279202279,0.715328467153285,0.793103448275862,0.87280701754386,0.864788732394366,0.27733109324373
E02000244,Perivale,Ealing,London,1558,4884,353,303,150,272,5962,1698,6297,324,327,208,256,7412,955,234,247,173,204,1813,0.151659520406543,0.722222222222222,0.755351681957187,0.831730769230769,0.796875,0.244603345925526
E02000245,Northolt South,Ealing,London,2343,5081,273,192,146,274,5966,2511,6951,317,229,153,225,7875,1189,219,172,126,174,1880,0.171054524528845,0.690851735015773,0.751091703056769,0.823529411764706,0.773333333333333,0.238730158730159
E02000246,Kingshill Avenue,Ealing,London,2319,5198,323,230,177,298,6226,2345,6999,342,301,200,282,8124,1290,255,237,152,223,2157,0.184312044577797,0.745614035087719,0.787375415282392,0.76,0.790780141843972,0.265509601181684
E02000247,Greenford West,Ealing,London,2734,6334,425,294,239,496,7788,2806,8707,400,368,238,473,10186,1448,290,285,185,384,2592,0.166302974618123,0.725,0.774456521739131,0.777310924369748,0.81183932346723,0.254466915374043
E02000248,Hanger Hill East,Ealing,London,1583,5189,306,240,140,280,6155,1707,6846,314,294,191,311,7956,918,218,222,148,250,1756,0.134092900964067,0.694267515923567,0.755102040816326,0.774869109947644,0.803858520900322,0.22071392659628
E02000249,Greenford South,Ealing,London,1648,4639,273,240,233,386,5771,1758,6380,310,270,238,380,7578,1130,228,225,213,318,2114,0.177115987460815,0.735483870967742,0.833333333333333,0.894957983193277,0.836842105263158,0.278965426233835
E02000250,Pitshanger,Ealing,London,1352,3646,389,311,206,321,4873,1387,4820,405,350,247,383,6205,965,349,315,215,340,2184,0.200207468879668,0.861728395061728,0.9,0.870445344129555,0.887728459530026,0.351974214343272
E02000251,Greenford Ravenor Park,Ealing,London,1596,4670,328,250,205,308,5761,1759,6918,421,312,213,348,8212,1232,331,269,166,278,2276,0.178086152067071,0.786223277909739,0.862179487179487,0.779342723004695,0.798850574712644,0.277155382367267
E02000252,North Acton,Ealing,London,1934,8743,346,220,161,262,9732,2122,12812,376,244,180,280,13892,1177,234,169,141,229,1950,0.0918669996877927,0.622340425531915,0.692622950819672,0.783333333333333,0.817857142857143,0.140368557443133
E02000253,Cuckoo Park,Ealing,London,2294,5562,384,337,260,420,6963,2433,7657,445,361,280,380,9123,1359,341,291,240,319,2550,0.177484654564451,0.766292134831461,0.806094182825485,0.857142857142857,0.839473684210526,0.279513317987504
E02000254,Southall North,Ealing,London,1798,5332,406,316,225,308,6587,2066,8379,501,361,243,378,9862,1700,388,301,204,314,2907,0.202888172812985,0.774451097804391,0.833795013850416,0.839506172839506,0.830687830687831,0.29476779557899
E02000255,Drayton Green & Cleveland,Ealing,London,2031,5610,414,359,276,443,7102,2180,7653,441,424,290,377,9185,1373,349,359,240,305,2626,0.179406768587482,0.791383219954649,0.846698113207547,0.827586206896552,0.809018567639257,0.285900925421884
E02000256,Ealing Broadway West,Ealing,London,1669,6107,312,255,219,323,7216,1578,8120,357,338,212,371,9398,1248,258,270,178,297,2251,0.153694581280788,0.722689075630252,0.798816568047337,0.839622641509434,0.800539083557952,0.239519046605661
E02000257,Ealing Broadway East,Ealing,London,2563,10169,535,398,394,563,12059,2791,13590,587,492,389,596,15654,1634,420,392,328,486,3260,0.120235467255335,0.715502555366269,0.796747967479675,0.84318766066838,0.815436241610738,0.208253481538265
E02000258,Acton Noel Road & Lynton Road,Ealing,London,1480,4718,267,214,123,228,5550,1700,6558,272,225,155,225,7435,675,181,169,124,180,1329,0.102927721866423,0.665441176470588,0.751111111111111,0.8,0.8,0.178749159381305
E02000259,Brent Valley,Ealing,London,1409,3746,278,216,130,205,4575,1477,5015,293,224,174,221,5927,983,231,196,152,196,1758,0.196011964107677,0.78839590443686,0.875,0.873563218390805,0.886877828054299,0.296608739665936
E02000260,Southall Park,Ealing,London,2167,5788,478,296,262,432,7256,2311,9192,519,370,265,413,10759,1586,385,303,216,334,2824,0.172541340295909,0.741811175337187,0.818918918918919,0.815094339622642,0.808716707021792,0.262477925457756
E02000261,East Acton,Ealing,London,2470,8396,345,336,225,328,9630,2797,12247,442,361,248,339,13637,1366,287,267,187,258,2365,0.111537519392504,0.649321266968326,0.739612188365651,0.754032258064516,0.761061946902655,0.173425240155459
E02000262,Acton Central,Ealing,London,1722,6083,285,230,203,274,7075,1968,8813,352,288,198,269,9920,1016,231,216,155,204,1822,0.115284239192103,0.65625,0.75,0.782828282828283,0.758364312267658,0.18366935483871
E02000263,Southall West,Ealing,London,2836,7602,504,360,280,469,9215,3405,14006,610,434,301,501,15852,2213,416,328,243,395,3595,0.158003712694559,0.681967213114754,0.755760368663594,0.807308970099668,0.788423153692615,0.226785263689124
E02000264,Ealing Common & Twyford Ave,Ealing,London,1342,5873,358,305,212,362,7110,1444,8062,397,318,232,392,9401,973,301,261,193,332,2060,0.120689655172414,0.758186397984887,0.820754716981132,0.831896551724138,0.846938775510204,0.219125624933518
E02000265,West Ealing,Ealing,London,2325,7008,345,341,237,326,8257,2445,9711,396,363,252,330,11052,1496,302,297,207,285,2587,0.154052105859335,0.762626262626263,0.818181818181818,0.821428571428571,0.863636363636364,0.234075280492219
E02000266,Norwood Green North & Windmill Park,Ealing,London,2691,7521,425,285,226,377,8834,3061,10815,492,377,246,379,12309,2030,372,301,196,280,3179,0.187702265372168,0.75609756097561,0.798408488063661,0.796747967479675,0.738786279683377,0.258266309204647
E02000267,Hanwell,Ealing,London,1733,4650,263,198,137,241,5489,1891,6245,331,250,174,205,7205,968,259,207,151,167,1752,0.155004003202562,0.782477341389728,0.828,0.867816091954023,0.814634146341463,0.243164469118668
E02000268,St Mary's,Ealing,London,1470,6105,397,396,193,352,7443,1657,7897,449,418,254,338,9356,1173,356,366,215,287,2397,0.148537419273142,0.792873051224944,0.875598086124402,0.846456692913386,0.849112426035503,0.256199230440359
E02000269,Northfields,Ealing,London,1648,5147,307,295,150,279,6178,1721,6754,356,309,191,297,7907,1075,281,269,161,257,2043,0.159164939295232,0.789325842696629,0.870550161812298,0.842931937172775,0.865319865319865,0.258378651827495
E02000270,South Acton,Ealing,London,1858,5154,255,182,148,248,5987,1925,8208,285,202,159,238,9092,940,187,151,125,172,1575,0.114522417153996,0.656140350877193,0.747524752475248,0.786163522012579,0.722689075630252,0.173229212494501
E02000271,Bedford Park,Ealing,London,1437,4522,286,287,148,212,5455,1528,6151,313,306,184,235,7189,787,241,271,156,203,1658,0.127946675337344,0.769968051118211,0.88562091503268,0.847826086956522,0.863829787234043,0.230630129364307
E02000272,Elthorne Park,Ealing,London,1342,3993,303,278,201,317,5092,1467,5156,353,298,235,345,6387,855,302,268,207,292,1924,0.165826221877424,0.855524079320113,0.899328859060403,0.880851063829787,0.846376811594203,0.301236887427587
E02000274,Southall Green,Ealing,London,3587,9154,532,365,241,312,10604,4261,16456,642,470,280,390,18238,2490,449,358,221,301,3819,0.151312591152163,0.699376947040499,0.761702127659575,0.789285714285714,0.771794871794872,0.209397960302665
E02000275,Norwood Green South,Ealing,London,1727,4648,360,293,208,342,5851,1886,7298,402,342,194,344,8580,1443,325,284,168,287,2507,0.197725404220334,0.808457711442786,0.830409356725146,0.865979381443299,0.834302325581395,0.292191142191142
E02000276,South Ealing,Ealing,London,1411,4300,255,166,155,185,5061,1495,5717,247,210,175,224,6573,841,189,164,149,191,1534,0.147105125065594,0.765182186234818,0.780952380952381,0.851428571428571,0.852678571428571,0.233378974593032
E02006791,Chiswick North West,Ealing,London,1244,4705,289,234,172,143,5543,1420,6675,296,259,198,184,7612,859,234,214,163,153,1623,0.128689138576779,0.790540540540541,0.826254826254826,0.823232323232323,0.831521739130435,0.213215974776668
E02000277,Bullsmoor & Freezywater,Enfield,London,1829,4868,265,226,204,278,5841,1839,5382,282,239,177,331,6411,1116,211,195,145,288,1955,0.207357859531773,0.74822695035461,0.815899581589958,0.819209039548023,0.870090634441088,0.304944626423335
E02000278,Turkey Street,Enfield,London,2633,6052,256,252,233,331,7124,2540,6981,308,264,223,341,8117,1548,232,230,187,281,2478,0.221744735711216,0.753246753246753,0.871212121212121,0.838565022421525,0.824046920821114,0.305285203893064
E02000279,Enfield Lock,Enfield,London,3594,8461,355,268,160,224,9468,3306,8717,374,279,180,221,9771,1840,290,220,146,171,2667,0.211081794195251,0.775401069518717,0.788530465949821,0.811111111111111,0.773755656108597,0.272950568007369
E02000280,Chase & Crews Hill,Enfield,London,1875,5161,420,370,290,391,6632,1908,5688,405,407,308,394,7202,1779,358,371,275,349,3132,0.312763713080169,0.883950617283951,0.911547911547912,0.892857142857143,0.885786802030457,0.434879200222161
E02000281,Carterhatch & Forty Hall,Enfield,London,2336,5749,312,290,214,320,6885,2314,6466,319,324,217,295,7621,1736,263,272,183,260,2714,0.268481286730591,0.824451410658307,0.839506172839506,0.84331797235023,0.88135593220339,0.356121243931243
E02000282,Enfield Wash,Enfield,London,2874,6203,264,253,195,177,7092,2812,7152,297,251,165,232,8097,1471,223,195,135,191,2215,0.205676733780761,0.750841750841751,0.776892430278885,0.818181818181818,0.823275862068966,0.273558107941213
E02000283,Brimsdown Avenue,Enfield,London,2165,5705,285,261,166,272,6689,2189,6478,317,269,201,297,7562,1524,238,214,166,227,2369,0.235257795615931,0.750788643533123,0.795539033457249,0.825870646766169,0.764309764309764,0.31327691087014
E02000284,Chase Side,Enfield,London,1856,5483,348,348,253,358,6790,1841,5906,402,353,250,371,7282,1769,341,304,224,334,2972,0.299525905858449,0.848258706467662,0.861189801699717,0.896,0.900269541778976,0.408129634715737
E02000285,Enfield Town North,Enfield,London,1201,4016,322,327,221,336,5222,1286,4669,362,338,247,356,5972,1579,335,315,223,318,2770,0.338188048832727,0.925414364640884,0.931952662721893,0.902834008097166,0.893258426966292,0.46383121232418
E02000286,Chase Farm & The Ridgeway,Enfield,London,1400,5285,427,437,352,611,7112,1506,5465,474,433,351,620,7343,1707,408,400,322,537,3374,0.312351326623971,0.860759493670886,0.92378752886836,0.917378917378917,0.866129032258064,0.459485224022879
E02000287,Cockfosters & Hadley Wood,Enfield,London,1349,4256,398,407,293,494,5848,1413,4809,438,404,322,553,6526,1291,369,355,293,504,2812,0.268454980245373,0.842465753424658,0.878712871287129,0.909937888198758,0.911392405063291,0.430891817346001
E02000288,Southbury East,Enfield,London,2983,7283,323,267,223,325,8421,2994,8411,341,296,245,369,9662,1997,252,238,200,278,2965,0.237427178694567,0.73900293255132,0.804054054054054,0.816326530612245,0.753387533875339,0.306872283171186
E02000289,World's End,Enfield,London,1266,3836,318,386,295,448,5283,1339,4602,337,387,270,459,6055,1525,292,354,230,409,2810,0.331377661886136,0.86646884272997,0.914728682170543,0.851851851851852,0.891067538126362,0.464079273327828
E02000290,Brimsdown & Ponders End,Enfield,London,2023,4153,216,136,110,177,4792,1977,4678,234,143,111,174,5340,1022,168,105,90,122,1507,0.218469431380932,0.717948717948718,0.734265734265734,0.810810810810811,0.701149425287356,0.282209737827715
E02000291,Enfield Town South & Bush Hill Park,Enfield,London,2193,6612,356,315,255,552,8090,2201,7106,411,366,270,507,8660,1749,320,307,230,446,3052,0.246130030959752,0.778588807785888,0.83879781420765,0.851851851851852,0.879684418145957,0.352424942263279
E02000292,Southbury West,Enfield,London,2253,6380,343,287,225,339,7574,2266,7161,391,357,261,352,8522,1802,321,296,226,297,2942,0.251640832285994,0.820971867007673,0.829131652661065,0.865900383141763,0.84375,0.345224125792068
E02000293,Grange Park,Enfield,London,1240,3777,372,362,259,441,5211,1231,4281,389,391,298,461,5820,1395,340,355,273,415,2778,0.325858444288718,0.874035989717224,0.907928388746803,0.916107382550335,0.900216919739696,0.477319587628866
E02000294,Ponders End South,Enfield,London,2299,6003,340,308,223,330,7204,2394,7167,425,311,238,345,8486,1497,294,254,190,276,2511,0.208874005860193,0.691764705882353,0.816720257234727,0.798319327731092,0.8,0.295899127975489
E02000295,Oakwood Park & Highlands,Enfield,London,1998,5471,330,310,290,548,6949,1897,6078,388,344,246,530,7586,1573,314,278,208,466,2839,0.258802237578151,0.809278350515464,0.808139534883721,0.845528455284553,0.879245283018868,0.374242024782494
E02000296,Southgate,Enfield,London,2032,6943,384,344,306,558,8535,2291,7728,392,377,327,570,9394,1670,290,307,264,477,3008,0.216097308488613,0.739795918367347,0.814323607427056,0.807339449541285,0.836842105263158,0.320204385778156
E02000297,Bury Street West & Village Road,Enfield,London,1712,5938,507,518,339,572,7874,1770,6608,610,531,366,596,8711,1899,513,458,327,514,3711,0.287378934624697,0.840983606557377,0.862523540489642,0.89344262295082,0.86241610738255,0.426013086901619
E02000298,Winchmore Hill,Enfield,London,1555,5008,412,363,286,436,6505,1658,5764,455,406,314,439,7378,1723,389,359,275,379,3125,0.298924358084663,0.854945054945055,0.884236453201971,0.875796178343949,0.863325740318907,0.423556519381946
E02000299,Lower Edmonton North,Enfield,London,2633,6506,340,212,191,280,7529,2847,8111,415,267,208,330,9331,1465,290,202,161,251,2369,0.180618912587844,0.698795180722892,0.756554307116105,0.774038461538462,0.760606060606061,0.253884899796378
E02000300,Haslebury North,Enfield,London,2270,5841,279,209,212,254,6795,2260,6630,342,255,186,265,7678,1257,237,191,151,212,2048,0.189592760180995,0.692982456140351,0.749019607843137,0.811827956989247,0.8,0.266736129200313
E02000301,Lower Edmonton South,Enfield,London,2927,6897,322,261,213,287,7980,2957,8401,390,326,192,311,9620,1594,253,247,141,234,2469,0.189739316748006,0.648717948717949,0.757668711656442,0.734375,0.752411575562701,0.256652806652807
E02000302,Palmers Green East,Enfield,London,1811,5394,388,342,292,325,6741,1852,6281,413,413,309,396,7812,1530,321,344,252,338,2785,0.243591784747652,0.777239709443099,0.832929782082324,0.815533980582524,0.853535353535354,0.356502816180236
E02000303,Haslebury South,Enfield,London,2282,5959,281,256,161,240,6897,2186,6894,366,270,163,247,7940,1358,259,197,114,186,2114,0.196982883666957,0.707650273224044,0.72962962962963,0.699386503067485,0.753036437246964,0.26624685138539
E02000304,Southgate Green,Enfield,London,1481,5004,419,417,282,475,6597,1481,5456,454,430,345,503,7188,1600,391,373,305,432,3101,0.293255131964809,0.861233480176212,0.867441860465116,0.884057971014493,0.858846918489066,0.43141346688926
E02000305,Palmers Green West,Enfield,London,1542,6217,339,306,208,354,7424,1793,7252,442,341,254,380,8669,1641,362,276,203,316,2798,0.226282404853833,0.819004524886878,0.809384164222874,0.799212598425197,0.831578947368421,0.322759257123082
E02000306,Edmonton Green,Enfield,London,2440,5893,260,226,175,244,6798,2587,7356,310,248,161,266,8341,1454,217,179,115,171,2136,0.197661772702556,0.7,0.721774193548387,0.714285714285714,0.642857142857143,0.256084402349838
E02000307,Tatem Park,Enfield,London,2235,6532,411,300,257,345,7845,2379,7565,413,364,252,390,8984,1607,325,293,192,315,2732,0.212425644415069,0.786924939467312,0.804945054945055,0.761904761904762,0.807692307692308,0.304096170970614
E02000308,New Southgate & Arnos Grove,Enfield,London,1678,5759,311,265,247,261,6843,1807,7202,345,297,234,326,8404,1248,250,243,195,254,2190,0.173285198555957,0.72463768115942,0.818181818181818,0.833333333333333,0.779141104294479,0.260590195145169
E02000309,Upper Edmonton East & Meridian Water,Enfield,London,3276,8174,333,220,181,226,9134,3304,9419,416,274,191,302,10602,1577,255,188,136,220,2376,0.167427540078565,0.612980769230769,0.686131386861314,0.712041884816754,0.728476821192053,0.224108658743633
E02000311,Bowes,Enfield,London,2219,7215,450,368,275,336,8644,2231,8038,459,435,240,395,9567,1540,364,349,200,314,2767,0.191589947748196,0.793028322440087,0.802298850574713,0.833333333333333,0.79493670886076,0.289223372007944
E02000312,Broomfield Park,Enfield,London,1987,8387,406,331,249,414,9787,2232,9383,484,382,254,473,10976,1618,363,293,210,392,2876,0.172439518277736,0.75,0.767015706806283,0.826771653543307,0.828752642706131,0.262026239067055
E02006793,Upper Edmonton West,Enfield,London,2690,6672,252,173,155,250,7502,2505,7381,324,217,155,272,8349,1393,220,150,110,206,2079,0.18872781465926,0.679012345679012,0.691244239631336,0.709677419354839,0.757352941176471,0.24901185770751
E02000313,Thamesmead Birchmere Park,Greenwich,London,1897,4999,218,182,92,82,5573,1754,4957,236,178,115,88,5574,886,159,141,98,77,1361,0.17873713939883,0.673728813559322,0.792134831460674,0.852173913043478,0.875,0.244169357732329
E02000314,West Thamesmead,Greenwich,London,4038,11411,242,176,107,100,12036,3868,13230,349,216,132,165,14092,1710,231,153,102,140,2336,0.129251700680272,0.66189111747851,0.708333333333333,0.772727272727273,0.848484848484848,0.165767811524269
E02000315,Abbey Wood North,Greenwich,London,2680,6045,263,232,134,295,6969,2689,7162,353,238,172,250,8175,1301,243,185,142,210,2081,0.181653169505725,0.688385269121813,0.777310924369748,0.825581395348837,0.84,0.254556574923547
E02000316,"Woolwich Dockyard, Arsenal & Charlton Riverside",Greenwich,London,2742,11540,307,222,147,171,12387,2529,11763,309,261,158,138,12629,1208,216,205,139,104,1872,0.10269489075916,0.699029126213592,0.78544061302682,0.879746835443038,0.753623188405797,0.148230263678834
E02000317,Woolwich West,Greenwich,London,2153,5308,225,185,137,158,6013,1936,6467,281,187,118,165,7218,989,205,154,99,140,1587,0.152930261326736,0.729537366548043,0.823529411764706,0.838983050847458,0.848484848484848,0.219866999168745
E02000318,Plumstead High Street,Greenwich,London,2367,7038,326,302,217,270,8153,2332,8293,420,314,249,259,9535,1306,318,258,201,201,2284,0.15748221391535,0.757142857142857,0.821656050955414,0.807228915662651,0.776061776061776,0.2395385422129
E02000319,Plumstead Common & Riverside,Greenwich,London,2638,8193,339,198,146,187,9063,2487,8383,331,253,162,162,9291,1276,249,202,136,123,1986,0.15221281164261,0.75226586102719,0.798418972332016,0.839506172839506,0.759259259259259,0.213755247013239
E02000320,Abbey Wood South,Greenwich,London,1762,4841,260,193,125,149,5568,1643,5094,294,204,145,151,5888,927,230,166,116,123,1562,0.181978798586572,0.782312925170068,0.813725490196078,0.8,0.814569536423841,0.265285326086957
E02000321,Woolwich Glyndon,Greenwich,London,1873,5123,223,188,134,162,5830,1893,5805,255,209,137,176,6582,920,181,178,113,132,1524,0.15848406546081,0.709803921568628,0.851674641148325,0.824817518248175,0.75,0.231540565177758
E02000323,Woolwich South,Greenwich,London,2769,7677,282,221,143,239,8562,2839,9526,348,251,155,241,10521,1376,237,166,119,184,2082,0.144446777241235,0.681034482758621,0.661354581673307,0.767741935483871,0.763485477178423,0.197889934416881
E02000324,Charlton Village,Greenwich,London,1924,5088,259,230,169,264,6010,1772,5685,316,229,160,229,6619,1319,245,187,144,194,2089,0.232014072119613,0.775316455696203,0.816593886462882,0.9,0.847161572052402,0.315606587097749
E02000326,Charlton Slopes,Greenwich,London,1659,5022,244,205,135,192,5798,1727,5768,264,243,159,201,6635,1363,203,207,137,160,2070,0.23630374479889,0.768939393939394,0.851851851851852,0.861635220125786,0.796019900497513,0.311981914091937
E02000327,Woolwich Common,Greenwich,London,1839,4888,155,112,53,82,5290,1646,4898,190,142,74,103,5407,747,129,121,56,72,1125,0.152511229073091,0.678947368421053,0.852112676056338,0.756756756756757,0.699029126213592,0.208063621231737
E02000328,Westcombe Park & Maze Hill,Greenwich,London,1290,4497,283,286,197,317,5580,1300,5012,287,275,200,257,6031,1270,234,239,174,231,2148,0.253391859537111,0.815331010452962,0.869090909090909,0.87,0.898832684824903,0.356159840822418
E02000329,Plumstead South,Greenwich,London,1312,4229,252,221,157,250,5109,1313,4330,313,225,189,219,5276,884,267,194,164,188,1697,0.204157043879908,0.853035143769968,0.862222222222222,0.867724867724868,0.858447488584475,0.321645185746778
E02000331,Hornfair Park,Greenwich,London,1831,5643,245,227,151,267,6533,1891,6250,286,234,155,225,7150,1303,226,202,142,202,2075,0.20848,0.79020979020979,0.863247863247863,0.916129032258065,0.897777777777778,0.29020979020979
E02000332,Shooters Hill,Greenwich,London,1582,4974,318,320,175,250,6037,1540,5092,334,278,211,248,6163,950,265,250,187,220,1872,0.186567164179104,0.793413173652695,0.899280575539568,0.886255924170616,0.887096774193548,0.303748174590297
E02000333,Blackheath Standard & Village,Greenwich,London,1159,4251,253,267,217,337,5325,1194,4573,221,269,223,353,5639,1140,186,235,212,320,2093,0.249289306800787,0.841628959276018,0.87360594795539,0.95067264573991,0.906515580736544,0.37116510019507
E02000334,Kidbrooke North,Greenwich,London,1343,4388,272,221,163,232,5276,1391,4935,308,261,173,237,5914,1204,250,230,149,222,2055,0.243971631205674,0.811688311688312,0.881226053639847,0.861271676300578,0.936708860759494,0.347480554616165
E02000335,Eltham North,Greenwich,London,1410,4242,308,326,200,346,5422,1386,4531,337,316,220,322,5726,933,290,302,208,288,2021,0.205914809092915,0.86053412462908,0.955696202531646,0.945454545454546,0.894409937888199,0.352951449528467
E02000337,Eltham West,Greenwich,London,1806,5340,313,325,217,264,6459,1933,6257,360,332,231,268,7448,1229,295,293,201,243,2261,0.19642000958926,0.819444444444445,0.882530120481928,0.87012987012987,0.906716417910448,0.303571428571429
E02000339,Eltham Park,Greenwich,London,1215,3883,337,328,177,367,5092,1288,4215,364,334,224,362,5499,889,310,300,205,331,2035,0.210913404507711,0.851648351648352,0.898203592814371,0.915178571428571,0.914364640883978,0.370067284960902
E02000340,Eltham South,Greenwich,London,1133,4190,317,378,199,450,5534,1256,4565,338,347,278,414,5942,825,271,323,253,377,2049,0.180722891566265,0.801775147928994,0.930835734870317,0.910071942446043,0.910628019323672,0.344833389431168
E02000341,Middlepark & Horn Park,Greenwich,London,2034,5198,266,311,159,250,6184,2079,5878,300,282,182,242,6884,1056,231,249,161,205,1902,0.179652943177952,0.77,0.882978723404255,0.884615384615385,0.847107438016529,0.276292852992446
E02000342,Avery Hill,Greenwich,London,1263,4168,243,179,127,228,4945,1265,4506,218,236,125,222,5307,769,181,212,108,195,1465,0.170661340434976,0.830275229357798,0.898305084745763,0.864,0.878378378378378,0.276050499340494
E02000343,Mottingham East,Greenwich,London,1530,4286,303,286,206,305,5386,1496,4873,315,330,216,305,6039,930,251,283,183,276,1923,0.190847527190642,0.796825396825397,0.857575757575758,0.847222222222222,0.904918032786885,0.318430203676105
E02000344,New Eltham,Greenwich,London,1309,4042,311,342,218,325,5238,1331,4411,334,355,238,312,5650,965,278,328,221,285,2077,0.218771253683972,0.832335329341317,0.923943661971831,0.928571428571429,0.913461538461539,0.367610619469027
E02006786,Wickham Lane & Winns Common,Greenwich,London,1790,4851,281,211,167,159,5669,1765,5599,295,227,156,205,6482,1106,221,186,141,166,1820,0.197535274156099,0.749152542372881,0.819383259911894,0.903846153846154,0.809756097560976,0.280777537796976
E02006927,Kidbrooke South,Greenwich,London,2436,6458,409,386,335,438,8026,2589,8464,442,434,345,466,10151,1420,325,373,304,418,2840,0.167769376181474,0.735294117647059,0.859447004608295,0.881159420289855,0.896995708154507,0.279775391587036
E02006928,Greenwich & Deptford Creekside,Greenwich,London,2112,9567,168,132,103,57,10027,2175,11804,229,170,94,106,12403,998,152,126,67,78,1421,0.084547610979329,0.663755458515284,0.741176470588235,0.712765957446809,0.735849056603774,0.114569055873579
E02006929,Greenwich Peninsula,Greenwich,London,2683,9560,230,192,124,230,10336,3005,12663,282,221,164,192,13522,1587,209,181,127,150,2254,0.125325752191424,0.74113475177305,0.819004524886878,0.774390243902439,0.78125,0.166691317852389
E02006930,Greenwich East,Greenwich,London,1782,6624,233,186,119,183,7345,1857,7974,253,210,134,145,8716,1260,201,161,108,121,1851,0.158013544018059,0.794466403162055,0.766666666666667,0.805970149253731,0.83448275862069,0.212368058742542
E02006931,Greenwich Town & Park,Greenwich,London,1783,6875,305,304,206,333,8023,1830,8077,338,311,220,289,9235,1011,248,251,179,245,1934,0.125170236473938,0.733727810650888,0.807073954983923,0.813636363636364,0.847750865051903,0.209420682187331
E02000345,Stamford Hill North,Hackney,London,3617,5317,232,228,125,160,6062,3804,6720,264,231,121,171,7507,516,149,163,76,126,1030,0.0767857142857143,0.564393939393939,0.705627705627706,0.628099173553719,0.736842105263158,0.137205275076595
E02000346,Woodberry Down & Manor House,Hackney,London,1857,5589,263,167,119,182,6320,1855,7371,251,202,106,160,8090,863,163,150,82,129,1387,0.117080450413784,0.649402390438247,0.742574257425743,0.773584905660377,0.80625,0.171446229913473
E02000347,Stamford Hill West,Hackney,London,3035,5076,221,220,93,213,5823,3227,6260,280,210,119,189,7058,555,173,153,95,148,1124,0.0886581469648562,0.617857142857143,0.728571428571429,0.798319327731092,0.783068783068783,0.159251912723151
E02000348,Stamford Hill South,Hackney,London,3328,5077,244,137,92,173,5723,3742,6856,238,184,107,165,7550,511,149,138,74,116,988,0.0745332555425904,0.626050420168067,0.75,0.691588785046729,0.703030303030303,0.130860927152318
E02000350,Stoke Newington East & Cazenove,Hackney,London,2305,7095,222,185,121,127,7750,2489,8723,274,209,122,176,9504,881,184,164,90,110,1429,0.100997363292445,0.671532846715328,0.784688995215311,0.737704918032787,0.625,0.150357744107744
E02000351,Brownswood,Hackney,London,1390,7810,204,167,110,172,8463,1440,8498,271,180,136,150,9235,1087,172,134,116,116,1625,0.127912449988233,0.634686346863469,0.744444444444445,0.852941176470588,0.773333333333333,0.175961017866811
E02000352,Clissold North,Hackney,London,1643,4847,221,180,112,229,5589,1490,5547,271,219,124,188,6349,766,200,179,99,142,1386,0.138092662700559,0.738007380073801,0.817351598173516,0.798387096774194,0.75531914893617,0.218302094818082
E02000353,Stoke Newington North,Hackney,London,1393,6010,244,201,110,223,6788,1495,7252,281,211,124,199,8067,897,210,170,96,159,1532,0.123690016547159,0.747330960854093,0.805687203791469,0.774193548387097,0.798994974874372,0.189909507871576
E02000354,Hackney Downs,Hackney,London,2036,7741,281,206,207,190,8625,1946,9099,324,222,157,208,10010,1098,203,162,110,142,1715,0.120672601384768,0.626543209876543,0.72972972972973,0.700636942675159,0.682692307692308,0.171328671328671
E02000355,Lower Clapton,Hackney,London,1621,6751,266,188,156,278,7639,1653,7904,295,233,135,251,8818,962,215,176,114,183,1650,0.121710526315789,0.728813559322034,0.755364806866953,0.844444444444445,0.729083665338646,0.187117260149694
E02000356,Clissold South,Hackney,London,1266,5584,190,150,93,128,6145,1252,6881,254,165,115,141,7556,983,194,124,91,110,1502,0.142857142857143,0.763779527559055,0.751515151515152,0.791304347826087,0.780141843971631,0.198782424563261
E02000357,Hackney Marshes,Hackney,London,1718,4058,246,208,134,189,4835,1611,5686,312,199,150,196,6543,626,185,146,109,139,1205,0.110094970102005,0.592948717948718,0.733668341708543,0.726666666666667,0.709183673469388,0.184166284578939
E02000358,Stoke Newington South,Hackney,London,1870,9093,276,240,187,248,10044,1984,11282,317,290,182,209,12280,1137,212,208,123,140,1820,0.100780003545471,0.668769716088328,0.717241379310345,0.675824175824176,0.669856459330144,0.148208469055375
E02000359,Homerton North,Hackney,London,1312,4776,166,150,121,155,5368,1352,5892,197,160,118,162,6529,649,139,114,88,108,1098,0.110149355057705,0.705583756345178,0.7125,0.745762711864407,0.666666666666667,0.168172767652014
E02000360,Amhurst Road & Pembury Estate,Hackney,London,2650,8476,355,204,169,291,9495,2495,10391,400,285,171,226,11473,1210,233,191,120,149,1903,0.116446925223751,0.5825,0.670175438596491,0.701754385964912,0.65929203539823,0.165867689357622
E02000361,Hackney Central,Hackney,London,1437,7089,231,121,106,152,7699,1300,8126,235,147,100,163,8771,865,142,107,77,114,1305,0.106448437115432,0.604255319148936,0.727891156462585,0.77,0.699386503067485,0.148785771291757
E02000362,Hackney Wick,Hackney,London,1457,5451,187,140,106,151,6035,1308,6358,199,149,104,149,6959,725,133,119,76,112,1165,0.11402956904687,0.668341708542714,0.798657718120805,0.730769230769231,0.751677852348993,0.167409110504383
E02000363,Homerton South,Hackney,London,2976,7918,348,217,150,269,8902,2854,10301,388,272,174,245,11380,1161,259,188,125,156,1889,0.112707504125813,0.667525773195876,0.691176470588235,0.718390804597701,0.636734693877551,0.165992970123023
E02000364,Dalston East,Hackney,London,1677,7725,354,261,225,220,8785,1570,8660,376,264,189,256,9745,1047,279,208,152,187,1873,0.120900692840647,0.742021276595745,0.787878787878788,0.804232804232804,0.73046875,0.192201128783992
E02000365,Dalston Kingsland & De Beauvoir,Hackney,London,1968,12344,361,326,195,294,13520,2072,14506,384,328,236,299,15753,1489,271,258,181,221,2420,0.102647180477044,0.705729166666667,0.786585365853659,0.766949152542373,0.739130434782609,0.153621532406526
E02000366,South Hackney,Hackney,London,1884,6464,289,206,154,277,7390,1725,7568,346,247,163,236,8560,908,235,210,137,187,1677,0.119978858350951,0.679190751445087,0.850202429149798,0.840490797546012,0.792372881355932,0.195911214953271
E02000367,London Fields & Mare Street,Hackney,London,2021,9106,220,175,103,87,9691,1826,11108,262,198,135,132,11835,1205,184,151,109,104,1753,0.108480374504861,0.702290076335878,0.762626262626263,0.807407407407407,0.787878787878788,0.148119983100972
E02000368,Haggerston East,Hackney,London,2020,7723,267,228,185,218,8621,1908,9107,337,266,158,221,10089,1132,222,192,114,166,1826,0.124299989019436,0.658753709198813,0.721804511278195,0.721518987341772,0.751131221719457,0.180989196154227
E02000369,Haggerston West & Kingsland Basin,Hackney,London,2646,11069,308,289,149,221,12036,2465,13272,373,260,184,249,14338,1251,247,179,139,180,1996,0.0942585895117541,0.662198391420912,0.688461538461539,0.755434782608696,0.72289156626506,0.139210489608035
E02000370,Hoxton & Wenlock,Hackney,London,1797,7665,209,159,77,153,8263,1611,8754,233,194,97,139,9417,813,161,147,72,100,1293,0.092871830020562,0.690987124463519,0.757731958762887,0.742268041237113,0.719424460431655,0.137304874163746
E02000371,Shoreditch,Hackney,London,1730,14066,208,175,99,191,14739,1586,16327,257,183,122,162,17051,1086,181,148,92,129,1636,0.0665155876768543,0.704280155642023,0.808743169398907,0.754098360655738,0.796296296296296,0.09594745176236
E02006918,Clapton Leaside,Hackney,London,2488,6387,176,145,109,145,6962,2086,6751,222,154,92,128,7347,694,135,103,60,80,1072,0.10279958524663,0.608108108108108,0.668831168831169,0.652173913043478,0.625,0.145909895195318
E02006921,Upper Clapton,Hackney,London,2953,5026,247,164,93,183,5713,2970,6234,266,190,130,152,6972,613,162,117,94,98,1084,0.0983317292268207,0.609022556390977,0.615789473684211,0.723076923076923,0.644736842105263,0.155479059093517
E02000372,Old Oak & Wormwood,Hammersmith and Fulham,London,1789,7068,295,242,137,258,8000,1858,10731,353,283,161,255,11783,1466,230,205,108,175,2184,0.136613549529401,0.651558073654391,0.724381625441696,0.670807453416149,0.686274509803922,0.185351777985233
E02000373,White City,Hammersmith and Fulham,London,1726,4289,189,161,98,165,4902,1766,6882,257,176,139,189,7643,794,161,116,82,101,1254,0.115373437954083,0.626459143968872,0.659090909090909,0.589928057553957,0.534391534391534,0.1640716995944
E02000374,Wormholt Road,Hammersmith and Fulham,London,1367,4625,232,183,149,211,5400,1325,6904,238,238,125,219,7724,928,156,178,99,165,1526,0.13441483198146,0.65546218487395,0.747899159663866,0.792,0.753424657534247,0.197566027964785
E02000375,Shepherd's Bush North,Hammersmith and Fulham,London,1435,4979,257,173,112,190,5711,1375,7726,276,208,119,208,8537,954,183,143,80,141,1501,0.123479161273622,0.66304347826087,0.6875,0.672268907563025,0.677884615384615,0.175822888602554
E02000376,Shepherd's Bush West,Hammersmith and Fulham,London,1081,5159,202,137,128,166,5792,1084,7621,233,178,116,174,8322,934,151,124,74,133,1416,0.122556095000656,0.648068669527897,0.696629213483146,0.637931034482759,0.764367816091954,0.17015140591204
E02000377,Askew,Hammersmith and Fulham,London,1484,5808,298,215,161,220,6702,1436,8109,285,234,150,215,8993,1141,176,183,109,151,1760,0.140707855469232,0.617543859649123,0.782051282051282,0.726666666666667,0.702325581395349,0.195707772712109
E02000378,Shepherd's Bush South,Hammersmith and Fulham,London,1062,4718,217,159,147,161,5402,1015,7220,256,217,147,167,8007,874,148,148,104,113,1387,0.121052631578947,0.578125,0.682027649769585,0.707482993197279,0.676646706586826,0.173223429499188
E02000379,Ravenscourt Park North,Hammersmith and Fulham,London,1671,5108,312,276,173,368,6237,1584,6319,293,275,212,294,7393,1038,220,235,171,243,1907,0.164266497863586,0.750853242320819,0.854545454545455,0.806603773584906,0.826530612244898,0.257946706343839
E02000380,Brackenbury,Hammersmith and Fulham,London,1214,3863,197,174,129,160,4523,1100,5060,203,207,134,193,5797,866,139,173,109,148,1435,0.171146245059289,0.684729064039409,0.835748792270531,0.813432835820896,0.766839378238342,0.24754183198206
E02000381,Brook Green,Hammersmith and Fulham,London,1603,5503,259,227,186,148,6323,1575,8327,308,270,182,236,9323,1038,213,193,140,180,1764,0.124654737600576,0.691558441558442,0.714814814814815,0.769230769230769,0.76271186440678,0.189209481926419
E02000382,Ravenscourt Park South,Hammersmith and Fulham,London,1077,4203,185,185,110,133,4816,981,5893,225,225,159,190,6692,885,160,179,130,162,1516,0.150178177498727,0.711111111111111,0.795555555555556,0.817610062893082,0.852631578947369,0.226539151225344
E02000383,West Kensington,Hammersmith and Fulham,London,1039,6620,306,355,212,337,7830,1175,9626,385,372,258,378,11019,1230,239,260,191,288,2208,0.127778932059007,0.620779220779221,0.698924731182796,0.74031007751938,0.761904761904762,0.200381159814865
E02000384,Hammersmith Broadway,Hammersmith and Fulham,London,1247,5244,242,248,149,323,6206,1238,8024,279,242,172,273,8990,1122,191,192,127,221,1853,0.139830508474576,0.684587813620072,0.793388429752066,0.738372093023256,0.80952380952381,0.206117908787542
E02000385,Barons Court,Hammersmith and Fulham,London,602,4793,169,128,97,81,5268,608,6733,168,141,98,113,7253,756,109,104,70,81,1120,0.112282786276548,0.648809523809524,0.73758865248227,0.714285714285714,0.716814159292035,0.154418861160899
E02000386,North End,Hammersmith and Fulham,London,1412,5817,256,216,151,187,6627,1367,8781,317,264,159,216,9737,976,196,165,110,136,1583,0.111149071859697,0.618296529968454,0.625,0.691823899371069,0.62962962962963,0.162575742014994
E02000387,Lillie Road & Greyhound Road,Hammersmith and Fulham,London,876,4503,150,181,122,148,5104,864,6545,225,161,142,159,7232,994,132,111,106,109,1452,0.151871657754011,0.586666666666667,0.68944099378882,0.746478873239437,0.685534591194969,0.200774336283186
E02000388,Fulham Broadway,Hammersmith and Fulham,London,1392,6274,279,273,169,305,7300,1313,8936,307,245,217,278,9983,823,182,165,157,218,1545,0.0920993733213966,0.592833876221499,0.673469387755102,0.723502304147465,0.784172661870504,0.154763097265351
E02000389,Fulham Reach,Hammersmith and Fulham,London,1525,5884,299,263,233,305,6984,1465,8346,330,303,247,302,9528,982,219,236,192,249,1878,0.117661155044333,0.663636363636364,0.778877887788779,0.777327935222672,0.824503311258278,0.197103274559194
E02000390,Fulham Aintree,Hammersmith and Fulham,London,1168,4559,158,176,115,140,5148,1144,6824,209,180,140,156,7509,571,128,117,104,111,1031,0.0836752637749121,0.61244019138756,0.65,0.742857142857143,0.711538461538462,0.137301904381409
E02000391,Parsons Green East & Eel Brook Common,Hammersmith and Fulham,London,1552,5585,280,265,156,234,6520,1477,7088,322,236,165,240,8051,631,224,186,135,196,1372,0.0890237020316027,0.695652173913044,0.788135593220339,0.818181818181818,0.816666666666667,0.17041361321575
E02000392,Parsons Green West,Hammersmith and Fulham,London,1839,6766,256,232,173,217,7644,1776,9611,283,230,179,223,10526,817,191,181,136,169,1494,0.0850067630839663,0.674911660777385,0.786956521739131,0.759776536312849,0.757847533632287,0.141934258027741
E02000393,Munster,Hammersmith and Fulham,London,1131,4185,178,140,119,175,4797,1229,6091,172,177,134,162,6736,477,116,144,109,132,978,0.0783122639960598,0.674418604651163,0.813559322033898,0.813432835820896,0.814814814814815,0.145190023752969
E02000394,Sands End & Chelsea Harbour,Hammersmith and Fulham,London,1804,6553,299,253,173,202,7480,1814,8656,295,241,171,211,9574,806,170,157,116,160,1409,0.0931146025878004,0.576271186440678,0.651452282157676,0.678362573099415,0.758293838862559,0.147169417171506
E02000395,Fulham Palace & Hurlingham Park,Hammersmith and Fulham,London,1112,4160,258,249,188,284,5139,974,5254,237,285,184,283,6243,429,178,234,152,249,1242,0.0816520746098211,0.751054852320675,0.821052631578947,0.826086956521739,0.879858657243816,0.198942815953868
E02000396,South Park,Hammersmith and Fulham,London,1667,4633,226,254,144,156,5413,1574,6294,256,227,166,168,7111,567,175,181,133,126,1182,0.0900857959961868,0.68359375,0.797356828193833,0.801204819277108,0.75,0.16622134720855
E02000397,Bowes Park,Haringey,London,1668,6107,249,191,141,205,6893,1610,7113,274,233,155,221,7996,899,188,177,129,162,1555,0.126388303106987,0.686131386861314,0.759656652360515,0.832258064516129,0.733031674208145,0.194472236118059
E02000398,Northumberland Park,Haringey,London,2027,5170,230,154,104,180,5838,1935,6530,265,187,126,183,7291,845,166,126,93,133,1363,0.129402756508423,0.626415094339623,0.67379679144385,0.738095238095238,0.726775956284153,0.186942806199424
E02000400,Bounds Green,Haringey,London,1710,5447,295,256,156,234,6388,1702,6765,326,262,196,248,7797,1043,239,218,160,197,1857,0.154175905395418,0.733128834355828,0.83206106870229,0.816326530612245,0.794354838709677,0.238168526356291
E02000401,Roundway,Haringey,London,1503,4440,231,161,111,158,5101,1441,5797,256,184,141,172,6550,917,176,144,106,128,1471,0.158185268242194,0.6875,0.782608695652174,0.75177304964539,0.744186046511628,0.224580152671756
E02000402,Tottenham Bruce Castle Park,Haringey,London,1470,4507,188,165,111,171,5142,1504,5765,286,173,113,175,6512,784,187,123,87,118,1299,0.135993061578491,0.653846153846154,0.710982658959538,0.769911504424779,0.674285714285714,0.199477886977887
E02000403,Wood Green North,Haringey,London,1454,6048,244,132,133,206,6763,1470,7152,253,196,133,207,7941,849,149,142,109,155,1404,0.118708053691275,0.588932806324111,0.724489795918367,0.819548872180451,0.748792270531401,0.176803928976199
E02000404,Scotch Estate,Haringey,London,1499,5424,244,219,147,205,6239,1418,6776,266,224,152,212,7630,806,173,171,120,169,1439,0.118949232585596,0.650375939849624,0.763392857142857,0.789473684210526,0.797169811320755,0.188597640891219
E02000405,Alexandra Park,Haringey,London,1513,4026,307,233,119,200,4885,1479,4834,301,253,179,204,5771,924,247,228,149,163,1711,0.191146048820852,0.820598006644518,0.901185770750988,0.832402234636871,0.799019607843137,0.296482412060302
E02000406,Noel Park,Haringey,London,1324,5186,216,169,129,152,5852,1198,6404,238,195,126,175,7138,819,161,141,102,137,1360,0.12788881948782,0.676470588235294,0.723076923076923,0.80952380952381,0.782857142857143,0.190529560100869
E02000407,Bruce Grove North,Haringey,London,1629,5271,208,142,154,205,5980,1719,6874,241,175,129,221,7640,834,155,130,84,152,1355,0.121326738434681,0.643153526970954,0.742857142857143,0.651162790697675,0.687782805429864,0.177356020942408
E02000408,Tottenham North West,Haringey,London,1870,5807,247,191,134,197,6576,1771,6738,268,232,136,212,7586,883,174,161,94,147,1459,0.131047788661324,0.649253731343284,0.693965517241379,0.691176470588235,0.693396226415094,0.19232797258107
E02000409,Lordship Lane & Broadwater Farm,Haringey,London,1300,4099,294,152,129,182,4856,1210,5471,308,192,131,176,6278,789,212,156,107,132,1396,0.144214951562786,0.688311688311688,0.8125,0.816793893129771,0.75,0.222363810130615
E02000410,Muswell Hill North,Haringey,London,1382,4370,274,230,153,205,5232,1369,5359,313,274,170,195,6311,1018,260,238,145,166,1827,0.189960813584624,0.830670926517572,0.868613138686131,0.852941176470588,0.851282051282051,0.28949453335446
E02000411,Tottenham Lea Valley,Haringey,London,2041,7994,230,222,142,160,8748,2114,9425,284,219,154,170,10252,1099,174,154,103,113,1643,0.116604774535809,0.612676056338028,0.703196347031963,0.668831168831169,0.664705882352941,0.160261412407335
E02000412,Wood Green South,Haringey,London,1295,5738,228,154,145,211,6476,1246,7324,227,171,130,204,8056,796,137,125,97,157,1312,0.108683779355543,0.60352422907489,0.730994152046784,0.746153846153846,0.769607843137255,0.162859980139027
E02000413,Fortis Green & Coldfall,Haringey,London,1793,4763,294,232,197,296,5782,1914,6075,346,271,217,325,7234,1102,265,233,197,282,2079,0.181399176954733,0.765895953757226,0.859778597785978,0.907834101382488,0.867692307692308,0.287392867016865
E02000414,Bruce Grove South,Haringey,London,1430,4981,213,168,111,185,5658,1488,6910,267,187,118,216,7698,844,175,143,87,140,1389,0.122141823444284,0.655430711610487,0.764705882352941,0.73728813559322,0.648148148148148,0.180436477007015
E02000415,Downhills Park,Haringey,London,1237,5234,258,217,109,231,6049,1250,6915,269,225,119,240,7768,830,177,168,89,193,1457,0.12002892263196,0.657992565055762,0.746666666666667,0.747899159663866,0.804166666666667,0.187564366632338
E02000416,Hornsey East,Haringey,London,1539,5735,287,237,178,158,6595,1581,7405,301,251,155,192,8304,1042,223,207,133,146,1751,0.140715732613099,0.740863787375415,0.824701195219124,0.858064516129032,0.760416666666667,0.210862235067437
E02000417,Muswell Hill South,Haringey,London,1188,4253,333,261,194,340,5381,1128,5164,324,299,216,279,6282,899,271,264,197,252,1883,0.174089852827266,0.83641975308642,0.882943143812709,0.912037037037037,0.903225806451613,0.299745304043298
E02000418,Hornsey West,Haringey,London,1052,3347,314,259,184,185,4289,1065,4238,334,295,193,223,5283,827,287,264,161,186,1725,0.195139216611609,0.859281437125748,0.894915254237288,0.83419689119171,0.834080717488789,0.326519023282226
E02000419,Harringay Ladder North,Haringey,London,1509,6715,220,187,141,202,7465,1567,8762,289,205,148,238,9642,914,190,158,104,175,1541,0.10431408354257,0.657439446366782,0.770731707317073,0.702702702702703,0.735294117647059,0.159821613773076
E02000420,Tottenham Green West,Haringey,London,1534,5853,303,257,137,167,6717,1484,7765,346,237,163,192,8703,1036,215,182,130,134,1697,0.133419188667096,0.621387283236994,0.767932489451477,0.797546012269939,0.697916666666667,0.194990233252901
E02000421,Tottenham Green East,Haringey,London,1624,5907,225,164,114,224,6634,1527,7470,265,171,125,241,8272,902,160,119,84,161,1426,0.120749665327979,0.60377358490566,0.695906432748538,0.672,0.66804979253112,0.172388781431335
E02000422,West Green & St Ann's,Haringey,London,1635,5911,239,201,158,236,6745,1626,7358,278,201,149,218,8204,868,179,135,108,156,1446,0.117966838814895,0.643884892086331,0.671641791044776,0.724832214765101,0.715596330275229,0.176255485129205
E02000423,Harringay East,Haringey,London,1094,5767,173,148,97,178,6363,1073,7558,243,158,102,183,8244,821,175,120,67,128,1311,0.108626620799153,0.720164609053498,0.759493670886076,0.656862745098039,0.699453551912568,0.159024745269287
E02000424,Hornsey Vale,Haringey,London,1234,4850,248,187,105,138,5528,1261,5966,301,213,132,142,6754,890,236,184,113,107,1530,0.149178679182032,0.78405315614618,0.863849765258216,0.856060606060606,0.753521126760563,0.226532425229494
E02000425,South Tottenham,Haringey,London,3095,4235,215,122,69,155,4796,3361,6162,207,171,102,153,6795,552,124,122,72,108,978,0.0895813047711782,0.599033816425121,0.713450292397661,0.705882352941177,0.705882352941177,0.1439293598234
E02000426,Highgate Wood,Haringey,London,1112,3828,277,340,222,330,4997,1187,5183,315,302,228,387,6415,1013,246,243,198,345,2045,0.195446652517847,0.780952380952381,0.804635761589404,0.868421052631579,0.891472868217054,0.318784099766173
E02000427,Harringay Ladder South,Haringey,London,991,5374,166,157,69,146,5912,1038,7193,206,173,92,174,7838,784,135,130,69,134,1252,0.108994856110107,0.655339805825243,0.751445086705202,0.75,0.770114942528736,0.159734626180148
E02000428,Harringay Warehouse District & Vartry,Haringey,London,1585,6002,169,168,125,198,6662,1709,7594,231,158,138,177,8298,809,150,117,97,111,1284,0.106531472214907,0.649350649350649,0.740506329113924,0.702898550724638,0.627118644067797,0.15473608098337
E02000429,Crouch End West,Haringey,London,1352,4564,287,302,164,224,5541,1363,5555,329,304,202,255,6645,836,262,264,175,215,1752,0.150495049504951,0.796352583586626,0.868421052631579,0.866336633663366,0.843137254901961,0.263656884875847
E02000430,Crouch End East,Haringey,London,1120,5224,266,205,123,134,5952,1161,6404,294,243,156,152,7249,883,227,200,125,117,1552,0.13788257339163,0.772108843537415,0.823045267489712,0.801282051282051,0.769736842105263,0.214098496344323
E02000431,Highgate East,Haringey,London,1069,4255,223,216,136,204,5034,907,5230,248,222,149,209,6058,737,188,187,126,186,1424,0.140917782026769,0.758064516129032,0.842342342342342,0.845637583892617,0.889952153110048,0.235061076262793
E02000432,Stroud Green,Haringey,London,910,4627,213,172,83,119,5214,865,6016,231,205,131,116,6699,720,176,175,89,80,1240,0.11968085106383,0.761904761904762,0.853658536585366,0.679389312977099,0.689655172413793,0.185102254067771
E02006794,White Hart Lane,Haringey,London,2231,5576,215,183,134,237,6345,2303,7269,274,196,132,215,8086,885,167,126,75,127,1380,0.121749896822121,0.609489051094891,0.642857142857143,0.568181818181818,0.590697674418605,0.170665347514222
E02000433,Stanmore Park,Harrow,London,1486,4476,413,509,378,968,6744,1625,5850,450,501,467,888,8156,1758,359,421,407,787,3732,0.300512820512821,0.797777777777778,0.840319361277445,0.87152034261242,0.886261261261261,0.457577243746935
E02000434,Canons Park,Harrow,London,1931,5922,487,403,306,560,7678,2108,7697,540,480,320,620,9657,1925,419,390,266,518,3518,0.250097440561258,0.775925925925926,0.8125,0.83125,0.835483870967742,0.364295329812571
E02000435,Stanmore Uxbridge Road,Harrow,London,1587,4600,405,391,295,495,6186,1537,5219,386,437,293,499,6834,1462,314,363,269,438,2846,0.280130293159609,0.813471502590674,0.830663615560641,0.918088737201365,0.877755511022044,0.416447175885279
E02000436,Hatch End North,Harrow,London,901,3114,398,433,259,438,4642,946,3668,401,418,296,435,5218,1282,351,369,274,400,2676,0.349509269356598,0.875311720698254,0.882775119617225,0.925675675675676,0.919540229885057,0.512840168646991
E02000437,Harrow Weald,Harrow,London,1773,5163,425,393,309,511,6801,1803,6228,450,438,332,525,7973,1598,381,370,293,469,3111,0.256583172768144,0.846666666666667,0.844748858447489,0.882530120481928,0.893333333333333,0.390191897654584
E02000438,Hatch End South,Harrow,London,1560,4732,433,328,271,559,6323,1680,5670,411,360,281,517,7239,1503,343,314,246,481,2887,0.265079365079365,0.834549878345499,0.872222222222222,0.875444839857651,0.93036750483559,0.398811990606437
E02000439,Edgware West,Harrow,London,2080,5758,352,285,223,346,6964,2356,7930,421,304,215,348,9218,1583,332,248,174,284,2621,0.199621689785624,0.788598574821853,0.81578947368421,0.809302325581395,0.816091954022989,0.284334996745498
E02000440,Belmont,Harrow,London,2064,5993,479,390,279,432,7573,2271,7279,577,403,309,447,9015,2108,499,348,258,387,3600,0.289600219810414,0.864818024263432,0.863523573200993,0.83495145631068,0.865771812080537,0.399334442595674
E02000441,Pinner Green,Harrow,London,1450,4195,387,384,246,426,5638,1577,5129,389,379,299,427,6623,1366,329,336,274,374,2679,0.266328719048548,0.845758354755784,0.886543535620053,0.916387959866221,0.875878220140515,0.404499471538578
E02000442,Queensbury East,Harrow,London,2041,6019,368,236,168,254,7045,2217,8266,406,295,196,293,9456,1905,322,256,167,254,2904,0.230462134043068,0.793103448275862,0.867796610169492,0.852040816326531,0.866894197952218,0.307106598984772
E02000443,Wealdstone North,Harrow,London,2532,6536,395,246,234,384,7795,2750,8625,419,315,263,435,10057,1619,305,252,214,347,2737,0.187710144927536,0.727923627684964,0.8,0.813688212927757,0.797701149425287,0.272148752112956
E02000444,Queensbury West,Harrow,London,1974,5435,448,328,211,385,6807,2070,6934,464,347,236,352,8333,1783,398,286,208,300,2975,0.257138736659937,0.857758620689655,0.824207492795389,0.88135593220339,0.852272727272727,0.357014280571223
E02000445,Wealdstone South,Harrow,London,2643,7285,366,319,248,437,8655,2774,8988,427,360,270,477,10522,1676,326,292,239,387,2920,0.186470850022252,0.763466042154567,0.811111111111111,0.885185185185185,0.811320754716981,0.277513780650067
E02000447,Headstone Lane,Harrow,London,1572,4482,351,368,222,287,5710,1750,5643,377,368,266,302,6956,1509,330,332,240,267,2678,0.267410951621478,0.875331564986737,0.902173913043478,0.902255639097744,0.884105960264901,0.384991374353076
E02000448,Pinner Central,Harrow,London,1409,4026,397,379,264,467,5533,1424,4511,380,409,302,521,6123,1395,329,376,270,485,2855,0.309244070050986,0.865789473684211,0.919315403422983,0.894039735099338,0.930902111324376,0.466274701943492
E02000449,Kenton East,Harrow,London,1665,5515,352,268,216,351,6702,1896,7097,428,316,229,347,8417,1762,355,271,194,300,2882,0.248273918557137,0.829439252336449,0.857594936708861,0.847161572052402,0.864553314121037,0.342402281097778
E02000451,North Harrow,Harrow,London,1237,4035,356,342,217,357,5307,1274,4801,405,350,260,347,6163,1368,359,323,237,325,2612,0.284940637367215,0.88641975308642,0.922857142857143,0.911538461538461,0.936599423631124,0.423819568392017
E02000452,Greenhill North,Harrow,London,1998,5837,271,204,172,223,6707,2267,8397,315,247,171,244,9374,1282,246,196,134,199,2057,0.152673573895439,0.780952380952381,0.793522267206478,0.783625730994152,0.815573770491803,0.219436739918925
E02000453,Pinner Road,Harrow,London,1821,5341,359,258,194,283,6435,1907,6811,382,291,190,297,7971,1379,287,242,165,245,2318,0.202466598150051,0.75130890052356,0.831615120274914,0.868421052631579,0.824915824915825,0.290804165098482
E02000454,Pinner South,Harrow,London,1580,4068,358,360,260,387,5433,1659,4795,397,345,294,399,6230,1484,347,322,272,366,2791,0.309489051094891,0.874055415617129,0.933333333333333,0.925170068027211,0.917293233082707,0.447993579454254
E02000455,Greenhill South,Harrow,London,2146,6906,278,287,244,360,8075,2444,9254,372,311,263,404,10604,1626,276,257,235,350,2744,0.175707802031554,0.741935483870968,0.82636655948553,0.893536121673004,0.866336633663366,0.258770275367786
E02000456,West Harrow,Harrow,London,1528,4706,315,243,177,313,5754,1533,5926,340,277,195,315,7053,1294,278,232,170,266,2240,0.218359770502869,0.817647058823529,0.837545126353791,0.871794871794872,0.844444444444445,0.317595349496668
E02000457,Rayners Lane North,Harrow,London,1283,4120,315,312,236,337,5320,1396,5459,393,301,266,376,6795,1424,323,260,239,334,2580,0.260853636197106,0.821882951653944,0.863787375415283,0.898496240601504,0.888297872340426,0.379690949227373
E02000459,South Harrow,Harrow,London,2126,6016,337,297,209,282,7141,2250,7226,372,317,200,286,8401,1469,282,260,173,244,2428,0.203293661776917,0.758064516129032,0.82018927444795,0.865,0.853146853146853,0.289013212712772
E02000460,Newton Farm,Harrow,London,1699,4420,237,197,108,197,5159,1909,5976,287,225,124,197,6809,1241,229,170,106,154,1900,0.207663989290495,0.797909407665505,0.755555555555556,0.854838709677419,0.781725888324873,0.27904244382435
E02000461,Harrow-on-the-Hill,Harrow,London,1573,5150,264,207,141,295,6057,1687,5766,266,238,159,277,6706,1107,217,204,140,243,1911,0.191987513007284,0.81578947368421,0.857142857142857,0.880503144654088,0.877256317689531,0.284968684759917
E02000462,Alexandra Park,Harrow,London,1445,4406,264,230,202,260,5362,1539,5969,325,245,197,300,7036,1168,250,205,170,252,2045,0.195677667951081,0.769230769230769,0.836734693877551,0.862944162436548,0.84,0.290648095508812
E02000463,Earlsmead,Harrow,London,1929,5308,348,274,189,248,6367,1992,6811,410,330,211,273,8035,1474,338,275,175,224,2486,0.216414623403318,0.824390243902439,0.833333333333333,0.829383886255924,0.82051282051282,0.309396390790293
E02006795,Rayners Lane South,Harrow,London,1678,5180,355,280,198,325,6338,1923,6680,416,311,228,332,7967,1523,335,276,207,287,2628,0.227994011976048,0.805288461538462,0.887459807073955,0.907894736842105,0.864457831325301,0.329860675285553
E02006882,Kenton West,Harrow,London,2699,9018,739,641,455,646,11499,3016,11878,854,716,482,738,14668,3172,714,609,405,627,5527,0.267048324633777,0.836065573770492,0.850558659217877,0.840248962655602,0.849593495934959,0.376806653940551
E02000464,Dagnam Park & Noak Hill,Havering,London,1790,4719,327,303,222,394,5965,1831,5233,330,326,236,375,6500,749,236,284,201,330,1800,0.143130135677432,0.715151515151515,0.871165644171779,0.851694915254237,0.88,0.276923076923077
E02000465,Petersfield Avenue & Duck Wood,Havering,London,2408,6009,340,279,164,263,7055,2326,6544,344,325,176,233,7622,955,225,266,157,198,1801,0.145935207823961,0.654069767441861,0.818461538461538,0.892045454545455,0.849785407725322,0.236289687745998
E02000466,Havering-atte-Bower & Chase Cross,Havering,London,2049,5451,370,414,282,431,6948,2027,6000,417,438,307,421,7583,1023,324,372,269,377,2365,0.1705,0.776978417266187,0.849315068493151,0.876221498371335,0.895486935866983,0.311881840960042
E02000467,Harold Hill East,Havering,London,3078,7118,363,329,171,301,8282,3170,7862,393,364,184,284,9087,1102,266,294,147,225,2034,0.140167896209616,0.676844783715013,0.807692307692308,0.798913043478261,0.792253521126761,0.223836249587323
E02000468,Collier Row & Park Farm,Havering,London,1774,5082,389,405,259,481,6616,1767,5513,396,429,271,451,7060,921,322,375,243,402,2263,0.167059677126791,0.813131313131313,0.874125874125874,0.896678966789668,0.891352549889135,0.320538243626062
E02000469,Harold Hill West,Havering,London,1792,4462,307,279,202,317,5567,1657,4821,297,309,236,294,5957,695,234,268,201,244,1642,0.144160962455922,0.787878787878788,0.867313915857605,0.851694915254237,0.829931972789116,0.275642101729058
E02000470,Harold Park & Harold Wood,Havering,London,1640,5912,445,459,360,557,7733,1763,6368,475,501,376,558,8278,815,389,460,340,497,2501,0.127983668341709,0.818947368421053,0.918163672654691,0.904255319148936,0.89068100358423,0.302126117419667
E02000471,Rise Park,Havering,London,1277,4342,508,531,364,576,6321,1329,4778,481,502,397,566,6724,911,405,456,368,530,2670,0.190665550439514,0.841995841995842,0.908366533864542,0.926952141057935,0.936395759717314,0.39708506841166
E02000472,Romford North,Havering,London,1928,5614,457,534,321,483,7409,1911,5872,481,497,346,440,7636,1023,401,451,312,407,2594,0.174216621253406,0.833679833679834,0.907444668008048,0.901734104046243,0.925,0.339706652697748
E02000473,Ardleigh Green,Havering,London,2069,6428,440,479,327,545,8219,2048,6783,507,479,352,544,8665,1042,443,432,324,499,2740,0.153619342473832,0.873767258382643,0.901878914405011,0.920454545454545,0.917279411764706,0.316214656664743
E02000474,Romford North West,Havering,London,2035,5743,349,376,252,507,7227,1949,5892,383,386,251,475,7387,988,275,314,221,430,2228,0.167684996605567,0.718015665796345,0.813471502590674,0.880478087649402,0.905263157894737,0.301610938134561
E02000475,Gidea Park,Havering,London,1728,6065,519,515,368,695,8162,1721,5929,506,516,410,661,8022,1071,417,474,385,607,2954,0.180637544273908,0.824110671936759,0.918604651162791,0.939024390243902,0.918305597579425,0.368237347294939
E02000476,Central Romford,Havering,London,2051,6938,328,313,237,427,8243,2055,6788,336,324,230,405,8083,1001,223,275,190,372,2061,0.147466116676488,0.663690476190476,0.848765432098766,0.826086956521739,0.918518518518519,0.254979586787084
E02000477,Romford East,Havering,London,1772,5924,493,498,366,513,7794,1726,6347,510,558,375,548,8338,1323,405,506,347,506,3087,0.208444934614779,0.794117647058824,0.906810035842294,0.925333333333333,0.923357664233577,0.370232669704965
E02000478,Emerson Park,Havering,London,845,3358,371,446,298,492,4965,917,3715,401,461,362,485,5424,1019,341,426,334,453,2573,0.274293405114401,0.850374064837905,0.924078091106291,0.922651933701657,0.934020618556701,0.474373156342183
E02000479,Romford South,Havering,London,2012,6480,328,288,184,328,7608,2036,6670,342,328,216,321,7877,1102,228,277,185,270,2062,0.165217391304348,0.666666666666667,0.844512195121951,0.856481481481482,0.841121495327103,0.261774787355592
E02000480,Rush Green,Havering,London,3083,8532,426,352,252,516,10078,3176,9141,474,392,276,465,10748,1630,298,327,245,396,2896,0.178317470736243,0.628691983122363,0.834183673469388,0.88768115942029,0.851612903225806,0.269445478228508
E02000481,Cranham East,Havering,London,1471,4709,410,418,368,744,6649,1587,5326,394,470,375,678,7243,1142,350,441,357,644,2934,0.214419827262486,0.888324873096447,0.938297872340426,0.952,0.949852507374631,0.405080767637719
E02000482,Upminster North & Cranham West,Havering,London,1140,3708,398,369,284,615,5374,1194,4117,403,403,278,592,5793,874,344,386,268,569,2441,0.212290502793296,0.853598014888337,0.957816377171216,0.964028776978417,0.961148648648649,0.421370619713447
E02000483,Hornchurch,Havering,London,1325,4899,450,399,306,614,6668,1404,5155,437,444,326,575,6937,1094,342,413,310,522,2681,0.212221144519884,0.782608695652174,0.93018018018018,0.950920245398773,0.907826086956522,0.386478304742684
E02000484,Hylands,Havering,London,1388,5384,403,421,292,428,6928,1464,5813,439,471,299,409,7431,1267,327,431,284,378,2687,0.217959745398245,0.744874715261959,0.915074309978769,0.949832775919733,0.924205378973105,0.36159332525905
E02000485,Upminster Bridge,Havering,London,1672,5414,364,384,292,516,6970,1604,5519,415,399,321,496,7150,1080,324,367,309,460,2540,0.195687624569668,0.780722891566265,0.919799498746867,0.962616822429906,0.92741935483871,0.355244755244755
E02000486,Elm Park East,Havering,London,1168,4678,401,411,297,546,6333,1193,4851,428,411,318,487,6495,1051,317,379,303,440,2490,0.216656359513502,0.740654205607477,0.922141119221411,0.952830188679245,0.903490759753593,0.38337182448037
E02000487,Upminster South & Corbets Tey,Havering,London,1277,4451,520,571,346,594,6482,1380,5073,501,606,412,626,7218,1059,431,581,398,602,3071,0.208752217622708,0.860279441117764,0.958745874587459,0.966019417475728,0.961661341853035,0.425464117484068
E02000488,Hacton,Havering,London,1229,4406,461,492,306,431,6096,1179,4681,479,524,353,476,6513,1033,384,501,328,446,2692,0.220679342020936,0.801670146137787,0.956106870229008,0.929178470254957,0.936974789915966,0.413327191770306
E02000489,Elm Park West,Havering,London,1872,5385,366,361,288,439,6839,1830,5888,388,378,304,437,7395,1272,260,333,287,385,2537,0.216032608695652,0.670103092783505,0.880952380952381,0.944078947368421,0.881006864988559,0.343069641649763
E02000490,South Hornchurch,Havering,London,1646,4765,336,404,289,545,6339,1667,5381,357,430,298,500,6966,1076,230,395,281,463,2445,0.199962832187326,0.644257703081233,0.918604651162791,0.942953020134228,0.926,0.35099052540913
E02000491,Hornchurch Marshes,Havering,London,2298,6098,368,367,308,415,7556,2248,6635,378,385,292,401,8091,1268,245,344,261,357,2475,0.191107761868877,0.648148148148148,0.893506493506493,0.893835616438356,0.890274314214464,0.305895439377086
E02000492,Rainham East & Wennington,Havering,London,1173,3848,338,380,291,463,5320,1204,4326,386,381,315,480,5888,955,310,333,291,453,2342,0.220758206195099,0.803108808290156,0.874015748031496,0.923809523809524,0.94375,0.397758152173913
E02000493,Rainham West,Havering,London,1673,4258,251,183,157,294,5143,1593,4649,263,214,164,270,5560,841,174,192,143,230,1580,0.180899118089912,0.661596958174905,0.897196261682243,0.871951219512195,0.851851851851852,0.284172661870504
E02000494,Ducks Hill,Hillingdon,London,1393,4418,476,461,340,592,6287,1438,5353,562,511,376,693,7495,1598,482,463,339,598,3480,0.298524192041846,0.857651245551601,0.906066536203523,0.901595744680851,0.862914862914863,0.464309539693129
E02000495,Northwood,Hillingdon,London,2088,6367,452,513,361,645,8338,2299,7554,505,519,388,696,9662,1645,396,445,341,600,3427,0.217765422292825,0.784158415841584,0.857418111753372,0.878865979381443,0.862068965517241,0.354688470296005
E02000496,Harefield,Hillingdon,London,1489,4684,380,425,255,463,6207,1504,5483,416,402,291,404,6996,1538,374,372,271,379,2934,0.280503374065293,0.899038461538462,0.925373134328358,0.93127147766323,0.938118811881188,0.419382504288165
E02000497,Northwood Hills,Hillingdon,London,1864,5704,384,391,312,570,7361,1970,6457,436,420,340,613,8266,1830,358,366,309,537,3400,0.283413349852873,0.821100917431193,0.871428571428572,0.908823529411765,0.876019575856444,0.411323493830148
E02000498,West Ruislip North,Hillingdon,London,1167,3647,390,375,244,328,4984,1242,4172,387,394,257,386,5596,1081,350,366,235,350,2382,0.259108341323106,0.904392764857881,0.928934010152284,0.914396887159533,0.906735751295337,0.42566118656183
E02000499,Eastcote,Hillingdon,London,1397,4545,377,413,304,568,6207,1449,5388,447,419,337,611,7202,1535,392,386,309,557,3179,0.284892353377877,0.876957494407159,0.921241050119332,0.916913946587537,0.911620294599018,0.44140516523188
E02000500,Ruislip,Hillingdon,London,1414,5042,438,435,329,579,6823,1410,5761,461,477,349,609,7657,1419,402,449,334,556,3160,0.246311404270092,0.872017353579176,0.941299790356394,0.95702005730659,0.912972085385879,0.41269426668408
E02000501,Ruislip Manor,Hillingdon,London,1708,5089,426,416,269,462,6662,1705,5862,417,369,304,453,7405,1510,363,338,288,419,2918,0.257591265779597,0.870503597122302,0.915989159891599,0.947368421052632,0.924944812362031,0.394058068872384
E02000502,West Ruislip South,Hillingdon,London,2008,5374,330,302,258,504,6768,2009,5968,368,332,244,509,7421,1322,305,297,217,465,2606,0.221514745308311,0.828804347826087,0.894578313253012,0.889344262295082,0.913555992141454,0.351165611103625
E02000503,Ruislip Gardens,Hillingdon,London,1847,5953,387,302,224,346,7212,1754,5940,407,334,213,355,7249,1354,342,310,191,323,2520,0.227946127946128,0.84029484029484,0.92814371257485,0.896713615023474,0.909859154929577,0.34763415643537
E02000504,Ickenham,Hillingdon,London,1514,4376,350,405,313,491,5935,1464,4900,379,413,331,498,6521,1282,347,377,313,466,2785,0.261632653061224,0.9155672823219,0.912832929782082,0.945619335347432,0.93574297188755,0.427081735930072
E02000506,Uxbridge Common & Swakeleys,Hillingdon,London,1340,4763,470,440,303,506,6482,1391,5430,518,444,353,524,7269,1511,454,399,329,482,3175,0.278268876611418,0.876447876447877,0.898648648648649,0.932011331444759,0.919847328244275,0.436786353005916
E02000507,Hillingdon North East,Hillingdon,London,1966,5152,340,282,191,327,6292,1984,5946,367,301,188,315,7117,1486,315,260,171,273,2505,0.249915909855365,0.858310626702997,0.863787375415283,0.909574468085106,0.866666666666667,0.351974146410004
E02000508,Uxbridge Central & Brunel,Hillingdon,London,2044,9073,292,259,180,299,10103,2239,10344,354,253,193,323,11467,1513,282,221,162,276,2454,0.146268368136118,0.796610169491525,0.873517786561265,0.839378238341969,0.854489164086687,0.214005406819569
E02000509,Uxbridge West,Hillingdon,London,1729,9575,295,204,164,219,10457,1841,9796,318,258,166,223,10761,1214,263,215,143,202,2037,0.123928133932217,0.827044025157233,0.833333333333333,0.86144578313253,0.905829596412556,0.189294675216058
E02000510,Hillingdon South,Hillingdon,London,1856,5934,341,392,248,452,7367,1888,6765,415,391,264,434,8269,1599,364,344,239,377,2923,0.236363636363636,0.87710843373494,0.879795396419437,0.90530303030303,0.868663594470046,0.353488934574918
E02000511,Charville,Hillingdon,London,2194,6460,320,325,255,441,7801,2267,7509,359,336,275,453,8932,1523,301,299,243,391,2757,0.202823278732188,0.838440111420613,0.889880952380952,0.883636363636364,0.863134657836645,0.308665472458576
E02000512,Hillingdon Heath,Hillingdon,London,2031,5640,288,278,231,290,6727,2028,6587,317,274,209,265,7652,1361,250,235,174,222,2242,0.206619098223774,0.788643533123028,0.857664233576642,0.832535885167464,0.837735849056604,0.292995295347622
E02000513,Yeading North,Hillingdon,London,2928,6326,242,242,129,230,7169,2672,7437,271,241,148,232,8329,1357,202,185,116,176,2036,0.18246604813769,0.745387453874539,0.767634854771784,0.783783783783784,0.758620689655172,0.244447112498499
E02000514,Yeading West,Hillingdon,London,2644,6996,355,267,213,342,8173,2718,8987,435,331,222,363,10338,1650,345,271,186,294,2746,0.18359853121175,0.793103448275862,0.818731117824773,0.837837837837838,0.809917355371901,0.2656219771716
E02000515,Yiewsley West,Hillingdon,London,2716,8274,379,307,229,304,9493,2928,9558,395,358,230,322,10863,1702,317,300,206,290,2815,0.178070726093325,0.80253164556962,0.837988826815642,0.895652173913044,0.900621118012422,0.259136518457148
E02000516,Yeading Brookside,Hillingdon,London,2242,5939,301,216,152,189,6797,2191,7339,346,266,158,211,8320,1249,269,214,138,165,2035,0.170186673933778,0.777456647398844,0.804511278195489,0.873417721518987,0.781990521327014,0.244591346153846
E02000517,Hayes End,Hillingdon,London,2766,6391,358,259,168,220,7396,2826,8155,402,315,216,327,9415,1464,323,262,184,259,2492,0.17952176578786,0.803482587064677,0.831746031746032,0.851851851851852,0.792048929663609,0.264684014869888
E02000518,Yiewsley East,Hillingdon,London,1938,5763,303,333,175,269,6843,2040,6829,364,336,215,304,8048,1491,299,297,195,263,2545,0.21833357739054,0.821428571428571,0.883928571428571,0.906976744186047,0.865131578947369,0.316227634194831
E02000519,Hayes Town North,Hillingdon,London,2174,5978,306,260,251,336,7131,2273,7656,370,336,222,370,8954,1344,288,269,168,283,2352,0.175548589341693,0.778378378378378,0.800595238095238,0.756756756756757,0.764864864864865,0.262675899039535
E02000520,Hayes Town & Lake Farm,Hillingdon,London,3562,9207,409,336,232,368,10552,3720,12296,465,376,242,388,13767,1849,338,282,192,296,2957,0.15037410540013,0.726881720430108,0.75,0.793388429752066,0.762886597938144,0.214788988160093
E02000521,West Drayton East,Hillingdon,London,3626,8815,322,276,164,283,9860,3668,11025,404,290,189,301,12209,2043,301,237,151,242,2974,0.18530612244898,0.745049504950495,0.817241379310345,0.798941798941799,0.803986710963455,0.243590793676796
E02000522,West Drayton West,Hillingdon,London,2426,6203,328,258,198,343,7330,2433,7366,393,308,223,388,8678,1311,332,264,190,329,2426,0.177979907683953,0.844783715012723,0.857142857142857,0.852017937219731,0.847938144329897,0.279557501728509
E02000523,Hayes South,Hillingdon,London,2814,7981,357,268,229,250,9085,2797,10650,470,305,215,302,11942,1520,323,219,179,237,2478,0.142723004694836,0.687234042553192,0.718032786885246,0.832558139534884,0.78476821192053,0.207502930832356
E02000524,"Heathrow, Hardmonsworth & Sipson",Hillingdon,London,1660,5727,260,214,177,283,6661,1613,6682,296,228,149,198,7553,1033,230,195,126,182,1766,0.15459443280455,0.777027027027027,0.855263157894737,0.845637583892617,0.919191919191919,0.233814378392692
E02000525,Harlington & Cranford Cross,Hillingdon,London,2632,6935,308,253,173,240,7909,2612,8722,369,278,162,257,9788,1422,280,223,137,209,2271,0.163036000917221,0.758807588075881,0.802158273381295,0.845679012345679,0.813229571984436,0.232018798528811
E02006796,South Ruislip,Hillingdon,London,2049,5918,320,342,251,401,7232,2059,7125,371,338,278,406,8518,1387,290,298,246,363,2584,0.194666666666667,0.78167115902965,0.881656804733728,0.884892086330935,0.894088669950739,0.303357595679737
E02000526,Chiswick North East,Hounslow,London,1567,5693,382,330,200,312,6917,1637,7300,404,366,260,324,8654,1108,338,321,230,278,2275,0.151780821917808,0.836633663366337,0.877049180327869,0.884615384615385,0.858024691358025,0.262884215391726
E02000528,Brentford East,Hounslow,London,2655,8343,521,371,259,311,9805,2977,10563,527,420,300,320,12130,1825,401,343,244,259,3072,0.17277288649058,0.760910815939279,0.816666666666667,0.813333333333333,0.809375,0.25325638911789
E02000529,Heston North,Hounslow,London,2195,5661,378,261,213,280,6793,2498,8414,442,317,207,288,9668,1720,357,271,176,243,2767,0.204421202757309,0.807692307692308,0.854889589905363,0.85024154589372,0.84375,0.286201903185768
E02000530,North Hyde & North Cranford,Hounslow,London,2071,4535,254,190,123,208,5310,2250,6547,296,209,134,190,7376,1199,220,164,105,157,1845,0.183137314800672,0.743243243243243,0.784688995215311,0.783582089552239,0.826315789473684,0.25013557483731
E02000531,Brentford Central,Hounslow,London,1968,7335,408,312,244,364,8663,2314,9224,462,386,267,373,10712,1643,357,324,233,326,2883,0.178122289679098,0.772727272727273,0.839378238341969,0.872659176029963,0.873994638069705,0.269137415982076
E02000532,Chiswick South East,Hounslow,London,1745,5787,432,433,234,333,7219,1861,7259,478,432,324,333,8826,1277,395,372,286,289,2619,0.175919548147128,0.826359832635983,0.861111111111111,0.882716049382716,0.867867867867868,0.296736913664174
E02000533,Chiswick South West,Hounslow,London,1617,5534,391,372,205,277,6779,1835,6882,436,391,255,288,8252,1276,358,331,220,255,2440,0.185411217669282,0.821100917431193,0.846547314578005,0.862745098039216,0.885416666666667,0.295685894328648
E02000534,Brentford West & Osterley Park,Hounslow,London,1578,5314,291,284,211,272,6372,1745,6515,356,324,244,359,7798,1312,294,280,211,303,2400,0.201381427475058,0.825842696629213,0.864197530864198,0.864754098360656,0.844011142061281,0.307771223390613
E02000535,Heston West,Hounslow,London,1805,6105,434,308,266,331,7444,2227,8831,540,374,291,377,10413,1666,426,307,242,311,2952,0.188653606613068,0.788888888888889,0.820855614973262,0.831615120274914,0.824933687002653,0.283491789109767
E02000536,Heston Central & Lampton West,Hounslow,London,1941,6192,381,314,209,326,7422,2333,9176,487,396,252,394,10705,1676,384,324,214,320,2918,0.182650392327812,0.788501026694045,0.818181818181818,0.849206349206349,0.812182741116751,0.272582905184493
E02000537,Osterley & Lampton East,Hounslow,London,1718,6144,378,314,261,331,7428,2115,9222,450,363,292,418,10745,1470,335,295,240,346,2686,0.159401431359792,0.744444444444445,0.81267217630854,0.821917808219178,0.827751196172249,0.249976733364356
E02000538,Cranford,Hounslow,London,2139,6579,370,290,207,250,7696,2435,9630,485,329,199,285,10928,1455,355,267,164,223,2464,0.151090342679128,0.731958762886598,0.811550151975684,0.824120603015075,0.782456140350877,0.225475841874085
E02000539,Syon Green,Hounslow,London,2533,7307,350,282,201,325,8465,2811,9332,396,351,251,308,10638,1793,287,291,200,274,2845,0.192134590655808,0.724747474747475,0.829059829059829,0.796812749003984,0.88961038961039,0.267437488249671
E02000540,Spring Grove,Hounslow,London,2503,7436,381,326,231,369,8743,2944,10720,411,368,244,356,12099,1638,283,304,208,307,2740,0.152798507462687,0.688564476885645,0.826086956521739,0.852459016393443,0.862359550561798,0.226464997107199
E02000541,Hounslow Meadows,Hounslow,London,2127,6456,362,264,224,302,7608,2542,10093,405,344,245,395,11482,1387,311,276,199,306,2479,0.137421975626672,0.767901234567901,0.802325581395349,0.812244897959184,0.774683544303798,0.215903152760843
E02000542,Hounslow West,Hounslow,London,2792,7707,399,345,222,387,9060,3267,11958,467,369,246,386,13426,1452,347,282,199,317,2597,0.121424987456096,0.743040685224839,0.764227642276423,0.808943089430894,0.821243523316062,0.193430656934307
E02000543,Hounslow High Street,Hounslow,London,3307,9331,364,306,203,294,10498,3822,13899,465,344,228,297,15233,1502,307,272,180,251,2512,0.108065328440895,0.660215053763441,0.790697674418605,0.789473684210526,0.845117845117845,0.16490514015624
E02000544,Hounslow East,Hounslow,London,1516,5350,379,336,213,351,6629,1679,6950,436,380,234,333,8333,1164,354,332,203,301,2354,0.167482014388489,0.811926605504587,0.873684210526316,0.867521367521368,0.903903903903904,0.282491299651986
E02000545,Isleworth & Ivybridge,Hounslow,London,2071,5533,359,301,197,285,6675,2198,6920,399,342,196,276,8133,1168,321,290,170,241,2190,0.16878612716763,0.804511278195489,0.847953216374269,0.86734693877551,0.873188405797101,0.269273330874216
E02000546,Hounslow Heath,Hounslow,London,2249,6375,438,257,157,249,7476,2537,9252,435,325,221,310,10543,1349,347,272,190,263,2421,0.145806312148725,0.797701149425287,0.836923076923077,0.859728506787331,0.848387096774194,0.229631034809826
E02000547,North Feltham & Hatton,Hounslow,London,2170,6439,391,358,245,352,7785,2369,8253,432,368,272,384,9709,1600,332,314,221,323,2790,0.193868896158973,0.768518518518519,0.853260869565217,0.8125,0.841145833333333,0.287362241219487
E02000548,Bedfont,Hounslow,London,2443,6307,335,278,185,357,7462,2551,7773,380,343,182,294,8972,1505,271,271,144,238,2429,0.193618937347228,0.713157894736842,0.790087463556851,0.791208791208791,0.80952380952381,0.270731163620152
E02000549,Feltham East,Hounslow,London,2500,7392,466,381,310,437,8986,2676,9954,512,450,300,482,11698,2063,404,380,251,398,3496,0.207253365481214,0.7890625,0.844444444444445,0.836666666666667,0.825726141078838,0.298854505043597
E02000550,Feltham Central,Hounslow,London,2843,7093,297,261,178,211,8040,2995,9165,344,274,171,234,10188,1559,251,218,132,192,2352,0.170103655210038,0.729651162790698,0.795620437956204,0.771929824561403,0.82051282051282,0.230859835100118
E02000551,Hanworth North,Hounslow,London,2296,5800,330,254,192,231,6807,2377,7047,359,295,205,224,8130,1443,269,241,177,183,2313,0.204767986377182,0.749303621169917,0.816949152542373,0.863414634146342,0.816964285714286,0.28450184501845
E02000552,Lower Feltham,Hounslow,London,2109,6104,279,216,135,199,6933,2122,7013,310,257,168,212,7960,1105,225,212,129,183,1854,0.157564523028661,0.725806451612903,0.824902723735409,0.767857142857143,0.863207547169811,0.232914572864322
E02000553,Hanworth South,Hounslow,London,1671,4445,302,272,163,256,5438,1728,5035,323,308,184,248,6098,915,223,244,156,202,1740,0.181727904667329,0.690402476780186,0.792207792207792,0.847826086956522,0.814516129032258,0.2853394555592
E02006792,Chiswick Park,Hounslow,London,1404,6262,316,322,241,396,7537,1590,8211,351,314,271,401,9548,1096,280,252,235,353,2216,0.133479478748021,0.797720797720798,0.802547770700637,0.867158671586716,0.880299251870324,0.232090490155006
E02000554,Highcroft & Holly Park,Islington,London,2021,7037,339,257,168,213,8014,1862,8452,328,288,167,217,9452,1035,215,223,117,141,1731,0.122456223379082,0.655487804878049,0.774305555555556,0.70059880239521,0.649769585253456,0.183135844265764
E02000555,Archway East,Islington,London,1792,7052,309,265,213,270,8109,1749,8383,379,302,234,289,9587,1000,276,223,180,214,1893,0.119289037337469,0.728232189973615,0.73841059602649,0.769230769230769,0.740484429065744,0.19745488682591
E02000556,Tollington,Islington,London,1719,8692,289,265,198,210,9654,1667,10665,332,307,187,229,11720,1102,229,243,133,157,1864,0.103328645100797,0.689759036144578,0.791530944625407,0.711229946524064,0.685589519650655,0.159044368600683
E02000557,Archway West,Islington,London,1426,6390,301,242,214,287,7434,1304,7762,322,236,233,277,8830,1031,218,187,196,213,1845,0.132826591084772,0.677018633540373,0.792372881355932,0.841201716738197,0.768953068592058,0.208946772366931
E02000558,Finsbury Park West,Islington,London,2248,7173,276,252,172,258,8131,1977,8744,291,272,169,270,9746,877,193,202,125,188,1585,0.100297346752059,0.663230240549828,0.742647058823529,0.739644970414201,0.696296296296296,0.162630822901703
E02000559,Gillespie Road,Islington,London,1894,7859,288,250,147,178,8722,1718,8088,292,218,154,201,8953,1056,231,173,120,157,1737,0.130563798219585,0.791095890410959,0.793577981651376,0.779220779220779,0.781094527363184,0.194013179939685
E02000560,Holloway Nag's Head,Islington,London,1199,7310,200,180,143,193,8026,1047,7959,211,170,135,175,8650,723,134,125,100,130,1212,0.0908405578590275,0.635071090047393,0.735294117647059,0.740740740740741,0.742857142857143,0.140115606936416
E02000561,Tufnell Park East,Islington,London,1465,6234,303,285,176,180,7178,1219,7202,317,266,199,187,8171,945,267,230,170,143,1755,0.131213551791169,0.842271293375394,0.864661654135338,0.85427135678392,0.764705882352941,0.214783992167421
E02000562,Highbury,Islington,London,1604,6348,290,262,145,272,7317,1447,7402,288,259,171,224,8344,872,210,220,151,181,1634,0.117805998378817,0.729166666666667,0.849420849420849,0.883040935672515,0.808035714285714,0.195829338446788
E02000563,Hilldrop,Islington,London,1501,6378,242,192,147,215,7174,1568,7990,316,256,162,215,8939,936,230,198,120,164,1648,0.117146433041302,0.727848101265823,0.7734375,0.740740740740741,0.762790697674419,0.184360666741246
E02000564,Lower Holloway,Islington,London,1923,11781,259,201,163,190,12594,1798,13128,320,242,163,210,14063,1322,203,176,135,161,1997,0.100700792199878,0.634375,0.727272727272727,0.828220858895705,0.766666666666667,0.142003839863472
E02000565,Newington Green,Islington,London,1698,6671,206,180,104,204,7365,1456,7803,236,200,127,193,8559,843,160,165,100,149,1417,0.10803537101115,0.677966101694915,0.825,0.78740157480315,0.772020725388601,0.165556723916345
E02000566,Highbury Fields,Islington,London,1533,7084,290,283,172,189,8018,1361,8160,344,281,195,211,9191,955,246,222,157,172,1752,0.11703431372549,0.715116279069768,0.790035587188612,0.805128205128205,0.815165876777251,0.190621259928191
E02000567,Canonbury East & Mildmay Park,Islington,London,1891,8701,321,263,177,263,9725,1673,10136,373,295,188,258,11250,1129,275,244,152,194,1994,0.111385161799526,0.737265415549598,0.827118644067797,0.808510638297872,0.751937984496124,0.177244444444444
E02000568,Caledonian Road,Islington,London,1845,10211,302,261,167,295,11236,1786,11643,334,281,173,284,12715,1133,242,216,140,216,1947,0.0973116894271236,0.724550898203593,0.768683274021352,0.809248554913295,0.76056338028169,0.153126228863547
E02000569,Islington North & Canonbury West,Islington,London,1937,8120,331,314,233,380,9378,1920,9728,379,311,207,320,10945,1242,277,245,163,263,2190,0.127672697368421,0.730870712401055,0.787781350482315,0.78743961352657,0.821875,0.200091365920512
E02000570,Barnsbury East,Islington,London,1445,7529,338,274,168,228,8537,1283,8360,328,313,172,233,9406,936,266,268,146,194,1810,0.111961722488038,0.810975609756098,0.856230031948882,0.848837209302326,0.832618025751073,0.192430363597704
E02000571,Islington East & Arlington,Islington,London,1503,6906,271,270,149,239,7835,1499,8003,308,256,174,226,8967,1027,222,215,147,180,1791,0.128326877420967,0.720779220779221,0.83984375,0.844827586206897,0.79646017699115,0.199732351957176
E02000572,Barnsbury West,Islington,London,1685,6611,289,218,149,267,7534,1590,8973,326,239,162,245,9945,1144,235,171,123,173,1846,0.127493591886771,0.720858895705521,0.715481171548117,0.759259259259259,0.706122448979592,0.18562091503268
E02000573,Angel,Islington,London,1389,8245,265,303,209,237,9259,1385,10654,351,318,216,252,11791,1009,276,266,186,212,1949,0.0947062136286841,0.786324786324786,0.836477987421384,0.861111111111111,0.841269841269841,0.165295564413536
E02000574,King's Cross & Pentonville,Islington,London,1139,7865,223,199,153,197,8637,997,9892,258,246,130,217,10743,980,192,193,109,196,1670,0.0990699555196118,0.744186046511628,0.784552845528455,0.838461538461539,0.903225806451613,0.155450060504515
E02000575,Clerkenwell,Islington,London,1536,13160,278,223,133,244,14038,1494,14202,317,262,171,254,15206,1284,241,213,141,200,2079,0.0904098014364174,0.760252365930599,0.812977099236641,0.824561403508772,0.78740157480315,0.136722346442194
E02000576,Old Street & St Luke's,Islington,London,2059,9174,267,212,165,282,10100,1856,10523,281,229,152,274,11459,960,191,183,123,223,1680,0.0912287370521714,0.679715302491103,0.799126637554585,0.80921052631579,0.813868613138686,0.146609651802077
E02000577,Golborne & Swinbrook,Kensington and Chelsea,London,1228,4457,245,232,187,287,5408,1366,7260,352,285,191,295,8383,1001,226,200,130,198,1755,0.137878787878788,0.642045454545455,0.701754385964912,0.680628272251309,0.671186440677966,0.209352260527258
E02000578,Ladbroke Grove,Kensington and Chelsea,London,1178,3588,248,206,179,329,4550,1101,4837,235,226,150,222,5670,891,170,162,126,162,1511,0.184205085796982,0.723404255319149,0.716814159292035,0.84,0.72972972972973,0.266490299823633
E02000579,North Kensington,Kensington and Chelsea,London,1593,5296,372,336,216,242,6462,1568,7160,441,348,261,292,8502,1008,306,268,201,219,2002,0.140782122905028,0.693877551020408,0.770114942528736,0.770114942528736,0.75,0.235474006116208
E02000580,Portobello,Kensington and Chelsea,London,1212,5474,350,319,222,235,6600,1283,7925,446,341,244,257,9213,918,289,231,166,171,1775,0.11583596214511,0.647982062780269,0.67741935483871,0.680327868852459,0.665369649805447,0.192662542060132
E02000581,Notting Dale,Kensington and Chelsea,London,1208,3860,304,337,253,317,5071,1276,5824,337,318,247,327,7053,940,234,231,185,245,1835,0.161401098901099,0.694362017804154,0.726415094339623,0.748987854251012,0.749235474006116,0.260172976038565
E02000582,Notting Hill Gate,Kensington and Chelsea,London,1158,4934,296,294,261,342,6127,1099,7227,328,276,208,331,8370,688,220,199,153,282,1542,0.0951985609519856,0.670731707317073,0.721014492753623,0.735576923076923,0.851963746223565,0.184229390681004
E02000583,Notting Hill West,Kensington and Chelsea,London,1210,4601,315,329,229,248,5722,1092,5928,318,292,213,276,7027,707,212,212,171,233,1535,0.119264507422402,0.666666666666667,0.726027397260274,0.802816901408451,0.844202898550725,0.218443147858261
E02000584,Notting Hill South,Kensington and Chelsea,London,1690,5104,387,347,286,364,6488,1489,6229,344,359,239,324,7495,635,215,276,191,254,1571,0.101942526890352,0.625,0.768802228412256,0.799163179916318,0.783950617283951,0.209606404269513
E02000585,Holland Park,Kensington and Chelsea,London,1450,5196,355,355,287,357,6550,1488,7721,395,338,302,336,9092,861,232,222,209,241,1765,0.111514052583862,0.587341772151899,0.656804733727811,0.69205298013245,0.717261904761905,0.194126704795425
E02000586,Queen's Gate,Kensington and Chelsea,London,1276,5491,313,284,165,218,6471,1181,6767,313,291,184,224,7779,531,182,199,136,160,1208,0.0784690409339441,0.5814696485623,0.683848797250859,0.739130434782609,0.714285714285714,0.155289883018383
E02000587,Kensington Abingdon,Kensington and Chelsea,London,1439,4880,340,362,225,336,6143,1247,6581,394,341,235,310,7861,671,240,237,177,244,1569,0.101960188421213,0.609137055837564,0.695014662756598,0.753191489361702,0.787096774193548,0.19959292710851
E02000588,Hans Town,Kensington and Chelsea,London,1081,5339,380,361,292,345,6717,1047,5969,391,317,222,281,7180,444,215,183,144,191,1177,0.0743843189814039,0.549872122762148,0.577287066246057,0.648648648648649,0.679715302491103,0.163927576601671
E02000589,Kensington Gardens,Kensington and Chelsea,London,1221,6698,267,262,174,264,7665,1182,9013,316,248,183,229,9989,677,162,159,129,165,1292,0.0751137246199934,0.512658227848101,0.641129032258065,0.704918032786885,0.720524017467249,0.129342276504155
E02000590,Brompton,Kensington and Chelsea,London,920,4588,391,340,223,455,5997,833,5433,321,308,226,351,6639,632,220,212,169,252,1485,0.116326154978833,0.685358255451713,0.688311688311688,0.747787610619469,0.717948717948718,0.223678264798916
E02000591,Earl's Court,Kensington and Chelsea,London,976,4992,298,291,154,175,5910,1158,7554,297,324,213,217,8605,773,169,202,151,139,1434,0.102329891448239,0.569023569023569,0.623456790123457,0.708920187793427,0.640552995391705,0.16664729808251
E02000592,South Kensington,Kensington and Chelsea,London,1213,4815,243,311,180,234,5783,1089,6277,245,231,181,254,7188,551,139,134,119,185,1128,0.0877807870001593,0.56734693877551,0.58008658008658,0.657458563535912,0.728346456692913,0.156928213689483
E02000593,West Brompton,Kensington and Chelsea,London,1317,5811,342,315,209,216,6893,1151,8017,314,311,207,218,9067,743,197,202,157,164,1463,0.0926780591243607,0.627388535031847,0.64951768488746,0.758454106280193,0.752293577981651,0.161354361971986
E02000594,Chelsea Manor & Royal Hospital,Kensington and Chelsea,London,1111,4787,480,453,358,561,6639,875,5071,390,370,327,500,6658,706,241,279,260,424,1910,0.139223032932361,0.617948717948718,0.754054054054054,0.795107033639144,0.848,0.28687293481526
E02000595,Chelsea Riverside East,Kensington and Chelsea,London,1238,4966,396,381,264,371,6378,963,5423,311,351,271,327,6683,688,214,241,198,257,1598,0.126867047759543,0.688102893890675,0.686609686609687,0.730627306273063,0.785932721712538,0.239114170282807
E02000596,Fulham Road,Kensington and Chelsea,London,1297,5309,349,279,205,278,6420,929,6198,271,263,176,253,7161,741,186,182,141,209,1459,0.119554695062924,0.686346863468635,0.692015209125475,0.801136363636364,0.826086956521739,0.203742494065075
E02000597,Chelsea Riverside West,Kensington and Chelsea,London,1260,4618,364,340,217,320,5859,1180,6040,382,343,223,303,7291,972,245,251,164,229,1861,0.160927152317881,0.641361256544503,0.731778425655977,0.73542600896861,0.755775577557756,0.255246193937731
E02000598,Tudor Drive,Kingston upon Thames,London,2006,5000,367,329,224,352,6272,2055,5859,404,385,257,338,7243,1168,341,329,231,308,2377,0.199351425157877,0.844059405940594,0.854545454545455,0.898832684824903,0.911242603550296,0.328178931382024
E02000599,Kingston Vale & Coombe Hill,Kingston upon Thames,London,1511,5453,363,358,262,565,7001,1346,6139,430,407,319,552,7847,1179,334,345,259,472,2589,0.192050822609546,0.776744186046512,0.847665847665848,0.811912225705329,0.855072463768116,0.329935007009048
E02000600,Kingston Hill,Kingston upon Thames,London,2150,6384,325,299,237,321,7566,2148,7293,324,338,238,308,8501,1416,255,271,212,268,2422,0.194158782394077,0.787037037037037,0.801775147928994,0.890756302521008,0.87012987012987,0.284907657922597
E02000601,Kingston North,Kingston upon Thames,London,3223,9021,402,330,221,276,10250,3241,10429,453,364,258,303,11807,1592,352,300,224,261,2729,0.152651260907086,0.777041942604857,0.824175824175824,0.868217054263566,0.861386138613861,0.231134073007538
E02000602,Kingston East & Norbiton West,Kingston upon Thames,London,2179,8639,361,249,176,284,9709,2240,9059,370,302,184,264,10179,1507,292,260,158,227,2444,0.16635390219671,0.789189189189189,0.860927152317881,0.858695652173913,0.859848484848485,0.240102171136654
E02000603,Norbiton East,Kingston upon Thames,London,2077,5869,316,270,189,269,6913,1948,7081,350,308,197,250,8186,1372,276,258,167,204,2277,0.19375794379325,0.788571428571429,0.837662337662338,0.847715736040609,0.816,0.278157830442218
E02000604,New Malden East,Kingston upon Thames,London,2030,6059,380,320,207,350,7316,2069,7653,436,379,248,342,9058,1136,371,330,222,311,2370,0.1484385208415,0.850917431192661,0.870712401055409,0.895161290322581,0.909356725146199,0.261647162729079
E02000605,New Malden West,Kingston upon Thames,London,1718,5168,406,358,247,447,6626,1840,6427,427,370,286,432,7942,1126,366,327,260,391,2470,0.175198381826669,0.857142857142857,0.883783783783784,0.909090909090909,0.905092592592593,0.311004784688995
E02000606,Kingston Riverside,Kingston upon Thames,London,1752,8345,361,351,203,338,9598,1647,10378,376,360,237,331,11682,1333,283,308,208,294,2426,0.128444787049528,0.752659574468085,0.855555555555556,0.877637130801688,0.88821752265861,0.207669919534326
E02000607,Berrylands North,Kingston upon Thames,London,1364,5858,244,230,132,231,6695,1299,5637,261,247,167,242,6554,848,222,227,156,213,1666,0.150434628348412,0.850574712643678,0.919028340080972,0.934131736526946,0.880165289256198,0.254195910894111
E02000608,Surbiton North,Kingston upon Thames,London,1181,5659,186,187,122,224,6378,1028,6949,212,226,142,187,7716,798,155,188,123,167,1431,0.114836667146352,0.731132075471698,0.831858407079646,0.866197183098592,0.893048128342246,0.185458786936236
E02000609,Malden Manor,Kingston upon Thames,London,1494,4726,386,398,265,406,6181,1488,5886,398,427,276,422,7409,1149,328,385,255,370,2487,0.195208970438328,0.824120603015075,0.901639344262295,0.923913043478261,0.876777251184834,0.335672830341477
E02000610,Surbiton South,Kingston upon Thames,London,1270,5795,295,283,175,362,6910,1277,6183,298,309,206,354,7350,1037,240,259,170,323,2029,0.167717936276888,0.805369127516778,0.838187702265372,0.825242718446602,0.912429378531073,0.276054421768708
E02000611,Berrylands South,Kingston upon Thames,London,1624,4286,426,433,287,402,5834,1534,4966,430,429,322,424,6571,1115,388,414,302,395,2614,0.224526782118405,0.902325581395349,0.965034965034965,0.937888198757764,0.931603773584906,0.3978085527317
E02000612,Motspur Park,Kingston upon Thames,London,1526,4949,457,497,350,479,6732,1577,5881,470,519,355,502,7727,1188,410,473,326,464,2861,0.202006461486142,0.872340425531915,0.911368015414258,0.91830985915493,0.924302788844621,0.370260126828006
E02000613,Southborough,Kingston upon Thames,London,1916,5259,304,281,212,426,6482,1816,5517,291,308,215,354,6685,1006,260,281,199,320,2066,0.182345477614646,0.893470790378007,0.912337662337662,0.925581395348837,0.903954802259887,0.309050112191473
E02000614,Tolworth,Kingston upon Thames,London,2031,6143,357,289,225,284,7298,2046,7157,399,330,225,310,8421,1379,325,294,193,279,2470,0.192678496576778,0.81453634085213,0.890909090909091,0.857777777777778,0.9,0.293314333214583
E02000615,Hook,Kingston upon Thames,London,1630,4868,312,344,269,377,6170,1606,5706,322,359,266,362,7015,1205,286,326,243,322,2382,0.2111812127585,0.888198757763975,0.908077994428969,0.913533834586466,0.889502762430939,0.339558089807555
E02000616,Chessington North,Kingston upon Thames,London,1248,3766,296,287,154,250,4753,1226,4220,272,289,180,231,5192,946,243,265,168,218,1840,0.224170616113744,0.893382352941176,0.916955017301038,0.933333333333333,0.943722943722944,0.354391371340524
E02000617,Chessington South & Malden Rushett,Kingston upon Thames,London,1993,5592,358,367,236,347,6900,1889,6311,425,365,283,371,7755,1405,367,345,258,335,2710,0.222627158928854,0.863529411764706,0.945205479452055,0.911660777385159,0.902964959568733,0.349451966473243
E02000619,Lambeth Walk & North Kennington,Lambeth,London,1571,6498,354,280,176,239,7547,1619,8580,393,296,181,261,9711,1313,257,220,127,192,2109,0.153030303030303,0.653944020356234,0.743243243243243,0.701657458563536,0.735632183908046,0.217176397899289
E02000620,Kennington West & Vauxhall North,Lambeth,London,1666,8076,245,180,187,268,8956,1528,9981,352,232,202,277,11044,1391,247,173,154,201,2166,0.139364793106903,0.701704545454545,0.745689655172414,0.762376237623762,0.725631768953069,0.196124592538935
E02000621,Vauxhall South,Lambeth,London,1431,10049,301,235,206,210,11001,1450,14371,372,280,182,249,15454,1577,234,191,135,200,2337,0.109734882749983,0.629032258064516,0.682142857142857,0.741758241758242,0.803212851405623,0.151222984340624
E02000622,Oval,Lambeth,London,1284,6917,219,168,112,178,7594,1251,8846,300,192,124,180,9642,1151,195,139,95,136,1716,0.130115306353154,0.65,0.723958333333333,0.766129032258065,0.755555555555556,0.177971375233354
E02000623,Stockwell North,Lambeth,London,1379,5847,292,187,170,224,6720,1381,8150,336,225,190,224,9125,1110,237,165,127,175,1814,0.136196319018405,0.705357142857143,0.733333333333333,0.668421052631579,0.78125,0.198794520547945
E02000624,Stockwell East,Lambeth,London,1398,6886,190,135,111,220,7542,1536,9506,291,226,117,204,10344,1266,160,159,75,156,1816,0.133179044813802,0.549828178694158,0.70353982300885,0.641025641025641,0.764705882352941,0.175560711523589
E02000625,Stockwell West,Lambeth,London,1620,6294,143,160,101,164,6862,1714,9688,299,185,107,155,10434,1117,166,126,70,108,1587,0.115297274979356,0.555183946488294,0.681081081081081,0.654205607476636,0.696774193548387,0.152098907418056
E02000626,Loughborough Road,Lambeth,London,1834,5912,183,139,108,146,6488,1778,8039,288,173,131,182,8813,1037,153,96,93,102,1481,0.12899614379898,0.53125,0.554913294797688,0.709923664122137,0.56043956043956,0.168047202995575
E02000627,Stockwell South,Lambeth,London,1418,7730,194,157,163,255,8499,1454,10478,265,226,148,239,11356,1233,153,158,108,172,1824,0.117675128841382,0.577358490566038,0.699115044247788,0.72972972972973,0.719665271966527,0.160619936597393
E02000628,Brixton North,Lambeth,London,1697,7134,242,206,174,235,7991,1833,10826,376,268,169,258,11897,1214,194,160,104,143,1815,0.112137446887124,0.515957446808511,0.597014925373134,0.615384615384615,0.554263565891473,0.15255946877364
E02000629,Clapham North,Lambeth,London,1176,7226,228,171,98,138,7861,1180,9559,264,188,125,151,10287,1194,181,146,100,106,1727,0.124908463228371,0.685606060606061,0.776595744680851,0.8,0.701986754966887,0.167881792553709
E02000630,Clapham Old Town,Lambeth,London,1120,6307,172,170,106,161,6916,1023,7633,264,199,119,172,8387,935,195,159,98,131,1518,0.12249443207127,0.738636363636364,0.798994974874372,0.823529411764706,0.761627906976744,0.180994396089186
E02000631,Herne Hill East,Lambeth,London,1701,6887,267,209,170,218,7751,1642,8491,312,251,171,243,9468,1390,204,210,134,174,2112,0.163702744081969,0.653846153846154,0.836653386454183,0.783625730994152,0.716049382716049,0.223067173637516
E02000632,Acre Lane,Lambeth,London,884,7786,168,111,91,175,8331,907,10840,216,176,108,181,11521,1197,131,113,68,115,1624,0.110424354243542,0.606481481481482,0.642045454545455,0.62962962962963,0.6353591160221,0.140959986112317
E02000633,Brixton Central,Lambeth,London,1487,6901,277,139,128,155,7600,1390,8432,301,184,145,199,9261,1004,169,123,105,131,1532,0.119070208728653,0.561461794019934,0.668478260869565,0.724137931034483,0.658291457286432,0.165424900118778
E02000634,Clapham Common North,Lambeth,London,1007,5146,187,157,83,190,5763,1001,7042,237,170,112,181,7742,930,165,121,87,133,1436,0.132064754331156,0.69620253164557,0.711764705882353,0.776785714285714,0.734806629834254,0.18548178765177
E02000635,Poets' Corner & Brockwell Park,Lambeth,London,1522,7119,220,169,116,145,7769,1533,8981,317,216,124,186,9824,1249,192,161,93,122,1817,0.139071372898341,0.605678233438486,0.74537037037037,0.75,0.655913978494624,0.184955211726384
E02000636,Clapham South,Lambeth,London,1407,6079,216,195,113,135,6738,1389,7244,198,218,141,166,7967,861,142,178,117,134,1432,0.11885698509111,0.717171717171717,0.81651376146789,0.829787234042553,0.807228915662651,0.179741433412828
E02000637,Brixton Hill East,Lambeth,London,1226,7189,201,153,128,190,7861,1174,8485,249,190,120,191,9235,1117,176,124,82,125,1624,0.131644077784325,0.706827309236948,0.652631578947369,0.683333333333333,0.654450261780105,0.175852734163508
E02000638,Brixton Hill West,Lambeth,London,1724,8331,220,152,162,241,9106,1634,10293,282,189,163,242,11169,1406,176,140,120,186,2028,0.136597687748956,0.624113475177305,0.740740740740741,0.736196319018405,0.768595041322314,0.181573999462799
E02000639,Clapham Park East & Streatham Hill North,Lambeth,London,1443,6075,221,133,118,107,6654,1367,8683,302,188,106,174,9453,1213,186,129,72,114,1714,0.139698260969711,0.615894039735099,0.686170212765958,0.679245283018868,0.655172413793103,0.181318100074051
E02000640,Clapham Park West,Lambeth,London,1849,7199,212,213,156,247,8027,1800,8539,288,216,185,234,9462,1236,220,183,154,185,1978,0.144747628527931,0.763888888888889,0.847222222222222,0.832432432432433,0.790598290598291,0.209046713168463
E02000641,Tulse Hill,Lambeth,London,1998,5952,271,145,110,210,6688,1866,7963,318,204,115,218,8818,1142,174,131,77,148,1672,0.143413286449831,0.547169811320755,0.642156862745098,0.669565217391304,0.678899082568807,0.18961215695169
E02000642,West Dulwich,Lambeth,London,2141,6579,321,267,169,267,7603,1992,7957,354,312,204,265,9092,1385,264,269,162,223,2303,0.174060575593817,0.745762711864407,0.862179487179487,0.794117647058824,0.841509433962264,0.253299604047514
E02000643,Streatham Hill,Lambeth,London,1725,7120,244,202,117,226,7909,1708,8755,282,204,125,225,9591,1440,190,159,97,160,2046,0.164477441462022,0.673758865248227,0.779411764705882,0.776,0.711111111111111,0.213324992180169
E02000644,Leigham Vale & Royal Circus,Lambeth,London,1882,6355,271,175,100,193,7094,1730,7691,281,248,110,201,8531,1227,189,189,91,156,1852,0.159537121310623,0.672597864768683,0.762096774193548,0.827272727272727,0.776119402985075,0.217090610713867
E02000645,West Norwood East,Lambeth,London,2164,6870,256,208,111,233,7678,2074,8257,291,254,147,214,9163,1345,204,198,116,164,2027,0.162892091558677,0.701030927835052,0.779527559055118,0.789115646258503,0.766355140186916,0.221215759030885
E02000646,Streatham Central,Lambeth,London,1654,7719,314,260,158,263,8714,1651,9169,347,272,192,279,10259,1508,250,211,150,227,2346,0.164467226524157,0.720461095100865,0.775735294117647,0.78125,0.813620071684588,0.228677258992105
E02000647,West Norwood West & Streatham East,Lambeth,London,1945,6162,346,279,186,365,7338,1796,7000,402,292,188,340,8222,1258,288,225,147,260,2178,0.179714285714286,0.716417910447761,0.770547945205479,0.781914893617021,0.764705882352941,0.264899051325712
E02000648,West Norwood South,Lambeth,London,2255,5299,212,209,137,236,6093,2008,6383,267,216,152,214,7232,996,160,168,117,152,1593,0.1560394798684,0.599250936329588,0.777777777777778,0.769736842105263,0.710280373831776,0.220271017699115
E02000649,Streatham Green,Lambeth,London,2525,10112,311,226,164,248,11061,2379,11350,355,282,163,272,12422,1718,248,185,125,196,2472,0.15136563876652,0.698591549295775,0.656028368794326,0.766871165644172,0.720588235294118,0.199001771051361
E02000650,Gipsy Hill,Lambeth,London,1793,5325,245,172,95,168,6005,1850,6907,272,214,121,171,7685,1132,181,163,89,123,1688,0.163891704068336,0.665441176470588,0.761682242990654,0.735537190082645,0.719298245614035,0.219648666232921
E02000651,Streatham Common,Lambeth,London,1734,6433,276,244,172,297,7422,1728,7478,355,254,182,294,8563,1332,240,191,134,225,2122,0.178122492645092,0.676056338028169,0.751968503937008,0.736263736263736,0.76530612244898,0.24781034684106
E02000652,Streatham Vale,Lambeth,London,1690,5252,257,195,182,284,6170,1594,6551,312,240,185,306,7594,961,213,179,138,234,1725,0.146695161044115,0.682692307692308,0.745833333333333,0.745945945945946,0.764705882352941,0.227153015538583
E02006801,"Lambeth North, Waterloo & South Bank",Lambeth,London,950,9468,299,249,131,235,10382,1028,13245,348,271,173,234,14271,1354,232,216,127,198,2127,0.102227255568139,0.666666666666667,0.797047970479705,0.734104046242775,0.846153846153846,0.149043514820265
E02000653,Silwood & Pepys,Lewisham,London,2066,9080,185,177,109,151,9702,2066,11391,273,175,124,145,12108,1237,189,122,92,120,1760,0.108594504433325,0.692307692307692,0.697142857142857,0.741935483870968,0.827586206896552,0.145358440700363
E02000654,Deptford North,Lewisham,London,1987,6190,218,132,114,169,6823,2001,8113,269,177,104,170,8833,996,171,124,67,110,1468,0.122765931221496,0.635687732342008,0.700564971751413,0.644230769230769,0.647058823529412,0.166194950752859
E02000655,New Cross Gate,Lewisham,London,1770,6950,178,137,114,166,7545,1799,8877,256,174,128,165,9600,956,143,110,87,102,1398,0.107694040779543,0.55859375,0.632183908045977,0.6796875,0.618181818181818,0.145625
E02000657,New Cross South,Lewisham,London,1575,7728,221,186,127,152,8414,1679,9536,269,224,150,213,10392,963,153,151,114,125,1506,0.100985738255034,0.568773234200744,0.674107142857143,0.76,0.586854460093897,0.144919168591224
E02000658,Telegraph Hill,Lewisham,London,1464,6560,271,192,125,180,7328,1408,7720,320,214,135,212,8601,930,207,162,104,142,1545,0.120466321243523,0.646875,0.757009345794393,0.77037037037037,0.669811320754717,0.179630275549355
E02000659,Blackheath West,Lewisham,London,1607,5921,223,205,133,208,6690,1557,6779,275,221,165,213,7653,932,180,163,131,165,1571,0.137483404631952,0.654545454545455,0.737556561085973,0.793939393939394,0.774647887323944,0.205278975565138
E02000660,Brockley East & St Johns,Lewisham,London,1383,6647,201,136,99,171,7254,1519,7737,216,172,131,150,8406,852,136,125,100,89,1302,0.110120201628538,0.62962962962963,0.726744186046512,0.763358778625954,0.593333333333333,0.154889364739472
E02000661,Blackheath Village,Lewisham,London,1171,4801,230,244,161,279,5715,1270,5496,247,240,183,301,6467,778,180,201,160,262,1581,0.14155749636099,0.728744939271255,0.8375,0.87431693989071,0.870431893687708,0.244471934436369
E02000662,Brockley West,Lewisham,London,1809,6301,214,146,102,140,6903,1820,7273,294,164,135,183,8049,881,157,102,95,101,1336,0.121132957514093,0.534013605442177,0.621951219512195,0.703703703703704,0.551912568306011,0.165983351969189
E02000663,Loampit & Hilly Fields,Lewisham,London,1209,5496,246,197,134,155,6228,1270,5975,261,189,153,176,6754,763,193,148,121,114,1339,0.127698744769874,0.739463601532567,0.783068783068783,0.790849673202614,0.647727272727273,0.198252887177969
E02000664,Lewisham Central & Park,Lewisham,London,2559,11114,301,226,180,301,12122,2753,13430,338,254,182,312,14516,1504,197,180,143,230,2254,0.11198808637379,0.582840236686391,0.708661417322835,0.785714285714286,0.737179487179487,0.155276935794985
E02000665,Manor House,Lewisham,London,1760,6116,243,233,156,246,6994,1818,6622,274,245,161,260,7562,929,193,206,133,205,1666,0.140289942615524,0.704379562043796,0.840816326530612,0.826086956521739,0.788461538461538,0.220312086749537
E02000666,Ladywell,Lewisham,London,1414,5189,219,167,151,250,5976,1509,5803,244,186,156,241,6630,813,159,141,118,177,1408,0.140099948302602,0.651639344262295,0.758064516129032,0.756410256410256,0.734439834024896,0.21236802413273
E02000667,Crofton Park,Lewisham,London,1540,4715,236,149,126,168,5394,1474,5082,228,206,137,206,5859,745,164,155,110,161,1335,0.14659582841401,0.719298245614035,0.752427184466019,0.802919708029197,0.781553398058252,0.227854582693292
E02000668,Lee,Lewisham,London,1655,5018,278,228,157,242,5923,1659,5258,283,215,176,210,6142,860,226,178,151,174,1589,0.163560289083302,0.798586572438163,0.827906976744186,0.857954545454545,0.828571428571429,0.258710517746662
E02000669,Hither Green,Lewisham,London,1580,6093,169,180,127,186,6755,1621,6627,197,189,130,186,7329,1084,135,140,95,137,1591,0.163573260902369,0.685279187817259,0.740740740740741,0.730769230769231,0.736559139784946,0.217082821667349
E02000670,Catford East & Mountsfield Park,Lewisham,London,1472,4608,156,121,99,190,5174,1401,5209,219,152,133,218,5931,700,133,94,95,150,1172,0.134382799001728,0.607305936073059,0.618421052631579,0.714285714285714,0.688073394495413,0.197605800033721
E02000671,Honor Oak,Lewisham,London,1767,6193,256,196,155,199,6999,1853,7082,295,235,156,243,8011,1189,210,190,118,183,1890,0.167890426433211,0.711864406779661,0.808510638297872,0.756410256410256,0.753086419753086,0.235925602296842
E02000672,Catford Bridge,Lewisham,London,2349,7131,220,180,117,280,7928,2255,8281,281,214,149,276,9201,1177,175,149,104,203,1808,0.142132592682043,0.622775800711744,0.696261682242991,0.697986577181208,0.735507246376812,0.196500380393436
E02000673,Forest Hill West,Lewisham,London,2002,5941,287,227,146,189,6790,1731,6202,310,218,162,190,7082,939,234,179,130,152,1634,0.151402773298936,0.754838709677419,0.821100917431193,0.802469135802469,0.8,0.230725783676927
E02000674,Corbett Estate,Lewisham,London,1801,5842,288,224,152,290,6796,1715,6471,311,241,205,318,7546,996,215,194,164,264,1833,0.153917477978674,0.691318327974277,0.804979253112033,0.8,0.830188679245283,0.242910151073416
E02000675,Grove Park & Lee South,Lewisham,London,1783,5929,366,298,204,302,7099,1764,6219,407,354,212,321,7513,1119,306,309,183,284,2201,0.179932465026532,0.751842751842752,0.872881355932204,0.863207547169811,0.884735202492212,0.292958871289764
E02000676,Forest Hill East,Lewisham,London,1742,5743,219,201,140,218,6521,1707,6346,278,197,133,234,7188,1176,208,163,98,190,1835,0.185313583359597,0.748201438848921,0.82741116751269,0.736842105263158,0.811965811965812,0.255286588759043
E02000677,Culverley Green,Lewisham,London,1538,5095,273,225,138,301,6032,1377,5599,316,265,160,295,6635,920,228,194,125,233,1700,0.164315056260046,0.721518987341772,0.732075471698113,0.78125,0.789830508474576,0.25621703089676
E02000678,Further Green,Lewisham,London,1705,4507,176,138,143,210,5174,1573,4917,222,148,122,180,5589,914,166,121,104,146,1451,0.185885702664226,0.747747747747748,0.817567567567568,0.852459016393443,0.811111111111111,0.259617105027733
E02000679,Perry Vale,Lewisham,London,1834,5682,285,214,167,218,6566,1898,6302,306,233,171,215,7227,1113,230,195,143,189,1870,0.176610599809584,0.751633986928105,0.836909871244635,0.83625730994152,0.87906976744186,0.258751902587519
E02000680,Upper Sydenham,Lewisham,London,1709,5214,218,167,124,197,5920,1618,5312,224,176,119,209,6040,900,160,143,95,184,1482,0.169427710843374,0.714285714285714,0.8125,0.798319327731092,0.880382775119617,0.245364238410596
E02000681,Bellingham & Perry Hill,Lewisham,London,2063,5618,322,268,185,291,6684,1927,6752,368,325,182,282,7909,1195,242,267,142,225,2071,0.176984597156398,0.657608695652174,0.821538461538462,0.78021978021978,0.797872340425532,0.26185358452396
E02000682,Forster Park & Southend,Lewisham,London,2220,5830,309,262,150,308,6859,2178,6795,315,278,171,279,7838,1115,231,224,134,232,1936,0.164091243561442,0.733333333333333,0.805755395683453,0.783625730994152,0.831541218637993,0.247001786169941
E02000683,Chinbrook,Lewisham,London,1481,4274,195,189,159,246,5063,1435,5092,271,202,165,257,5987,860,183,162,124,203,1532,0.168892380204242,0.675276752767528,0.801980198019802,0.751515151515152,0.78988326848249,0.255887756806414
E02000685,Sydenham Wells,Lewisham,London,1890,5613,283,241,189,284,6610,1738,6075,292,259,184,290,7100,1098,207,204,161,246,1916,0.180740740740741,0.708904109589041,0.787644787644788,0.875,0.848275862068966,0.269859154929577
E02000686,Beckenham Hill,Lewisham,London,1985,4846,200,191,127,146,5510,1979,5709,222,178,126,143,6378,940,160,130,88,113,1431,0.164652303380627,0.720720720720721,0.730337078651685,0.698412698412698,0.79020979020979,0.224365004703669
E02000687,Lower Sydenham,Lewisham,London,1658,5722,307,244,148,320,6741,1695,6214,310,262,196,300,7282,1114,242,229,164,258,2007,0.179272610234953,0.780645161290323,0.874045801526717,0.836734693877551,0.86,0.275611095852788
E02006783,Downham East,Lewisham,London,1940,4978,198,162,132,254,5724,1968,6107,246,176,134,212,6875,1119,171,135,102,175,1702,0.183232356312428,0.695121951219512,0.767045454545455,0.761194029850746,0.825471698113208,0.247563636363636
E02006784,Downham West,Lewisham,London,1772,5158,331,275,203,345,6312,1769,5775,370,282,204,335,6966,1010,278,241,169,281,1979,0.174891774891775,0.751351351351351,0.854609929078014,0.82843137254902,0.838805970149254,0.284094171691071
E02006798,New Cross & Deptford South,Lewisham,London,1472,6279,213,143,122,85,6842,1672,9233,296,176,144,181,10030,993,179,119,103,110,1504,0.107549008989494,0.60472972972973,0.676136363636364,0.715277777777778,0.607734806629834,0.149950149551346
E02000689,Wimbledon Park & Durnsford Road,Merton,London,2063,5551,286,186,156,173,6352,2219,7519,340,256,183,201,8499,1215,274,223,156,167,2035,0.1615906370528,0.805882352941176,0.87109375,0.852459016393443,0.830845771144279,0.239439934109895
E02000690,Wimbledon Common,Merton,London,1025,3139,344,370,233,459,4545,1187,4442,416,372,308,478,6016,1063,323,315,263,406,2370,0.239306618640252,0.776442307692308,0.846774193548387,0.853896103896104,0.849372384937239,0.393949468085106
E02000691,Wimbledon Broadway North,Merton,London,1467,5179,241,214,119,227,5980,1513,6735,272,236,151,252,7646,1083,218,195,124,223,1843,0.160801781737194,0.801470588235294,0.826271186440678,0.821192052980132,0.884920634920635,0.241041067224693
E02000692,Wimbledon Hill,Merton,London,1373,5172,340,369,219,445,6545,1657,7306,387,406,262,496,8857,1254,302,327,226,415,2524,0.171639748152204,0.780361757105943,0.805418719211823,0.862595419847328,0.836693548387097,0.28497233826352
E02000693,Colliers Wood,Merton,London,1445,7237,250,205,150,244,8086,1741,9564,308,250,150,274,10546,1468,209,206,117,204,2204,0.15349226265161,0.678571428571429,0.824,0.78,0.744525547445256,0.208989190214299
E02000694,South Wimbledon,Merton,London,1871,6387,291,244,141,176,7239,2100,8027,295,279,157,222,8980,1290,236,229,131,178,2064,0.160707611810141,0.8,0.82078853046595,0.834394904458599,0.801801801801802,0.229844097995546
E02000695,Graveney,Merton,London,1594,5781,300,255,227,325,6888,1714,7788,368,273,262,345,9036,1426,273,223,206,261,2389,0.183102208525937,0.741847826086957,0.816849816849817,0.786259541984733,0.756521739130435,0.264386896857016
E02000696,Lavender Park,Merton,London,1496,5864,235,148,122,158,6527,1703,7809,278,238,121,153,8599,1213,203,183,86,109,1794,0.155333589448073,0.73021582733813,0.76890756302521,0.710743801652893,0.712418300653595,0.208628910338411
E02000697,Wimbledon Broadway South,Merton,London,1659,6626,227,215,118,178,7364,1790,8167,251,238,120,203,8979,1182,202,199,99,170,1852,0.14472878658014,0.804780876494024,0.836134453781513,0.825,0.83743842364532,0.206259048891859
E02000698,Cottenham Park,Merton,London,1821,4804,338,391,267,395,6195,2157,6649,438,423,315,435,8260,1284,372,364,268,372,2660,0.193111746127237,0.849315068493151,0.860520094562648,0.850793650793651,0.855172413793104,0.322033898305085
E02000699,Wimbledon Chase,Merton,London,1928,5388,274,257,159,278,6356,2032,6832,313,266,185,307,7903,1114,262,232,166,269,2043,0.163056206088993,0.837060702875399,0.87218045112782,0.897297297297297,0.876221498371335,0.258509426799949
E02000700,Merton Church Road & Phipps Bridge,Merton,London,1821,5774,287,228,138,148,6575,1889,7349,321,244,161,181,8256,1271,236,178,115,133,1933,0.17294870050347,0.735202492211838,0.729508196721312,0.714285714285714,0.734806629834254,0.234132751937985
E02000701,Mitcham East,Merton,London,1849,5614,274,250,173,271,6582,2049,7725,382,295,219,320,8941,1419,296,236,164,240,2355,0.18368932038835,0.774869109947644,0.8,0.748858447488584,0.75,0.263393356447825
E02000702,Lonesome,Merton,London,2220,5627,314,180,172,223,6516,2286,7087,346,251,157,254,8095,1345,247,186,114,196,2088,0.189784111753916,0.713872832369942,0.741035856573705,0.726114649681529,0.771653543307087,0.257936998147004
E02000703,Merton Park,Merton,London,1647,4856,404,346,278,416,6300,1661,6080,418,419,290,432,7639,1202,352,370,262,380,2566,0.197697368421053,0.842105263157895,0.883054892601432,0.903448275862069,0.87962962962963,0.33590784134049
E02000704,Raynes Park,Merton,London,1577,5695,290,235,188,341,6749,1787,7422,315,286,218,331,8572,1173,239,250,180,280,2122,0.158043654001617,0.758730158730159,0.874125874125874,0.825688073394496,0.845921450151057,0.247550163322445
E02000705,Rowan Road,Merton,London,1808,5560,361,256,224,316,6717,1977,7419,453,320,251,394,8837,1290,340,247,199,303,2379,0.173877881116053,0.750551876379691,0.771875,0.792828685258964,0.769035532994924,0.269209007581759
E02000706,Mitcham West,Merton,London,2475,6026,306,193,162,211,6898,2539,8018,347,245,172,244,9026,1543,227,184,120,193,2267,0.192442005487653,0.654178674351585,0.751020408163265,0.697674418604651,0.790983606557377,0.251163306004875
E02000707,Pollards Hill,Merton,London,1736,4889,286,206,145,194,5720,1898,6710,309,249,164,268,7700,1286,213,187,126,199,2011,0.191654247391952,0.689320388349515,0.751004016064257,0.768292682926829,0.742537313432836,0.261168831168831
E02000708,West Barnes,Merton,London,1797,5290,370,337,220,333,6550,1965,7295,414,379,231,372,8691,1246,339,326,199,313,2423,0.170801919122687,0.818840579710145,0.860158311345647,0.861471861471862,0.841397849462366,0.278794154872857
E02000709,Cannon Hill,Merton,London,1534,4685,384,377,263,403,6112,1678,5688,411,389,281,448,7217,1296,357,335,244,406,2638,0.227848101265823,0.868613138686131,0.861182519280206,0.868327402135231,0.90625,0.365525841762505
E02000710,Mitcham South,Merton,London,1830,5362,326,314,253,490,6745,1981,6713,383,366,262,436,8160,1390,296,302,220,371,2579,0.207060926560405,0.772845953002611,0.825136612021858,0.83969465648855,0.850917431192661,0.316053921568627
E02000711,Morden Central,Merton,London,1943,5985,256,254,146,273,6914,2101,7894,305,260,177,299,8935,1389,227,204,141,250,2211,0.175956422599443,0.744262295081967,0.784615384615385,0.796610169491525,0.836120401337793,0.247453833240067
E02000712,St Helier North,Merton,London,1965,5618,316,298,194,379,6805,2097,7201,372,338,210,398,8519,1550,288,281,183,341,2643,0.215247882238578,0.774193548387097,0.831360946745562,0.871428571428572,0.85678391959799,0.310247681652776
E02000713,Lower Morden,Merton,London,1514,4514,372,356,223,365,5830,1575,5510,383,394,237,401,6925,1361,332,354,211,347,2605,0.247005444646098,0.866840731070496,0.898477157360406,0.890295358649789,0.865336658354115,0.376173285198556
E02000714,Forest Gate North,Newham,London,1763,5700,202,134,112,169,6317,1907,7426,272,157,126,156,8137,935,181,115,95,114,1440,0.125908968489092,0.665441176470588,0.732484076433121,0.753968253968254,0.730769230769231,0.176969399041416
E02000715,Little Ilford West,Newham,London,2088,4883,214,135,138,211,5581,2208,6110,211,151,109,165,6746,776,124,107,86,123,1216,0.127004909983633,0.587677725118483,0.708609271523179,0.788990825688074,0.745454545454546,0.180254965905722
E02000716,Manor Park North,Newham,London,1831,5180,250,159,109,200,5898,2114,6615,283,169,97,175,7339,750,184,121,71,124,1250,0.113378684807256,0.65017667844523,0.715976331360947,0.731958762886598,0.708571428571429,0.170322932279602
E02000717,Manor Park South,Newham,London,2170,5595,231,145,122,159,6252,2418,7473,253,185,113,161,8185,887,166,137,88,115,1393,0.118693964940452,0.656126482213439,0.740540540540541,0.778761061946903,0.714285714285714,0.170189370800244
E02000718,Little Ilford East,Newham,London,2235,4652,181,130,113,128,5204,2260,6036,201,135,101,141,6614,779,131,100,72,104,1186,0.129058979456594,0.651741293532338,0.740740740740741,0.712871287128713,0.73758865248227,0.179316601149078
E02000719,Forest Gate West,Newham,London,1663,6192,212,226,150,186,6966,1753,7924,260,171,117,154,8626,919,162,122,84,117,1404,0.115976779404341,0.623076923076923,0.713450292397661,0.717948717948718,0.75974025974026,0.162763737537677
E02000720,Forest Gate East,Newham,London,1818,5155,279,210,131,183,5958,2023,7345,295,210,134,189,8173,854,194,164,102,134,1448,0.116269571136828,0.657627118644068,0.780952380952381,0.761194029850746,0.708994708994709,0.177168726293895
E02000721,Forest Gate South,Newham,London,2445,6477,232,197,123,217,7246,2803,9874,314,217,112,205,10722,969,203,168,83,148,1571,0.0981365201539396,0.646496815286624,0.774193548387097,0.741071428571429,0.721951219512195,0.146521171423242
E02000722,Stratford East,Newham,London,1534,6295,218,166,83,174,6936,1643,8210,247,187,104,184,8932,952,132,134,79,139,1436,0.115956151035323,0.534412955465587,0.716577540106952,0.759615384615385,0.755434782608696,0.16077026421854
E02000723,East Ham North,Newham,London,2536,7671,393,213,210,265,8752,2845,11112,424,234,170,288,12228,1150,304,181,146,222,2003,0.103491720662347,0.716981132075472,0.773504273504274,0.858823529411765,0.770833333333333,0.163804383382401
E02000724,Plashet East,Newham,London,2545,6582,262,164,193,238,7439,2640,9178,298,192,154,198,10020,1002,185,137,111,147,1582,0.109174112006973,0.620805369127517,0.713541666666667,0.720779220779221,0.742424242424242,0.157884231536926
E02000725,Stratford Central,Newham,London,1596,7854,266,165,124,148,8557,1876,9502,280,185,114,176,10257,1056,168,127,86,122,1559,0.111134498000421,0.6,0.686486486486487,0.754385964912281,0.693181818181818,0.151993760358779
E02000726,Olympic Park & Mill Meads,Newham,London,3492,22359,232,157,124,149,23021,3619,23661,323,184,127,157,24452,2671,198,121,90,106,3186,0.112886184015891,0.613003095975232,0.657608695652174,0.708661417322835,0.67515923566879,0.130296090299362
E02000727,Plashet West,Newham,London,2167,5831,238,140,124,162,6495,2426,8928,306,175,107,179,9695,968,206,132,72,133,1511,0.1084229390681,0.673202614379085,0.754285714285714,0.672897196261682,0.743016759776536,0.15585353274884
E02000728,Wallend North,Newham,London,2004,5446,289,191,120,146,6192,2343,8180,313,188,114,156,8951,866,220,148,96,118,1448,0.105867970660147,0.702875399361022,0.787234042553192,0.842105263157895,0.756410256410256,0.16176963467769
E02000729,West Ham Park,Newham,London,1633,4983,281,161,102,158,5685,1678,6446,288,193,109,180,7216,705,187,147,80,143,1262,0.109370152032268,0.649305555555556,0.761658031088083,0.73394495412844,0.794444444444444,0.174889135254989
E02000730,Upton Park,Newham,London,2043,6024,357,240,165,253,7039,2448,9607,358,260,171,246,10642,1134,250,194,121,184,1883,0.118038929946914,0.698324022346369,0.746153846153846,0.707602339181287,0.747967479674797,0.176940424732193
E02000731,East Ham Central,Newham,London,2613,7487,298,242,144,198,8369,2734,9504,318,245,142,207,10416,1031,207,197,107,172,1714,0.10848063973064,0.650943396226415,0.804081632653061,0.753521126760563,0.830917874396135,0.164554531490015
E02000732,East Ham West,Newham,London,2020,5259,211,153,129,183,5935,2170,7199,249,163,124,180,7915,1007,159,126,93,133,1518,0.139880538963745,0.63855421686747,0.773006134969325,0.75,0.738888888888889,0.191787744788377
E02000733,West Ham & Stratford Park,Newham,London,1920,7281,321,252,149,214,8217,2021,9562,338,265,150,172,10487,961,210,193,109,130,1603,0.100501987032002,0.621301775147929,0.728301886792453,0.726666666666667,0.755813953488372,0.152855916849433
E02000734,Plaistow North,Newham,London,1628,5363,230,148,110,176,6027,1675,6812,224,176,105,178,7495,767,142,131,82,130,1252,0.112595419847328,0.633928571428571,0.744318181818182,0.780952380952381,0.730337078651685,0.16704469646431
E02000735,Plaistow North East,Newham,London,1937,5802,246,202,163,327,6740,2174,7528,259,203,163,230,8383,772,172,157,120,162,1383,0.102550478214665,0.664092664092664,0.773399014778325,0.736196319018405,0.704347826086957,0.164976738637719
E02000736,Wallend South,Newham,London,2516,5864,214,167,101,194,6540,2612,7575,242,187,116,163,8283,901,149,139,96,130,1415,0.118943894389439,0.615702479338843,0.74331550802139,0.827586206896552,0.797546012269939,0.170831824218278
E02000737,East Ham South,Newham,London,2587,6644,266,266,162,214,7552,2715,8306,320,238,141,203,9208,1048,210,193,107,153,1711,0.12617385022875,0.65625,0.810924369747899,0.75886524822695,0.753694581280788,0.185816681146829
E02000738,East Ham South West,Newham,London,2418,6091,211,195,98,205,6800,2585,7789,265,183,115,169,8521,983,190,143,94,143,1553,0.126203620490435,0.716981132075472,0.781420765027322,0.817391304347826,0.846153846153846,0.182255603802371
E02000739,Plaistow Park,Newham,London,1668,5293,223,163,117,129,5925,1711,7078,258,204,100,130,7770,660,156,145,78,102,1141,0.0932466798530658,0.604651162790698,0.71078431372549,0.78,0.784615384615385,0.146846846846847
E02000740,Canning Town North,Newham,London,1496,5056,235,139,92,117,5639,1516,6349,233,166,92,113,6953,658,147,116,68,84,1073,0.103638368246968,0.630901287553648,0.698795180722892,0.739130434782609,0.743362831858407,0.154321875449446
E02000741,Plaistow South,Newham,London,2121,5944,280,162,123,153,6662,2235,7377,284,181,116,151,8109,869,192,140,89,100,1390,0.117798563101532,0.676056338028169,0.773480662983426,0.767241379310345,0.662251655629139,0.171414477740782
E02000742,Lonsdale Avenue,Newham,London,2419,5667,225,130,123,221,6366,2402,6888,242,160,109,181,7580,803,163,110,74,138,1288,0.116579558652729,0.673553719008265,0.6875,0.678899082568807,0.762430939226519,0.169920844327177
E02000743,Canning Town Central,Newham,London,2156,7161,294,193,159,217,8024,2299,9361,318,197,121,218,10215,958,184,138,89,158,1527,0.102339493643841,0.578616352201258,0.700507614213198,0.735537190082645,0.724770642201835,0.149486049926579
E02000744,Canning Town East,Newham,London,2301,6454,229,195,106,222,7206,2293,7903,257,199,121,168,8648,881,171,155,100,132,1439,0.111476654435025,0.665369649805447,0.778894472361809,0.826446280991736,0.785714285714286,0.166396854764107
E02000745,Beckton North,Newham,London,1862,5743,232,138,122,134,6369,2066,7498,327,194,105,121,8245,707,205,152,76,83,1223,0.0942918111496399,0.62691131498471,0.783505154639175,0.723809523809524,0.685950413223141,0.14833232261977
E02000746,Beckton,Newham,London,1711,6200,200,118,77,143,6738,1951,8055,264,176,73,118,8686,938,155,136,51,89,1369,0.116449410304159,0.587121212121212,0.772727272727273,0.698630136986301,0.754237288135593,0.157609947041216
E02000747,Canning Town South & Bow Creek,Newham,London,2337,10824,293,243,177,218,11755,2383,11533,308,222,166,152,12381,1101,188,173,126,117,1705,0.0954651868551114,0.61038961038961,0.779279279279279,0.759036144578313,0.769736842105263,0.137711008803812
E02000748,Beckton Park,Newham,London,1597,4386,211,113,88,80,4878,1660,6184,238,130,88,108,6748,534,147,109,70,81,941,0.0863518758085382,0.617647058823529,0.838461538461539,0.795454545454545,0.75,0.139448725548311
E02000749,Custom House,Newham,London,2034,5825,241,185,144,141,6536,2213,7808,301,223,129,184,8645,876,188,161,93,147,1465,0.11219262295082,0.624584717607973,0.721973094170404,0.72093023255814,0.798913043478261,0.169462116830538
E02000750,Royal Docks & North Woolwich,Newham,London,3235,12544,211,170,106,148,13179,3746,14711,286,186,126,123,15432,1620,179,126,96,101,2122,0.110121677656176,0.625874125874126,0.67741935483871,0.761904761904762,0.821138211382114,0.137506480041472
E02000751,Woodford Wells,Redbridge,London,1789,6384,573,638,457,775,8827,1982,7449,623,656,501,711,9940,1783,549,610,474,665,4081,0.239360988052088,0.881219903691814,0.929878048780488,0.946107784431138,0.935302390998594,0.41056338028169
E02000752,Hainault East,Redbridge,London,1760,5091,277,293,160,251,6072,2025,6237,289,293,183,267,7269,1095,175,243,157,223,1893,0.175565175565176,0.605536332179931,0.829351535836178,0.85792349726776,0.835205992509363,0.260420965744944
E02000753,Hainault West,Redbridge,London,1387,4281,234,186,161,340,5202,1526,5075,261,236,167,263,6002,884,178,192,148,231,1633,0.174187192118227,0.681992337164751,0.813559322033898,0.88622754491018,0.878326996197719,0.272075974675108
E02000754,Woodford Green,Redbridge,London,1326,4398,278,245,178,220,5319,1417,4998,296,292,165,251,6002,907,225,243,151,222,1748,0.181472589035614,0.760135135135135,0.832191780821918,0.915151515151515,0.884462151394422,0.291236254581806
E02000755,Woodford Bridge,Redbridge,London,1125,3601,228,250,171,218,4468,1163,3944,239,222,186,205,4796,747,189,201,163,184,1484,0.189401622718053,0.790794979079498,0.905405405405405,0.876344086021505,0.897560975609756,0.309424520433695
E02000756,Fairlop,Redbridge,London,2819,9072,574,517,363,515,11041,3222,10466,567,548,401,484,12466,1942,428,471,346,425,3612,0.185553219950315,0.754850088183422,0.85948905109489,0.86284289276808,0.878099173553719,0.289748114872453
E02000757,South Woodford High Road,Redbridge,London,2361,8623,491,454,276,533,10377,2563,9205,493,501,304,494,10997,1665,405,431,282,452,3235,0.180879956545356,0.821501014198783,0.860279441117764,0.927631578947368,0.91497975708502,0.294171137582977
E02000758,Clayhall North,Redbridge,London,1309,4006,255,252,180,323,5016,1472,4704,286,274,176,314,5754,1079,236,236,161,286,1998,0.22937925170068,0.825174825174825,0.861313868613139,0.914772727272727,0.910828025477707,0.347236704900939
E02000759,Roding,Redbridge,London,2952,8810,515,374,277,389,10365,3016,9839,528,403,271,409,11450,1722,401,338,238,362,3061,0.175017786360402,0.759469696969697,0.838709677419355,0.878228782287823,0.885085574572127,0.267336244541485
E02000760,Barkingside North,Redbridge,London,1587,4547,272,265,197,355,5636,1707,5530,327,286,210,340,6693,1155,268,237,183,302,2145,0.208860759493671,0.819571865443425,0.828671328671329,0.871428571428572,0.888235294117647,0.320484087852981
E02000762,Barkingside West,Redbridge,London,1246,4294,332,262,180,342,5410,1295,4815,317,304,197,335,5968,1022,259,265,170,303,2019,0.212253374870197,0.817034700315458,0.87171052631579,0.862944162436548,0.904477611940299,0.338304289544236
E02000763,Aldborough Hatch,Redbridge,London,1628,5011,304,227,178,281,6001,1769,5675,292,253,187,247,6654,1068,221,207,162,221,1879,0.188193832599119,0.756849315068493,0.818181818181818,0.866310160427808,0.894736842105263,0.282386534415389
E02000764,Snaresbrook,Redbridge,London,2006,8209,557,498,414,737,10415,2203,8805,550,554,449,745,11103,1777,468,473,408,690,3816,0.201817149346962,0.850909090909091,0.853790613718412,0.908685968819599,0.926174496644295,0.343690894352878
E02000765,Barkingside East,Redbridge,London,1535,4518,282,201,159,329,5489,1657,5436,284,229,141,308,6398,841,216,190,117,263,1627,0.154709345106696,0.76056338028169,0.829694323144105,0.829787234042553,0.853896103896104,0.254298218193185
E02000767,Newbury Park,Redbridge,London,1936,5371,333,244,234,307,6489,2074,6286,326,272,212,339,7435,1072,253,228,188,285,2026,0.170537702831689,0.776073619631902,0.838235294117647,0.886792452830189,0.84070796460177,0.272494956287828
E02000768,Wanstead,Redbridge,London,1169,3657,266,282,169,280,4654,1284,4205,273,316,169,296,5259,868,227,283,151,267,1796,0.206420927467301,0.831501831501832,0.895569620253165,0.893491124260355,0.902027027027027,0.341509792736262
E02000769,Chadwell Heath West,Redbridge,London,4071,10155,474,316,267,532,11744,4390,11854,538,365,264,578,13599,1860,348,297,206,501,3212,0.156909060232833,0.646840148698885,0.813698630136986,0.78030303030303,0.866782006920415,0.23619383778219
E02000770,Seven Kings Park,Redbridge,London,1859,5290,308,235,153,274,6260,1914,6266,340,268,173,264,7311,1205,268,225,152,211,2061,0.192307692307692,0.788235294117647,0.83955223880597,0.878612716763006,0.799242424242424,0.281903980303652
E02000772,Goodmayes North,Redbridge,London,2315,5911,311,176,107,234,6739,2282,6665,313,181,134,190,7483,1050,227,144,111,158,1690,0.157539384846212,0.725239616613419,0.795580110497238,0.828358208955224,0.831578947368421,0.225845249231592
E02000773,Ley Street,Redbridge,London,2515,6652,313,227,169,224,7585,2503,7603,319,256,181,265,8624,1386,231,215,147,206,2185,0.182296461922925,0.724137931034483,0.83984375,0.812154696132597,0.777358490566038,0.253362708719852
E02000774,Seven Kings Meads Lane,Redbridge,London,1754,4954,271,209,155,216,5805,1967,6084,300,235,149,211,6979,966,219,193,124,170,1672,0.158777120315582,0.73,0.821276595744681,0.832214765100671,0.805687203791469,0.239575870468549
E02000776,Ilford North East,Redbridge,London,1851,4414,272,175,120,157,5138,2073,5620,284,210,135,196,6445,924,210,165,120,163,1582,0.1644128113879,0.73943661971831,0.785714285714286,0.888888888888889,0.831632653061224,0.245461598138092
E02000777,Wanstead Flats,Redbridge,London,1154,3865,332,273,151,249,4870,1248,4340,348,315,185,240,5428,970,295,292,163,215,1935,0.223502304147465,0.847701149425287,0.926984126984127,0.881081081081081,0.895833333333333,0.356484893146647
E02000779,Ilford North West,Redbridge,London,2355,5908,286,199,107,198,6698,2647,8170,296,200,137,231,9034,1037,197,154,105,197,1690,0.126927784577723,0.665540540540541,0.77,0.766423357664234,0.852813852813853,0.187071064866062
E02000780,Ilford South East,Redbridge,London,4932,11459,428,369,249,369,12874,5466,15480,546,413,252,373,17064,1832,358,320,199,309,3018,0.118346253229974,0.655677655677656,0.774818401937046,0.78968253968254,0.828418230563003,0.176863572433193
E02000781,South Park,Redbridge,London,3567,9727,543,478,328,497,11573,3926,11631,583,486,339,525,13564,1839,426,395,291,431,3382,0.158111942223369,0.730703259005146,0.812757201646091,0.858407079646018,0.820952380952381,0.249336478914774
E02000782,Ilford South West,Redbridge,London,2906,6990,249,163,178,258,7838,3407,9662,307,219,137,252,10577,1026,192,155,96,191,1660,0.106189194783689,0.625407166123778,0.707762557077626,0.700729927007299,0.757936507936508,0.156944313132268
E02000783,Loxford Park,Redbridge,London,2234,4951,208,151,111,158,5579,2225,6444,212,161,116,170,7103,652,144,118,85,130,1129,0.101179391682185,0.679245283018868,0.732919254658385,0.732758620689655,0.764705882352941,0.158946923834999
E02006800,Goodmayes South,Redbridge,London,3530,9616,493,348,219,282,10958,3965,11764,590,371,224,309,13258,1626,405,296,179,237,2743,0.138218293097586,0.686440677966102,0.797843665768194,0.799107142857143,0.766990291262136,0.206893950822145
E02006924,Valentines Park & Cranbrook,Redbridge,London,2737,9071,578,472,333,576,11030,3180,10844,638,498,334,579,12893,1921,477,413,298,501,3610,0.177148653633346,0.747648902821317,0.829317269076305,0.892215568862276,0.865284974093264,0.279996897541301
E02006925,Clayhall South,Redbridge,London,2783,9036,668,547,413,588,11252,2713,10160,674,578,403,592,12407,2293,567,507,351,528,4246,0.225688976377953,0.841246290801187,0.877162629757786,0.870967741935484,0.891891891891892,0.342226162650117
E02000784,North Barnes,Richmond upon Thames,London,2020,6275,480,487,371,488,8101,2135,8602,550,552,438,577,10719,1565,424,470,385,492,3336,0.181934433852592,0.770909090909091,0.851449275362319,0.878995433789955,0.852686308492201,0.311223061852785
E02000785,Kew Gardens,Richmond upon Thames,London,1919,6375,451,457,369,499,8151,1884,7712,469,504,371,572,9628,986,365,443,349,512,2655,0.127852697095436,0.778251599147122,0.878968253968254,0.940700808625337,0.895104895104895,0.275758205234732
E02000786,Mortlake & South Barnes,Richmond upon Thames,London,2602,7301,508,475,317,402,9003,2786,9747,500,554,352,433,11586,1638,386,485,315,372,3196,0.168051708217913,0.772,0.875451263537906,0.894886363636364,0.859122401847575,0.275850163991024
E02000787,North Sheen,Richmond upon Thames,London,2702,7972,455,440,290,392,9549,2840,9975,427,498,316,436,11652,1179,296,425,272,389,2561,0.118195488721805,0.693208430913349,0.853413654618474,0.860759493670886,0.892201834862385,0.219790593889461
E02000788,East Sheen North,Richmond upon Thames,London,2159,5576,413,351,251,354,6945,2323,7232,419,430,290,376,8747,1176,335,381,256,334,2482,0.162610619469027,0.799522673031026,0.886046511627907,0.882758620689655,0.888297872340426,0.283754430090317
E02000789,Queen's Road,Richmond upon Thames,London,1267,4273,280,290,210,304,5357,1337,5246,284,305,217,327,6379,496,206,266,191,287,1446,0.0945482272207396,0.725352112676056,0.872131147540984,0.880184331797235,0.877675840978593,0.226681298009092
E02000790,St Margarets,Richmond upon Thames,London,1547,4360,230,245,110,181,5126,1569,5361,249,220,164,175,6169,609,211,195,153,160,1328,0.113598209289312,0.847389558232932,0.886363636363636,0.932926829268293,0.914285714285714,0.215269897876479
E02000791,Richmond Central,Richmond upon Thames,London,1248,4999,270,323,191,302,6085,1421,6409,300,330,231,290,7560,416,185,273,207,263,1344,0.0649087221095335,0.616666666666667,0.827272727272727,0.896103896103896,0.906896551724138,0.177777777777778
E02000792,Twickenham Marble Hill,Richmond upon Thames,London,1456,4650,319,317,243,365,5894,1526,5694,354,333,282,380,7043,535,263,294,249,341,1682,0.0939585528626625,0.742937853107345,0.882882882882883,0.882978723404255,0.897368421052632,0.238818685219367
E02000793,Whitton,Richmond upon Thames,London,1690,5255,405,350,269,370,6649,1680,5784,394,371,282,403,7234,894,339,329,262,364,2188,0.154564315352697,0.860406091370558,0.886792452830189,0.929078014184397,0.903225806451613,0.302460602709428
E02000794,Twickenham North,Richmond upon Thames,London,1529,4539,277,249,177,285,5527,1544,5364,315,291,193,276,6439,747,253,244,182,251,1677,0.139261744966443,0.803174603174603,0.838487972508591,0.94300518134715,0.909420289855072,0.260444168349123
E02000795,"Richmond Park, Sheen Gate & Petersham",Richmond upon Thames,London,1780,4051,303,357,295,399,5405,1769,4979,350,372,329,425,6455,772,283,338,297,385,2075,0.155051215103434,0.808571428571429,0.908602150537634,0.90273556231003,0.905882352941176,0.321456235476375
E02000796,Heathfield,Richmond upon Thames,London,2430,6621,476,452,327,485,8361,2429,7686,513,499,345,501,9544,1469,428,438,313,452,3100,0.191126723913609,0.834307992202729,0.877755511022044,0.907246376811594,0.902195608782435,0.324811399832355
E02000797,Twickenham Town,Richmond upon Thames,London,1656,5362,327,264,165,223,6341,1712,6403,330,288,185,215,7421,686,254,248,159,200,1547,0.107137279400281,0.76969696969697,0.861111111111111,0.85945945945946,0.930232558139535,0.208462471365045
E02000798,Twickenham West,Richmond upon Thames,London,2586,7004,422,409,254,413,8502,2715,8280,460,448,294,379,9861,1203,361,389,258,339,2550,0.145289855072464,0.784782608695652,0.868303571428571,0.877551020408163,0.894459102902375,0.258594463036203
E02000799,Strawberry Hill,Richmond upon Thames,London,1175,4056,312,302,158,226,5054,1168,5313,340,303,214,250,6420,655,263,274,192,233,1617,0.123282514586862,0.773529411764706,0.904290429042904,0.897196261682243,0.932,0.251869158878505
E02000800,Ham,Richmond upon Thames,London,1268,3312,265,214,178,252,4221,1343,3933,265,239,192,217,4846,575,201,212,172,192,1352,0.146198830409357,0.758490566037736,0.887029288702929,0.895833333333333,0.884792626728111,0.278992983904251
E02000801,Teddington North,Richmond upon Thames,London,1578,4608,317,302,193,231,5651,1600,5169,327,329,223,233,6281,749,281,297,205,205,1737,0.14490230218611,0.859327217125382,0.90273556231003,0.919282511210762,0.879828326180258,0.276548320331157
E02000802,Hampton Hill,Richmond upon Thames,London,1363,4320,336,327,228,359,5570,1436,5062,352,374,254,367,6409,813,295,339,234,338,2019,0.160608455156065,0.838068181818182,0.906417112299465,0.921259842519685,0.920980926430518,0.315025745046029
E02000803,Nursery Lands & Hampton North,Richmond upon Thames,London,1982,5732,514,471,271,500,7488,1983,6688,548,544,323,498,8601,1306,469,482,285,451,2993,0.195275119617225,0.855839416058394,0.886029411764706,0.882352941176471,0.905622489959839,0.347982792698523
E02000804,Teddington Central,Richmond upon Thames,London,1372,4718,338,370,187,350,5963,1362,5306,346,378,259,351,6640,734,291,335,233,321,1914,0.138333961552959,0.841040462427746,0.886243386243386,0.8996138996139,0.914529914529914,0.288253012048193
E02000805,Hampton Wick & Teddington East,Richmond upon Thames,London,2264,7392,485,492,296,502,9167,2274,8580,570,512,347,488,10497,1261,478,459,298,424,2920,0.146969696969697,0.83859649122807,0.896484375,0.858789625360231,0.868852459016394,0.278174716585691
E02000806,Hampton Village,Richmond upon Thames,London,2027,6256,607,562,306,558,8289,2077,7088,607,585,398,526,9204,1331,527,527,372,487,3244,0.187782167042889,0.868204283360791,0.900854700854701,0.934673366834171,0.925855513307985,0.352455454150369
E02000807,Rotherhithe,Southwark,London,1257,7536,265,201,123,127,8252,1258,8660,311,213,122,121,9427,1048,235,158,100,101,1642,0.121016166281755,0.755627009646302,0.741784037558686,0.819672131147541,0.834710743801653,0.174180545242389
E02000808,Borough & Southwark Street,Southwark,London,1081,9648,261,182,103,179,10373,1039,12513,279,223,123,191,13329,1286,191,173,94,145,1889,0.102773115959402,0.684587813620072,0.775784753363229,0.764227642276423,0.759162303664922,0.141721059344287
E02000809,Bermondsey North,Southwark,London,1624,12044,277,183,89,97,12690,1387,12005,312,199,107,110,12733,1290,210,154,78,80,1812,0.107455226988755,0.673076923076923,0.773869346733668,0.728971962616822,0.727272727272727,0.142307390245818
E02000810,Bermondsey East,Southwark,London,2571,10007,336,230,150,217,10940,2231,10445,307,283,150,195,11380,1397,216,234,126,153,2126,0.133748204882719,0.703583061889251,0.826855123674912,0.84,0.784615384615385,0.186818980667838
E02000812,London Bridge & Bermondsey West,Southwark,London,1736,8172,263,213,169,263,9080,1640,10935,294,232,158,279,11898,1453,201,179,113,217,2163,0.132876085962506,0.683673469387755,0.771551724137931,0.715189873417722,0.777777777777778,0.181795259707514
E02000813,Canada Water,Southwark,London,2036,8019,261,212,138,199,8829,1831,9564,292,219,134,170,10379,1125,208,168,99,140,1740,0.11762860727729,0.712328767123288,0.767123287671233,0.738805970149254,0.823529411764706,0.167646208690625
E02000814,Surrey Quays,Southwark,London,1574,8032,256,178,156,160,8782,1624,10642,327,224,127,164,11484,1182,218,151,90,117,1758,0.111069347866942,0.666666666666667,0.674107142857143,0.708661417322835,0.713414634146341,0.153082549634274
E02000815,Elephant & Castle,Southwark,London,862,6030,101,63,41,152,6387,962,8177,129,95,82,86,8569,958,87,58,58,61,1222,0.117157881863764,0.674418604651163,0.610526315789474,0.707317073170732,0.709302325581395,0.142607072003734
E02000816,South Bermondsey Central,Southwark,London,2040,7679,277,234,142,221,8553,1782,8488,282,207,135,199,9311,1103,196,168,107,171,1745,0.129948162111216,0.695035460992908,0.811594202898551,0.792592592592593,0.85929648241206,0.187412737622167
E02000817,South Bermondsey East,Southwark,London,1500,4938,237,189,133,290,5787,1289,5673,263,195,117,254,6502,835,204,164,91,220,1514,0.147188436453376,0.775665399239544,0.841025641025641,0.777777777777778,0.866141732283465,0.23285143032913
E02000818,Walworth North,Southwark,London,1317,6372,249,230,153,189,7193,1406,9192,293,223,174,216,10098,1139,198,169,125,158,1789,0.123912097476066,0.675767918088737,0.757847533632287,0.718390804597701,0.731481481481482,0.177163794810854
E02000819,South Bermondsey West,Southwark,London,1680,6428,237,162,140,181,7148,1632,7758,272,177,132,181,8520,1140,189,142,95,130,1696,0.146945088940449,0.694852941176471,0.80225988700565,0.71969696969697,0.718232044198895,0.19906103286385
E02000820,Kennington East,Southwark,London,1661,7990,273,226,143,222,8854,1552,10161,306,196,158,195,11016,1203,201,147,111,148,1810,0.118393858872158,0.656862745098039,0.75,0.70253164556962,0.758974358974359,0.164306463326071
E02000821,Burgess Park,Southwark,London,2053,5182,227,191,104,181,5885,1947,8302,253,201,119,159,9034,899,142,131,92,114,1378,0.108287159720549,0.561264822134387,0.651741293532338,0.773109243697479,0.716981132075472,0.152534868275404
E02000822,Walworth South,Southwark,London,1672,5016,164,135,86,146,5547,1500,6882,216,177,86,137,7498,822,142,140,61,98,1263,0.119442022667829,0.657407407407407,0.790960451977401,0.709302325581395,0.715328467153285,0.168444918644972
E02000823,Burgess Park West & John Ruskin Street,Southwark,London,1584,6497,273,236,158,199,7363,1508,8308,283,233,177,227,9228,1041,186,163,120,157,1667,0.125300914780934,0.657243816254417,0.699570815450644,0.677966101694915,0.691629955947137,0.180645860424794
E02000824,Peckham Park Road,Southwark,London,2327,6570,289,226,155,230,7470,2204,8863,344,239,154,222,9822,1008,172,157,107,151,1595,0.113731242243033,0.5,0.656903765690377,0.694805194805195,0.68018018018018,0.162390551822439
E02000825,Peckham North West,Southwark,London,2328,6475,196,174,179,167,7191,2302,9230,326,224,145,200,10125,1026,173,126,94,124,1543,0.111159263271939,0.530674846625767,0.5625,0.648275862068966,0.62,0.152395061728395
E02000826,Camberwell North,Southwark,London,1816,6656,252,207,149,216,7480,1878,8928,312,232,158,196,9826,999,172,144,102,128,1545,0.111895161290323,0.551282051282051,0.620689655172414,0.645569620253165,0.653061224489796,0.15723590474252
E02000827,Camberwell Green,Southwark,London,2310,7882,300,252,163,218,8815,2203,10228,393,296,158,249,11324,1285,247,211,111,164,2018,0.125635510363707,0.628498727735369,0.712837837837838,0.70253164556962,0.658634538152611,0.178205581066761
E02000828,Peckham North,Southwark,London,1738,6145,253,159,136,177,6870,1769,8640,289,208,138,187,9462,919,142,143,81,121,1406,0.106365740740741,0.491349480968858,0.6875,0.586956521739131,0.647058823529412,0.14859437751004
E02000829,Queens Road Peckham,Southwark,London,2003,8560,319,223,213,263,9578,1986,9676,365,276,202,348,10867,1010,217,198,138,239,1802,0.10438197602315,0.594520547945206,0.717391304347826,0.683168316831683,0.686781609195402,0.165823134259685
E02000830,Camberwell South,Southwark,London,1461,6956,262,236,127,229,7810,1454,8579,271,235,177,244,9506,965,167,178,134,172,1616,0.112483972490966,0.616236162361624,0.757446808510638,0.757062146892655,0.704918032786885,0.169997896065643
E02000831,Peckham Rye,Southwark,London,1836,7235,274,241,165,212,8127,1797,8643,298,236,148,248,9573,924,184,188,107,170,1573,0.106907323845887,0.61744966442953,0.796610169491525,0.722972972972973,0.685483870967742,0.164316306278074
E02000832,Nunhead North,Southwark,London,2214,7390,337,259,227,328,8541,1926,8259,384,303,174,273,9393,992,230,217,132,197,1768,0.12011139363119,0.598958333333333,0.716171617161716,0.758620689655172,0.721611721611722,0.188225274140317
E02000833,North Dulwich,Southwark,London,1837,6200,191,159,98,213,6861,1653,6891,212,166,119,186,7574,1039,140,125,91,125,1520,0.15077637498186,0.660377358490566,0.753012048192771,0.764705882352941,0.672043010752688,0.200686559281753
E02000834,Peckham Rye Common,Southwark,London,1857,7065,261,252,176,257,8011,1756,7668,310,260,168,224,8630,1061,214,213,125,175,1788,0.138367240479917,0.690322580645161,0.819230769230769,0.744047619047619,0.78125,0.207184241019699
E02000835,Nunhead South & Newlands,Southwark,London,1844,5257,226,158,122,196,5959,1808,5916,266,172,113,195,6662,863,187,137,88,143,1418,0.145875591615957,0.703007518796993,0.796511627906977,0.778761061946903,0.733333333333333,0.212848994296007
E02000836,East Dulwich,Southwark,London,1912,5834,252,200,157,204,6647,1884,6798,336,210,169,242,7755,961,266,181,145,182,1735,0.141365107384525,0.791666666666667,0.861904761904762,0.857988165680473,0.752066115702479,0.223726627981947
E02000837,Herne Hill & Dulwich Park,Southwark,London,2336,5818,372,293,233,366,7082,2153,6784,409,352,240,384,8169,1321,353,316,205,339,2534,0.194722877358491,0.863080684596577,0.897727272727273,0.854166666666667,0.8828125,0.310197086546701
E02000838,Dulwich Hill,Southwark,London,2277,6545,316,272,149,257,7539,2202,7712,341,298,188,255,8794,1119,251,232,143,201,1946,0.145098547717842,0.736070381231672,0.778523489932886,0.76063829787234,0.788235294117647,0.221287241300887
E02000839,Sydenham Hill,Southwark,London,1988,5444,302,299,200,268,6513,1971,6633,334,334,272,329,7902,1319,248,256,219,261,2303,0.198854213779587,0.74251497005988,0.766467065868264,0.805147058823529,0.793313069908815,0.291445203745887
E02006802,Southwark St George's,Southwark,London,1212,6534,196,147,100,152,7129,1360,10108,265,183,126,173,10855,1158,185,132,91,125,1691,0.114562722595964,0.69811320754717,0.721311475409836,0.722222222222222,0.722543352601156,0.155780746199908
E02000840,Middleton Circle,Sutton,London,2241,5569,272,208,161,241,6451,2264,6432,292,223,145,237,7329,1187,231,188,127,201,1934,0.184546019900498,0.791095890410959,0.84304932735426,0.875862068965517,0.848101265822785,0.263883203711284
E02000841,St Helier South,Sutton,London,2146,6106,316,211,172,299,7104,2139,6816,341,218,171,255,7801,1376,269,180,146,200,2171,0.2018779342723,0.788856304985337,0.825688073394496,0.853801169590643,0.784313725490196,0.278297654146904
E02000842,Stonecot,Sutton,London,1517,5121,390,365,240,329,6445,1612,5800,435,424,250,411,7320,1474,381,372,225,364,2816,0.254137931034483,0.875862068965517,0.877358490566038,0.9,0.885644768856448,0.384699453551913
E02000843,Hackbridge,Sutton,London,1956,5819,262,243,146,222,6692,2114,6385,296,252,153,266,7352,1152,241,234,141,246,2014,0.180422866092404,0.814189189189189,0.928571428571429,0.92156862745098,0.924812030075188,0.273939064200218
E02000844,The Wrythe,Sutton,London,1961,5507,279,269,187,267,6509,1993,6289,306,318,185,303,7401,1178,248,283,162,266,2137,0.187311178247734,0.810457516339869,0.889937106918239,0.875675675675676,0.877887788778878,0.288744764221051
E02000845,Worcester Park East,Sutton,London,2357,6491,330,308,206,302,7637,2368,6926,347,304,227,333,8137,1121,282,277,197,289,2166,0.16185388391568,0.812680115273775,0.911184210526316,0.86784140969163,0.867867867867868,0.26619147105813
E02000846,Sutton North,Sutton,London,1617,4681,332,341,239,404,5997,1594,5146,365,335,257,375,6478,1099,311,300,237,344,2291,0.213563933151963,0.852054794520548,0.895522388059702,0.922178988326848,0.917333333333333,0.353658536585366
E02000847,North Cheam West,Sutton,London,1795,5735,473,537,381,603,7729,1883,6159,498,531,410,540,8138,1287,438,493,385,503,3106,0.208962493911349,0.879518072289157,0.928436911487759,0.939024390243902,0.931481481481481,0.381666257065618
E02000848,North Cheam East,Sutton,London,1726,5141,294,327,228,352,6342,1766,5538,321,322,267,367,6815,1240,284,305,249,333,2411,0.22390754785121,0.884735202492212,0.947204968944099,0.932584269662921,0.907356948228883,0.353778429933969
E02000849,Wallington North,Sutton,London,1656,5169,324,371,219,317,6400,1739,5567,360,341,245,324,6837,1102,293,312,229,295,2231,0.197952218430034,0.813888888888889,0.914956011730205,0.93469387755102,0.910493827160494,0.326312710253035
E02000850,Beddington,Sutton,London,2291,6944,472,413,317,433,8579,2246,7428,510,487,315,433,9173,1419,419,448,286,395,2967,0.191033925686591,0.82156862745098,0.919917864476386,0.907936507936508,0.912240184757506,0.323449253243214
E02000851,Sutton Central,Sutton,London,2216,6871,304,320,219,415,8129,2520,8071,372,322,246,382,9393,1447,285,262,222,335,2551,0.179283855779953,0.766129032258065,0.813664596273292,0.902439024390244,0.87696335078534,0.271585223038433
E02000852,Sutton East,Sutton,London,1727,5216,301,269,209,324,6319,1786,5740,331,301,215,378,6965,1149,283,271,195,342,2240,0.200174216027875,0.854984894259819,0.900332225913621,0.906976744186047,0.904761904761905,0.321608040201005
E02000853,Sutton West,Sutton,London,1834,5165,295,302,191,315,6268,1884,5690,316,304,195,292,6797,1094,266,273,170,270,2073,0.192267135325132,0.841772151898734,0.898026315789474,0.871794871794872,0.924657534246575,0.30498749448286
E02000854,Carshalton Village,Sutton,London,1545,4897,330,337,209,320,6093,1611,5313,377,314,237,326,6567,1035,327,283,205,303,2153,0.194805194805195,0.86737400530504,0.901273885350319,0.864978902953587,0.929447852760736,0.327851378102634
E02000855,Cheam High Street,Sutton,London,1539,4931,396,427,300,495,6549,1563,5442,448,430,316,495,7131,1103,389,401,300,451,2644,0.202682837192209,0.868303571428571,0.932558139534884,0.949367088607595,0.911111111111111,0.370775487308933
E02000856,Wallington South,Sutton,London,1954,5900,393,419,269,358,7339,2011,6423,412,418,277,383,7913,1202,334,375,248,348,2507,0.187139965748093,0.810679611650486,0.897129186602871,0.895306859205776,0.908616187989556,0.316820422090231
E02000857,Sutton South West,Sutton,London,1747,5661,311,265,242,555,7034,1826,6297,344,321,248,539,7749,1140,263,273,223,492,2391,0.181038589804669,0.76453488372093,0.850467289719626,0.899193548387097,0.912801484230056,0.308555942702284
E02000858,Roundshaw,Sutton,London,2083,5340,301,266,182,219,6308,2098,6092,305,284,207,224,7112,969,213,231,180,202,1795,0.159061063690085,0.698360655737705,0.813380281690141,0.869565217391304,0.901785714285714,0.252390326209224
E02000859,Carshalton on the Hill,Sutton,London,1804,5111,410,418,319,637,6895,1717,5456,434,462,328,637,7317,1095,373,428,294,589,2779,0.200696480938416,0.859447004608295,0.926406926406927,0.896341463414634,0.924646781789639,0.379800464671313
E02000860,Sutton South & Shanklin,Sutton,London,1716,5705,325,287,189,356,6862,1743,6067,326,325,200,362,7280,1200,256,280,173,321,2230,0.197791330146695,0.785276073619632,0.861538461538462,0.865,0.886740331491713,0.306318681318681
E02000861,Carshalton Beeches & Banstead Road,Sutton,London,1488,4649,463,518,329,401,6360,1495,5140,483,497,379,465,6964,1117,423,462,364,419,2785,0.217315175097276,0.875776397515528,0.929577464788732,0.96042216358839,0.901075268817204,0.399913842619184
E02000863,"Orchard Hill, Woodcote Green & Clockhouse",Sutton,London,1349,4178,408,383,194,340,5503,1307,4508,424,406,254,341,5933,1008,348,380,231,309,2276,0.22360248447205,0.820754716981132,0.935960591133005,0.909448818897638,0.906158357771261,0.383617057138041
E02006836,Belmont & South Cheam,Sutton,London,1638,4917,450,531,372,632,6902,1674,5591,442,553,411,611,7608,1406,399,508,394,579,3286,0.251475585762833,0.902714932126697,0.918625678119349,0.958637469586375,0.947626841243862,0.431913774973712
E02000864,Bow North & Fish Island,Tower Hamlets,London,2400,7468,305,228,131,262,8394,2253,9533,300,228,139,231,10431,972,196,184,110,190,1652,0.101961607049198,0.653333333333333,0.807017543859649,0.79136690647482,0.822510822510823,0.158374077269677
E02000865,Bethnal Green North East,Tower Hamlets,London,1824,5890,220,182,101,167,6560,1601,7326,215,159,114,158,7972,821,135,121,83,124,1284,0.112066612066612,0.627906976744186,0.761006289308176,0.728070175438597,0.784810126582278,0.161063723030607
E02000866,Bow West,Tower Hamlets,London,2086,7810,405,274,161,192,8842,1763,8900,326,245,163,204,9838,961,224,201,137,169,1692,0.107977528089888,0.687116564417178,0.820408163265306,0.840490797546012,0.82843137254902,0.171986176052043
E02000867,Bow South,Tower Hamlets,London,2153,9976,241,150,134,146,10647,1871,10945,272,147,108,148,11620,964,178,124,92,124,1482,0.0880767473732298,0.654411764705882,0.843537414965986,0.851851851851852,0.837837837837838,0.127538726333907
E02000868,Bethnal Green North West,Tower Hamlets,London,1270,5730,144,106,72,146,6198,1209,7215,136,120,88,144,7703,781,88,97,67,110,1143,0.108246708246708,0.647058823529412,0.808333333333333,0.761363636363636,0.763888888888889,0.148383746592237
E02000869,Columbia Road,Tower Hamlets,London,1191,4840,220,167,110,138,5475,1065,5355,159,150,87,143,5894,588,101,121,76,116,1002,0.109803921568627,0.635220125786164,0.806666666666667,0.873563218390805,0.811188811188811,0.170003393281303
E02000870,Bethnal Green East,Tower Hamlets,London,1454,4922,183,150,76,155,5486,1291,5977,164,133,74,134,6482,652,121,116,65,114,1068,0.109084825163125,0.737804878048781,0.87218045112782,0.878378378378378,0.850746268656716,0.164763961740204
E02000871,Bromley-by-Bow East,Tower Hamlets,London,2863,8017,257,154,126,208,8762,2730,10711,242,152,97,188,11390,991,142,112,76,141,1462,0.0925217066567081,0.586776859504132,0.736842105263158,0.783505154639175,0.75,0.128358208955224
E02000872,Brick Lane North,Tower Hamlets,London,1602,6993,167,104,71,160,7495,1502,8161,173,99,69,120,8622,715,97,74,51,93,1030,0.0876118122779071,0.560693641618497,0.747474747474748,0.739130434782609,0.775,0.119461841800046
E02000873,Mile End West,Tower Hamlets,London,2129,8390,144,141,104,195,8974,1923,11156,156,116,78,141,11647,738,109,87,58,114,1106,0.0661527429186088,0.698717948717949,0.75,0.743589743589744,0.808510638297872,0.0949600755559372
E02000874,Bethnal Green Central,Tower Hamlets,London,1770,5906,149,118,92,101,6366,1669,7462,176,85,78,114,7915,693,128,67,58,94,1040,0.0928705440900563,0.727272727272727,0.788235294117647,0.743589743589744,0.824561403508772,0.131396083385976
E02000875,Bromley-by-Bow West,Tower Hamlets,London,3384,9765,265,173,117,139,10459,2978,11428,272,172,112,142,12126,1116,161,131,81,119,1608,0.0976548827441372,0.591911764705882,0.761627906976744,0.723214285714286,0.838028169014084,0.132607619990104
E02000876,Bethnal Green South,Tower Hamlets,London,1335,6354,175,80,59,90,6758,1468,8360,157,111,65,104,8797,783,108,90,55,82,1118,0.0936602870813397,0.687898089171975,0.810810810810811,0.846153846153846,0.788461538461538,0.127088780266
E02000877,Mile End East & Burdett Estate,Tower Hamlets,London,3103,9451,247,171,136,216,10221,2898,11755,228,151,133,177,12444,1158,161,112,100,142,1673,0.0985112717992344,0.706140350877193,0.741721854304636,0.75187969924812,0.80225988700565,0.134442301510768
E02000878,Spitalfields,Tower Hamlets,London,1596,9593,273,184,144,204,10398,1633,13799,269,139,108,178,14493,1094,162,99,88,127,1570,0.0792811073266179,0.602230483271376,0.712230215827338,0.814814814814815,0.713483146067416,0.108328158421307
E02000879,Stepney Green,Tower Hamlets,London,1926,6458,232,229,147,350,7416,1810,7914,226,208,134,284,8766,1021,161,185,113,238,1718,0.129011877685115,0.712389380530973,0.889423076923077,0.843283582089552,0.838028169014084,0.195984485512206
E02000880,Whitechapel,Tower Hamlets,London,1402,4877,137,102,61,144,5321,1367,6124,146,89,56,134,6549,843,101,67,37,104,1152,0.137655127367734,0.691780821917808,0.752808988764045,0.660714285714286,0.776119402985075,0.1759047182776
E02000881,Poplar Leaside,Tower Hamlets,London,2571,6366,200,142,90,146,6944,2627,9024,235,145,92,130,9626,969,164,127,80,107,1447,0.107380319148936,0.697872340425532,0.875862068965517,0.869565217391304,0.823076923076923,0.150322044462913
E02000882,Limehouse North & Stepney East,Tower Hamlets,London,2657,7321,241,166,117,200,8045,2520,8723,230,168,113,216,9450,1253,171,134,87,166,1811,0.143643242003898,0.743478260869565,0.797619047619048,0.769911504424779,0.768518518518519,0.191640211640212
E02000883,Poplar Central,Tower Hamlets,London,2486,5735,243,176,133,198,6485,2266,7369,239,163,92,156,8019,867,155,132,77,134,1365,0.117655041389605,0.648535564853557,0.809815950920245,0.836956521739131,0.858974358974359,0.170220725776281
E02000884,Aldgate,Tower Hamlets,London,2080,11142,183,130,114,184,11753,2221,13138,201,113,99,139,13690,1249,138,83,68,91,1629,0.095067742426549,0.686567164179104,0.734513274336283,0.686868686868687,0.654676258992806,0.118991964937911
E02000885,Shadwell North,Tower Hamlets,London,1772,5162,227,190,147,213,5939,1724,6578,182,171,137,187,7255,964,124,135,107,156,1486,0.146549103070842,0.681318681318681,0.789473684210526,0.781021897810219,0.834224598930481,0.204824259131633
E02000886,Limehouse East,Tower Hamlets,London,1918,6910,250,165,80,152,7557,1761,7628,209,147,75,111,8170,785,145,113,60,92,1195,0.102910330361825,0.69377990430622,0.768707482993197,0.8,0.828828828828829,0.146266829865361
E02000887,Poplar West,Tower Hamlets,London,2901,7809,276,144,120,171,8520,2541,9518,262,182,104,187,10253,1008,156,151,87,150,1552,0.105904601807102,0.595419847328244,0.82967032967033,0.836538461538462,0.802139037433155,0.151370330634936
E02000888,Shadwell Basin & Ratcliffe,Tower Hamlets,London,2111,7672,196,115,102,151,8236,1793,8199,183,118,67,117,8684,885,129,87,50,88,1239,0.107939992682034,0.704918032786885,0.73728813559322,0.746268656716418,0.752136752136752,0.14267618608936
E02000889,St George in the East & Wapping North,Tower Hamlets,London,1719,6353,247,141,100,120,6961,1724,7992,231,125,77,114,8539,848,170,90,61,93,1262,0.106106106106106,0.735930735930736,0.72,0.792207792207792,0.81578947368421,0.147792481555217
E02000890,Tower Hill & Wapping South,Tower Hamlets,London,863,5272,278,182,110,124,5966,716,5638,211,168,81,110,6208,511,158,135,65,86,955,0.0906349769421781,0.748815165876777,0.803571428571429,0.802469135802469,0.781818181818182,0.153833762886598
E02000891,Blackwall & Leamouth,Tower Hamlets,London,3861,15799,245,183,112,173,16512,3372,18114,269,166,123,129,18801,1449,159,130,94,97,1929,0.0799933752898311,0.591078066914498,0.783132530120482,0.764227642276423,0.751937984496124,0.102600925482687
E02000893,Mudchute,Tower Hamlets,London,1790,5667,243,191,100,141,6342,1627,6882,211,180,107,162,7542,761,154,151,88,142,1296,0.11057832025574,0.729857819905213,0.838888888888889,0.822429906542056,0.876543209876543,0.171837708830549
E02000894,Millwall South,Tower Hamlets,London,2273,9046,270,181,121,120,9738,2246,10823,241,189,115,122,11490,947,162,145,87,95,1436,0.0874988450522036,0.672199170124481,0.767195767195767,0.756521739130435,0.778688524590164,0.124978241949521
E02006853,Millwall North,Tower Hamlets,London,1922,8716,139,111,107,111,9184,2033,9839,196,118,77,104,10334,836,108,88,62,84,1178,0.0849679845512755,0.551020408163265,0.745762711864407,0.805194805194805,0.807692307692308,0.113992645635765
E02006854,Canary Wharf,Tower Hamlets,London,1145,6919,144,69,70,32,7234,974,6567,105,77,32,46,6827,578,65,56,21,35,755,0.0880158367595553,0.619047619047619,0.727272727272727,0.65625,0.760869565217391,0.110590303207851
E02000895,Chingford Green West,Waltham Forest,London,1584,4714,406,467,364,645,6596,1649,5790,417,449,354,596,7606,1233,316,395,321,525,2790,0.212953367875648,0.75779376498801,0.879732739420935,0.906779661016949,0.880872483221476,0.366815671838023
E02000896,Chingford Green East,Waltham Forest,London,1616,5568,479,473,339,569,7428,1768,6509,500,469,342,579,8399,1376,411,408,300,510,3005,0.21139960055308,0.822,0.869936034115139,0.87719298245614,0.880829015544041,0.357780688177164
E02000897,Friday Hill,Waltham Forest,London,1872,5184,347,348,272,535,6686,1892,6254,358,338,262,479,7691,1284,289,286,237,426,2522,0.205308602494404,0.807262569832402,0.846153846153846,0.904580152671756,0.889352818371608,0.327915745676765
E02000898,Larkswood,Waltham Forest,London,1667,4771,413,369,223,456,6232,1641,5577,398,360,280,413,7028,1216,343,317,251,383,2510,0.218038371884526,0.861809045226131,0.880555555555556,0.896428571428572,0.927360774818402,0.357142857142857
E02000899,Chingford Mount,Waltham Forest,London,1716,5410,388,370,220,552,6940,1856,6433,412,330,258,443,7876,1286,321,295,232,388,2522,0.1999067309187,0.779126213592233,0.893939393939394,0.89922480620155,0.875846501128668,0.320213306246826
E02000900,South Chingford,Waltham Forest,London,2046,5502,338,311,216,358,6725,2109,6741,373,334,240,320,8008,1248,267,271,209,258,2253,0.185135736537606,0.715817694369973,0.811377245508982,0.870833333333333,0.80625,0.281343656343656
E02000901,Highams Park East,Waltham Forest,London,2188,6547,435,441,242,351,8016,2148,7439,433,408,274,346,8900,1698,373,369,253,319,3012,0.22825648608684,0.861431870669746,0.904411764705882,0.923357664233577,0.921965317919075,0.338426966292135
E02000902,Highams Park West,Waltham Forest,London,2487,6216,326,269,213,290,7314,2520,7379,301,280,197,261,8418,1258,229,234,162,221,2104,0.170483805393685,0.760797342192691,0.835714285714286,0.822335025380711,0.846743295019157,0.249940603468757
E02000903,Higham Hill,Waltham Forest,London,2530,6492,279,239,168,202,7380,2554,8135,326,240,169,200,9070,1037,221,176,133,154,1721,0.127473878303626,0.677914110429448,0.733333333333333,0.78698224852071,0.77,0.189746416758545
E02000904,Fulbourne Road & Walthamstow Forest,Waltham Forest,London,2066,5980,269,225,129,190,6793,2044,6770,303,219,153,194,7639,877,202,177,123,155,1534,0.129542097488922,0.666666666666667,0.808219178082192,0.803921568627451,0.798969072164949,0.200811624558188
E02000905,Lloyd Park,Waltham Forest,London,2488,7089,240,211,137,204,7881,2483,8168,293,245,137,197,9040,1137,201,191,108,153,1790,0.139201762977473,0.686006825938567,0.779591836734694,0.788321167883212,0.776649746192893,0.198008849557522
E02000906,William Morris,Waltham Forest,London,2321,6441,230,200,138,210,7219,2389,7997,252,203,136,182,8770,1030,173,144,107,145,1599,0.128798299362261,0.686507936507937,0.70935960591133,0.786764705882353,0.796703296703297,0.182326111744584
E02000907,Wood Street,Waltham Forest,London,2821,7136,271,255,146,316,8124,2579,8143,288,233,165,270,9099,968,179,184,119,212,1662,0.118875107454255,0.621527777777778,0.789699570815451,0.721212121212121,0.785185185185185,0.182657434882954
E02000908,Blackhorse Road,Waltham Forest,London,2813,9064,308,217,169,226,9984,2762,9978,314,220,139,210,10861,1122,200,170,112,155,1759,0.11244738424534,0.636942675159236,0.772727272727273,0.805755395683453,0.738095238095238,0.161955621029371
E02000909,Upper Walthamstow,Waltham Forest,London,2053,6069,269,229,150,257,6974,2237,7494,325,242,146,225,8432,1067,230,202,106,169,1774,0.142380571123566,0.707692307692308,0.834710743801653,0.726027397260274,0.751111111111111,0.2103889943074
E02000910,Walthamstow Central,Waltham Forest,London,2168,7660,294,224,159,280,8617,2333,9800,367,272,173,311,10923,1199,248,209,132,228,2016,0.12234693877551,0.67574931880109,0.768382352941177,0.763005780346821,0.733118971061093,0.184564680032958
E02000911,Walthamstow Market & South Grove,Waltham Forest,London,2505,8379,346,237,184,232,9378,2800,10789,360,242,171,217,11779,1340,225,184,126,150,2025,0.124200574659375,0.625,0.760330578512397,0.736842105263158,0.691244239631336,0.171916121911877
E02000912,Markhouse & St James Park,Waltham Forest,London,2227,6085,276,231,212,358,7162,2231,7779,326,234,187,218,8744,1003,214,189,141,147,1694,0.128936881347217,0.656441717791411,0.807692307692308,0.754010695187166,0.674311926605505,0.193732845379689
E02000913,Whipps Cross,Waltham Forest,London,1932,6217,328,260,178,255,7238,2184,8092,391,268,228,261,9240,1231,268,203,180,183,2065,0.152125556104795,0.685421994884911,0.757462686567164,0.789473684210526,0.701149425287356,0.223484848484848
E02000914,Baker's Arms,Waltham Forest,London,2591,7668,309,209,159,303,8648,2829,10176,408,270,198,356,11408,1319,236,184,127,221,2087,0.129618710691824,0.57843137254902,0.681481481481482,0.641414141414141,0.620786516853933,0.182941795231417
E02000915,Leytonstone North,Waltham Forest,London,1710,6687,344,194,145,202,7572,1717,7657,397,235,155,226,8670,1254,301,192,122,167,2036,0.163771712158809,0.758186397984887,0.817021276595745,0.787096774193548,0.738938053097345,0.234832756632065
E02000916,Lea Bridge,Waltham Forest,London,2330,6796,244,207,157,178,7582,2295,8779,333,217,157,224,9710,965,205,151,107,143,1571,0.109921403348901,0.615615615615616,0.695852534562212,0.681528662420382,0.638392857142857,0.161791967044284
E02000917,Leyton North,Waltham Forest,London,2404,7249,228,166,130,171,7944,2221,8724,259,196,131,195,9505,1161,174,143,94,131,1703,0.133081155433288,0.671814671814672,0.729591836734694,0.717557251908397,0.671794871794872,0.179168858495529
E02000918,Leytonstone East,Waltham Forest,London,2006,6941,292,241,133,196,7803,1974,8235,343,258,159,171,9166,1198,232,192,123,134,1879,0.145476624165149,0.676384839650146,0.744186046511628,0.773584905660377,0.783625730994152,0.204996727034693
E02000919,Leyton East,Waltham Forest,London,1845,7241,299,202,171,249,8162,1953,9003,312,225,147,246,9933,1104,208,172,112,181,1777,0.122625791402866,0.666666666666667,0.764444444444445,0.761904761904762,0.735772357723577,0.178898620759086
E02000920,Leyton South,Waltham Forest,London,2109,7382,280,240,124,194,8220,2193,9671,342,240,166,236,10655,1188,220,184,122,172,1886,0.122841484851618,0.64327485380117,0.766666666666667,0.734939759036145,0.728813559322034,0.177006100422337
E02000921,Leytonstone South West,Waltham Forest,London,2423,7917,343,227,186,186,8859,2313,10201,357,323,195,213,11289,1031,205,231,140,136,1743,0.101068522693854,0.574229691876751,0.715170278637771,0.717948717948718,0.63849765258216,0.154398086633006
E02000922,Leytonstone South East,Waltham Forest,London,2264,7816,306,232,159,211,8724,2328,9637,362,253,176,253,10681,1002,234,178,130,183,1727,0.103974265850368,0.646408839779006,0.703557312252965,0.738636363636364,0.723320158102767,0.161688980432544
E02000923,Battersea Park,Wandsworth,London,1167,5794,331,301,236,368,7030,1160,6497,307,317,258,431,7810,671,222,239,216,351,1699,0.103278436201324,0.723127035830619,0.753943217665615,0.837209302325582,0.814385150812065,0.217541613316261
E02000924,Nine Elms & Patmore,Wandsworth,London,2529,11226,354,232,177,252,12241,2843,15613,432,299,203,287,16834,1551,254,202,152,204,2363,0.0993402933452892,0.587962962962963,0.675585284280936,0.748768472906404,0.710801393728223,0.140370678388975
E02000925,Battersea Latchmere,Wandsworth,London,1574,5753,211,207,119,204,6494,1544,7233,262,226,139,200,8060,847,183,167,109,154,1460,0.11710217060694,0.698473282442748,0.738938053097345,0.784172661870504,0.77,0.181141439205955
E02000926,St Mary's & Cotton Row,Wandsworth,London,1640,8634,310,325,198,242,9709,1739,11065,343,348,204,247,12207,1238,252,270,163,200,2123,0.1118843199277,0.73469387755102,0.775862068965517,0.799019607843137,0.809716599190283,0.173916605226509
E02000927,Lavender Hill East,Wandsworth,London,1017,5506,233,217,152,194,6302,1081,6718,267,220,165,196,7566,778,198,193,136,158,1463,0.1158082762727,0.741573033707865,0.877272727272727,0.824242424242424,0.806122448979592,0.193365054189796
E02000928,Putney Embankment & Lower Common,Wandsworth,London,1633,5847,347,321,200,240,6955,1680,7896,372,345,237,260,9110,1218,318,311,210,220,2277,0.154255319148936,0.854838709677419,0.901449275362319,0.886075949367089,0.846153846153846,0.249945115257958
E02000929,York Gardens,Wandsworth,London,1576,5178,229,167,146,212,5932,1588,7348,248,209,152,216,8173,948,164,155,117,151,1535,0.129014697876973,0.661290322580645,0.741626794258373,0.769736842105263,0.699074074074074,0.187813532362658
E02000930,Lavender Hill West & Little India,Wandsworth,London,1379,8959,175,163,112,187,9596,1411,11403,217,208,130,181,12139,1011,145,165,106,151,1578,0.0886608787161273,0.668202764976959,0.793269230769231,0.815384615384615,0.834254143646409,0.129994233462394
E02000931,Clapham Common West,Wandsworth,London,1867,7219,158,180,98,171,7826,1943,8350,197,185,126,160,9018,789,146,148,106,120,1309,0.0944910179640719,0.741116751269036,0.8,0.841269841269841,0.75,0.1451541361721
E02000932,Putney Town & Wandsworth Park,Wandsworth,London,1809,9049,350,261,174,184,10018,2105,13134,397,286,215,235,14267,1517,299,219,162,196,2393,0.115501751180143,0.753148614609572,0.765734265734266,0.753488372093023,0.834042553191489,0.167729725940983
E02000933,Putney West,Wandsworth,London,1483,6214,402,324,234,349,7523,1603,8963,398,405,255,368,10389,1398,321,355,210,313,2597,0.155974562088586,0.806532663316583,0.876543209876543,0.823529411764706,0.85054347826087,0.249975936086245
E02000934,Clapham Junction & East Hill,Wandsworth,London,1133,8144,224,211,122,185,8886,1189,9399,257,233,142,203,10234,1043,187,192,117,161,1700,0.11096925204809,0.727626459143969,0.824034334763949,0.823943661971831,0.793103448275862,0.166112956810631
E02000935,Roehampton North West,Wandsworth,London,1690,4723,168,186,131,224,5432,1678,6568,192,188,158,239,7345,843,133,138,125,200,1439,0.128349573690621,0.692708333333333,0.734042553191489,0.791139240506329,0.836820083682008,0.195915588835943
E02000936,East Putney,Wandsworth,London,1233,6885,292,314,225,319,8035,1450,10748,310,329,229,342,11958,1340,210,232,189,284,2255,0.124674358020097,0.67741935483871,0.70516717325228,0.825327510917031,0.830409356725146,0.188576685064392
E02000937,Wandsworth Common,Wandsworth,London,1987,5934,187,163,102,175,6561,1986,7027,246,212,113,155,7753,943,203,175,97,112,1530,0.134196669987192,0.82520325203252,0.825471698113208,0.858407079646018,0.72258064516129,0.19734296401393
E02000938,Roehampton North East,Wandsworth,London,2303,7556,335,332,286,480,8989,2408,9795,401,411,280,495,11382,1476,274,325,220,414,2709,0.150689127105666,0.683291770573566,0.790754257907543,0.785714285714286,0.836363636363636,0.238007380073801
E02000939,Nightingale Lane,Wandsworth,London,2035,5403,262,231,154,289,6339,2031,6374,265,241,174,305,7359,816,226,208,152,266,1668,0.128020081581425,0.852830188679245,0.863070539419087,0.873563218390805,0.872131147540984,0.226661231145536
E02000940,Wandsworth South,Wandsworth,London,1541,6344,220,165,137,176,7042,1697,8949,256,197,153,180,9735,1239,179,156,115,138,1827,0.138451223600402,0.69921875,0.791878172588833,0.751633986928105,0.766666666666667,0.187673343605547
E02000941,Earlsfield North,Wandsworth,London,2218,7307,264,259,164,233,8227,2146,11031,293,298,179,231,12032,1413,234,259,154,194,2254,0.128093554528148,0.798634812286689,0.869127516778524,0.860335195530726,0.83982683982684,0.187333776595745
E02000942,Southfields North,Wandsworth,London,1983,6519,336,333,212,236,7636,2016,8760,375,346,242,287,10010,1264,314,312,223,254,2367,0.144292237442922,0.837333333333333,0.901734104046243,0.921487603305785,0.885017421602787,0.236463536463536
E02000943,Balham,Wandsworth,London,1444,6726,240,169,144,178,7457,1477,8538,254,202,153,224,9371,1167,188,168,129,174,1826,0.136683063949403,0.740157480314961,0.831683168316832,0.843137254901961,0.776785714285714,0.19485647209476
E02000944,West Hill North,Wandsworth,London,1529,5080,204,177,115,212,5788,1715,7184,225,206,131,213,7959,1249,160,165,102,186,1862,0.173858574610245,0.711111111111111,0.800970873786408,0.778625954198473,0.873239436619718,0.233948988566403
E02000945,Roehampton South & Putney Vale,Wandsworth,London,1606,5922,267,213,117,210,6729,1701,7283,272,237,158,199,8149,1137,202,175,122,163,1799,0.156116984759028,0.742647058823529,0.738396624472574,0.772151898734177,0.819095477386935,0.220763283838508
E02000946,Earlsfield South,Wandsworth,London,1397,6485,246,181,100,165,7177,1514,7079,228,216,109,179,7811,989,168,170,78,144,1549,0.139708998446108,0.736842105263158,0.787037037037037,0.715596330275229,0.804469273743017,0.198310075534503
E02000947,Merton Road,Wandsworth,London,2084,6191,241,193,183,195,7003,2082,7969,247,245,171,204,8836,1239,202,203,146,175,1965,0.155477475216464,0.817813765182186,0.828571428571429,0.853801169590643,0.857843137254902,0.222385694884563
E02000948,Tooting Bec Common,Wandsworth,London,1470,7610,197,223,144,247,8421,1536,9937,249,242,175,280,10883,1378,185,190,128,223,2104,0.138673643956929,0.742971887550201,0.785123966942149,0.731428571428571,0.796428571428571,0.193329045300009
E02000949,Springfield,Wandsworth,London,1771,7129,298,290,167,247,8131,1708,9057,329,315,209,300,10210,1578,270,272,176,255,2551,0.174229877442862,0.820668693009118,0.863492063492064,0.842105263157895,0.85,0.249853085210578
E02000950,West Hill South,Wandsworth,London,1511,5192,261,239,161,208,6061,1575,7000,318,277,192,249,8036,1113,225,218,150,210,1916,0.159,0.707547169811321,0.787003610108303,0.78125,0.843373493975904,0.238427078148333
E02000951,Tooting Bec West,Wandsworth,London,967,4784,180,163,80,222,5429,1007,6243,226,177,110,174,6930,990,167,142,87,129,1515,0.15857760691975,0.738938053097345,0.80225988700565,0.790909090909091,0.741379310344828,0.218614718614719
E02000952,Tooting Bec East,Wandsworth,London,1067,4404,183,133,131,172,5023,970,5980,202,190,121,158,6651,1020,148,154,98,120,1540,0.17056856187291,0.732673267326733,0.810526315789474,0.809917355371901,0.759493670886076,0.231544128702451
E02000953,Summerstown,Wandsworth,London,1446,5895,144,118,89,148,6394,1489,6879,169,128,122,132,7430,1376,112,104,98,116,1806,0.200029073993313,0.662721893491124,0.8125,0.80327868852459,0.878787878787879,0.24306864064603
E02000954,Upper Tooting,Wandsworth,London,1138,4345,206,191,132,188,5062,1099,5844,221,202,141,233,6641,978,172,169,109,192,1620,0.16735112936345,0.778280542986425,0.836633663366337,0.773049645390071,0.824034334763949,0.243939165788285
E02000955,Tooting North,Wandsworth,London,1249,4517,204,179,141,215,5256,1285,6415,232,223,131,232,7233,1073,170,171,111,187,1712,0.167264224473889,0.732758620689655,0.766816143497758,0.847328244274809,0.806034482758621,0.236692935158302
E02000956,Tooting West,Wandsworth,London,1379,6296,173,161,100,184,6914,1353,7811,211,188,103,176,8489,1267,131,134,76,122,1730,0.162207143771604,0.62085308056872,0.712765957446809,0.737864077669903,0.693181818181818,0.203793144068795
E02000957,Tooting East,Wandsworth,London,2005,8192,311,207,184,266,9160,2100,10737,338,276,174,321,11846,1725,250,216,132,246,2569,0.160659402067617,0.739644970414201,0.782608695652174,0.758620689655172,0.766355140186916,0.216866452811075
E02000958,Furzedown West,Wandsworth,London,1798,5777,311,271,183,325,6867,1755,6888,372,298,194,342,8094,1475,284,234,151,260,2404,0.214140534262485,0.763440860215054,0.785234899328859,0.778350515463918,0.760233918128655,0.297010130961206
E02000959,Furzedown East,Wandsworth,London,1845,5809,204,167,150,199,6529,1741,6667,223,194,124,203,7411,1212,152,148,96,146,1754,0.181790910454477,0.681614349775785,0.762886597938144,0.774193548387097,0.719211822660099,0.236675212521927
E02000960,St John's Wood North,Westminster,London,1794,5511,325,328,242,516,6922,1424,6466,318,298,226,402,7710,977,202,212,175,336,1902,0.1510980513455,0.635220125786164,0.711409395973154,0.774336283185841,0.835820895522388,0.246692607003891
E02000961,Abbey Road,Westminster,London,2682,7420,399,313,248,412,8792,2057,9035,347,316,249,332,10279,1271,216,222,181,272,2162,0.140675152185944,0.622478386167147,0.70253164556962,0.726907630522088,0.819277108433735,0.210331744333106
E02000962,St John's Wood South,Westminster,London,1991,6945,451,452,309,565,8722,1542,8276,410,421,312,458,9877,1050,243,294,250,358,2195,0.126872885451909,0.592682926829268,0.69833729216152,0.801282051282051,0.781659388646288,0.222233471701934
E02000963,Queen's Park Gardens,Westminster,London,2599,7155,432,328,243,353,8511,1972,8735,451,327,264,309,10086,1374,289,237,206,216,2322,0.157298225529479,0.64079822616408,0.724770642201835,0.78030303030303,0.699029126213592,0.23022010707912
E02000964,Maida Hill,Westminster,London,2797,9439,489,328,256,351,10863,2159,11291,504,369,286,336,12786,1507,292,239,193,222,2453,0.13346913470906,0.579365079365079,0.64769647696477,0.674825174825175,0.660714285714286,0.191850461442202
E02000965,Maida Vale,Westminster,London,1805,6824,313,172,128,181,7618,1429,8384,292,224,164,213,9277,946,186,153,121,157,1563,0.112833969465649,0.636986301369863,0.683035714285714,0.737804878048781,0.737089201877934,0.168481190039884
E02000966,Little Venice,Westminster,London,2220,7750,431,373,220,369,9143,1769,8623,446,350,225,289,9933,1155,305,232,173,221,2086,0.133944102980401,0.683856502242152,0.662857142857143,0.768888888888889,0.764705882352941,0.21000704721635
E02000967,Regent's Park,Westminster,London,1533,7797,365,261,216,334,8973,968,7476,283,220,198,283,8460,673,158,146,142,211,1330,0.0900214018191546,0.558303886925795,0.663636363636364,0.717171717171717,0.745583038869258,0.157210401891253
E02000968,Church Street,Westminster,London,3481,10336,685,478,348,672,12519,2626,12801,624,487,334,535,14781,1846,399,334,251,403,3233,0.144207483790329,0.639423076923077,0.685831622176591,0.751497005988024,0.753271028037383,0.218726743792707
E02000969,Westbourne,Westminster,London,2548,7195,332,236,213,410,8386,2063,9193,344,261,178,331,10307,1349,211,177,133,248,2118,0.146742086370064,0.613372093023256,0.67816091954023,0.747191011235955,0.749244712990937,0.205491413602406
E02000970,Marylebone & Park Lane,Westminster,London,1545,8314,478,394,250,360,9796,1075,8236,383,338,224,304,9485,950,220,216,168,215,1769,0.11534725594949,0.574412532637076,0.63905325443787,0.75,0.707236842105263,0.186505007907222
E02000971,Bryanston & Dorset Square,Westminster,London,1358,7431,334,325,208,336,8634,981,8464,302,274,229,256,9525,847,181,170,162,176,1536,0.100070888468809,0.599337748344371,0.62043795620438,0.707423580786026,0.6875,0.161259842519685
E02000972,Fitzrovia West & Soho,Westminster,London,1185,9068,295,297,183,279,10122,807,8972,299,244,168,201,9884,1201,190,162,124,154,1831,0.133860900579581,0.635451505016722,0.663934426229508,0.738095238095238,0.766169154228856,0.185248887090247
E02000973,Westbourne Grove,Westminster,London,1936,8356,398,353,284,295,9686,1425,10170,413,364,241,274,11462,957,259,265,183,216,1880,0.0941002949852507,0.627118644067797,0.728021978021978,0.759336099585062,0.788321167883212,0.164020240795673
E02000974,Paddington & St George's Fields,Westminster,London,1637,7522,434,362,220,364,8902,1349,8902,373,345,243,300,10163,1001,202,231,160,205,1799,0.112446641204224,0.541554959785523,0.669565217391304,0.65843621399177,0.683333333333333,0.177014661025288
E02000975,Bayswater East,Westminster,London,1386,8355,252,308,163,215,9293,1046,9200,245,268,162,168,10043,681,127,154,100,108,1170,0.0740217391304348,0.518367346938776,0.574626865671642,0.617283950617284,0.642857142857143,0.11649905406751
E02000976,Queensway,Westminster,London,1620,8745,328,344,228,264,9909,1369,11097,351,328,242,291,12309,811,179,192,161,185,1528,0.0730828151752726,0.50997150997151,0.585365853658537,0.665289256198347,0.63573883161512,0.124136810463888
E02000977,"Strand, St James & Mayfair",Westminster,London,739,5534,387,336,219,313,6789,531,8290,326,251,167,225,9259,799,197,166,108,156,1426,0.0963811821471653,0.604294478527607,0.661354581673307,0.646706586826347,0.693333333333333,0.154012312344746
E02000978,"Knightsbridge, Belgravia & Hyde Park",Westminster,London,1533,8667,432,378,270,466,10213,983,8330,368,353,255,362,9668,694,191,203,151,261,1500,0.0833133253301321,0.519021739130435,0.575070821529745,0.592156862745098,0.720994475138122,0.155151013653289
E02000979,Central Westminster,Westminster,London,1395,7743,480,398,246,365,9232,1208,8635,414,347,243,301,9940,1108,267,258,170,232,2035,0.128314997104806,0.644927536231884,0.743515850144092,0.699588477366255,0.770764119601329,0.204728370221328
E02000980,Millbank,Westminster,London,1689,7608,477,403,267,454,9209,1263,8125,399,338,262,323,9447,1222,280,254,200,244,2200,0.1504,0.701754385964912,0.751479289940828,0.763358778625954,0.755417956656347,0.232878162379591
E02000981,Pimlico North,Westminster,London,1336,7882,370,344,209,285,9090,979,8385,360,296,195,221,9457,1160,230,204,143,151,1888,0.138342277877162,0.638888888888889,0.689189189189189,0.733333333333333,0.683257918552036,0.199640477952839
E02000982,Victoria,Westminster,London,1760,6092,447,366,217,364,7486,1289,7139,364,328,230,283,8344,1081,253,228,182,216,1960,0.151421767754588,0.695054945054945,0.695121951219512,0.791304347826087,0.763250883392226,0.23489932885906
E02000983,Pimlico South,Westminster,London,1511,6920,397,360,269,481,8427,1200,7170,320,297,227,342,8356,1176,209,218,175,287,2065,0.164016736401674,0.653125,0.734006734006734,0.770925110132159,0.839181286549708,0.247127812350407
E02002483,Clavering,Hartlepool,North East,2095,6378,479,500,325,484,8166,2151,6714,511,522,321,518,8586,1558,330,487,302,492,3169,0.232052427762884,0.645792563600783,0.932950191570881,0.940809968847352,0.94980694980695,0.369089215001165
E02002484,Headland & West View,Hartlepool,North East,2152,6431,552,533,278,503,8297,2187,6741,562,548,303,507,8661,1588,282,489,284,465,3108,0.235573357068684,0.501779359430605,0.892335766423358,0.937293729372937,0.917159763313609,0.358850017319016
E02002485,Jesmond,Hartlepool,North East,1806,4959,375,433,264,348,6379,1768,5384,396,417,285,314,6796,1289,218,383,267,288,2445,0.239413075780089,0.550505050505051,0.918465227817746,0.936842105263158,0.917197452229299,0.359770453207769
E02002487,Harbour & Victoria,Hartlepool,North East,886,3694,235,172,123,167,4391,795,3554,252,211,129,152,4298,671,134,182,120,141,1248,0.188801350590884,0.531746031746032,0.862559241706161,0.930232558139535,0.927631578947368,0.290367612843183
E02002488,Wooler Road,Hartlepool,North East,993,3580,386,322,229,338,4855,1012,3899,398,381,271,413,5362,948,262,356,265,395,2226,0.243139266478584,0.658291457286432,0.934383202099738,0.977859778597786,0.956416464891041,0.415143603133159
E02002489,Old Town & Grange,Hartlepool,North East,1518,4847,412,329,194,430,6212,1374,5122,401,355,198,320,6396,989,195,315,187,281,1967,0.193088637251074,0.486284289276808,0.887323943661972,0.944444444444444,0.878125,0.307535959974984
E02002490,Foggy Furze,Hartlepool,North East,1206,4058,330,264,150,206,5008,1192,4139,345,281,166,195,5126,828,196,256,153,181,1614,0.200048320850447,0.568115942028986,0.911032028469751,0.921686746987952,0.928205128205128,0.314865392118611
E02002491,Rift House & Summerhill,Hartlepool,North East,1369,3763,332,318,212,460,5085,1309,4040,343,310,213,445,5351,970,194,284,199,423,2070,0.24009900990099,0.565597667638484,0.916129032258065,0.934272300469484,0.950561797752809,0.386843580639133
E02002492,Rossmere & Mill,Hartlepool,North East,1328,4081,408,377,231,462,5559,1285,4294,391,415,233,349,5682,1063,226,389,226,337,2241,0.247554727526782,0.578005115089514,0.937349397590361,0.969957081545064,0.965616045845272,0.394403379091869
E02002493,Seaton Carew,Hartlepool,North East,1121,3921,485,438,285,452,5581,1096,4145,522,486,333,450,5936,983,336,460,323,442,2544,0.237153196622437,0.64367816091954,0.946502057613169,0.96996996996997,0.982222222222222,0.428571428571429
E02002494,Owton Manor,Hartlepool,North East,1838,4688,350,293,207,374,5912,1849,5127,367,342,222,320,6378,1170,192,313,213,302,2190,0.228203627852545,0.523160762942779,0.915204678362573,0.959459459459459,0.94375,0.343367826904986
E02006909,"The Fens, Elwick & Hart",Hartlepool,North East,1683,7070,823,936,607,787,10223,1813,7722,915,943,639,860,11079,1895,642,896,621,833,4887,0.245402745402745,0.701639344262295,0.950159066808059,0.971830985915493,0.968604651162791,0.44110479285134
E02002496,Middlesbrough Central,Middlesbrough,North East,2479,9916,283,211,148,215,10773,2763,12519,379,268,168,252,13586,1169,208,208,131,204,1920,0.0933780653406822,0.548812664907652,0.776119402985075,0.779761904761905,0.80952380952381,0.141321949065214
E02002497,North Ormesby & Brambles,Middlesbrough,North East,1409,3771,240,221,130,173,4535,1581,4384,278,217,127,174,5180,734,194,192,115,151,1386,0.16742700729927,0.697841726618705,0.884792626728111,0.905511811023622,0.867816091954023,0.267567567567568
E02002498,Ayresome,Middlesbrough,North East,2157,6766,236,203,140,162,7507,2832,9004,330,207,146,220,9907,804,175,162,124,174,1439,0.0892936472678809,0.53030303030303,0.782608695652174,0.849315068493151,0.790909090909091,0.145250832744524
E02002499,Berwick Hills,Middlesbrough,North East,1980,4454,291,240,142,299,5426,2206,5262,364,255,152,267,6300,1146,279,225,140,237,2027,0.217787913340935,0.766483516483517,0.882352941176471,0.921052631578947,0.887640449438202,0.321746031746032
E02002500,Linthorpe East & Albert Park,Middlesbrough,North East,1276,3830,264,217,129,203,4643,1354,4265,322,255,153,238,5233,836,231,225,138,217,1647,0.196014067995311,0.717391304347826,0.882352941176471,0.901960784313725,0.911764705882353,0.314733422510988
E02002501,Park Vale,Middlesbrough,North East,1286,3508,268,179,149,172,4276,1576,4199,309,214,159,188,5069,988,226,185,150,162,1711,0.235294117647059,0.731391585760518,0.864485981308411,0.943396226415094,0.861702127659575,0.337541921483527
E02002502,Thorntree,Middlesbrough,North East,2076,5625,479,362,293,386,7145,2220,6384,561,442,266,433,8086,1502,418,382,248,396,2946,0.235275689223058,0.745098039215686,0.864253393665159,0.932330827067669,0.914549653579677,0.364333415780361
E02002503,Newport & Maze Park,Middlesbrough,North East,1698,4181,275,202,148,229,5035,1791,4690,302,232,142,207,5573,966,221,212,132,191,1722,0.205970149253731,0.731788079470199,0.913793103448276,0.929577464788732,0.922705314009662,0.308989772115557
E02002504,Linthorpe West,Middlesbrough,North East,2143,6237,424,370,257,357,7645,2165,6854,472,432,275,398,8431,1359,367,393,258,368,2745,0.198278377589729,0.777542372881356,0.909722222222222,0.938181818181818,0.924623115577889,0.32558415371842
E02002505,Park End,Middlesbrough,North East,1631,3701,259,199,94,220,4473,1770,4423,300,225,111,195,5254,996,227,205,106,176,1710,0.225186524983043,0.756666666666667,0.911111111111111,0.954954954954955,0.902564102564103,0.325466311381804
E02002506,Beechwood & James Cook,Middlesbrough,North East,1398,3431,209,232,153,263,4288,1301,3828,226,227,156,248,4685,1076,142,206,137,230,1791,0.281086729362591,0.628318584070796,0.907488986784141,0.878205128205128,0.92741935483871,0.382283884738527
E02002507,Acklam,Middlesbrough,North East,1064,3717,283,319,282,327,4928,1153,4010,333,316,257,354,5270,950,270,293,250,341,2104,0.236907730673317,0.810810810810811,0.927215189873418,0.972762645914397,0.963276836158192,0.399240986717268
E02002508,Kader,Middlesbrough,North East,919,2880,297,294,253,424,4148,909,3311,298,297,281,416,4603,780,244,284,272,392,1972,0.235578375113259,0.818791946308725,0.956228956228956,0.96797153024911,0.942307692307692,0.428416250271562
E02002509,Easterside,Middlesbrough,North East,1213,3140,336,224,154,328,4182,1112,3405,324,286,164,297,4476,904,248,256,159,274,1841,0.265491923641703,0.765432098765432,0.895104895104895,0.969512195121951,0.922558922558922,0.411304736371761
E02002510,Trimdon,Middlesbrough,North East,920,3359,435,510,310,394,5008,1205,4068,452,506,375,446,5847,1007,387,493,364,432,2683,0.247541789577188,0.856194690265487,0.974308300395257,0.970666666666667,0.968609865470852,0.458867795450659
E02002512,Marton West,Middlesbrough,North East,846,3096,325,357,291,383,4452,832,3196,360,379,264,396,4595,788,311,358,256,385,2098,0.246558197747184,0.863888888888889,0.944591029023747,0.96969696969697,0.972222222222222,0.45658324265506
E02002513,Stainton & Hemlington,Middlesbrough,North East,1883,5394,635,514,320,515,7378,2060,6242,653,591,358,517,8361,1387,517,552,337,487,3280,0.222204421659724,0.791730474732006,0.934010152284264,0.941340782122905,0.941972920696325,0.392297572060758
E02002514,Coulby Newham,Middlesbrough,North East,1518,5276,478,460,285,511,7010,1468,5707,549,521,297,464,7538,1384,434,467,275,438,2998,0.242509199229017,0.790528233151184,0.896353166986564,0.925925925925926,0.943965517241379,0.397718227646591
E02006811,Nunthorpe & Marton East,Middlesbrough,North East,1829,5875,637,693,501,697,8403,2065,6774,700,730,561,713,9478,1686,558,685,537,668,4134,0.2488928255093,0.797142857142857,0.938356164383562,0.957219251336898,0.936886395511921,0.436167967925723
E02002515,Redcar Town & Coatham,Redcar and Cleveland,North East,1183,4474,308,283,247,408,5720,1021,4524,343,318,214,425,5824,762,166,292,197,380,1797,0.168435013262599,0.48396501457726,0.918238993710692,0.920560747663551,0.894117647058824,0.308550824175824
E02002516,Redcar Lakes North,Redcar and Cleveland,North East,1232,3515,291,305,198,312,4621,1237,3781,305,300,220,312,4918,727,162,277,208,291,1665,0.192277175350436,0.531147540983607,0.923333333333333,0.945454545454546,0.932692307692308,0.338552257015047
E02002517,Dormanstown,Redcar and Cleveland,North East,1062,3218,271,293,192,308,4282,1045,3448,273,281,208,297,4507,574,145,270,194,279,1462,0.166473317865429,0.531135531135531,0.96085409252669,0.932692307692308,0.939393939393939,0.324384291102729
E02002518,Redcar East,Redcar and Cleveland,North East,1852,6653,653,656,409,614,8985,1768,6868,683,671,485,633,9340,1328,387,640,459,608,3422,0.19336051252184,0.566617862371889,0.953800298062593,0.94639175257732,0.960505529225908,0.366381156316916
E02002519,Redcar Lakes South,Redcar and Cleveland,North East,1479,4199,464,474,336,503,5976,1517,4508,485,472,383,503,6351,886,242,441,360,487,2416,0.196539485359361,0.498969072164949,0.934322033898305,0.939947780678851,0.968190854870775,0.380412533459298
E02002520,Marske,Redcar and Cleveland,North East,2048,7381,852,1003,741,921,10898,2026,7808,833,991,814,986,11432,1574,470,948,787,958,4737,0.201588114754098,0.564225690276111,0.956609485368315,0.966830466830467,0.971602434077079,0.414363191042687
E02002521,Saltburn,Redcar and Cleveland,North East,798,3440,470,447,396,561,5314,783,3635,438,483,380,587,5523,683,276,451,358,565,2333,0.187895460797799,0.63013698630137,0.933747412008282,0.942105263157895,0.96252129471891,0.422415353974289
E02002523,Grangetown,Redcar and Cleveland,North East,1874,4029,258,185,138,139,4749,1840,4301,287,206,122,149,5065,699,219,185,114,141,1358,0.162520344106022,0.763066202090592,0.898058252427185,0.934426229508197,0.946308724832215,0.268114511352419
E02002524,Brotton,Redcar and Cleveland,North East,1028,3251,314,418,231,264,4478,948,3319,340,401,269,301,4630,812,148,384,264,286,1894,0.244652003615547,0.435294117647059,0.957605985037407,0.981412639405205,0.950166112956811,0.409071274298056
E02002525,Eston,Redcar and Cleveland,North East,1323,5016,483,459,395,536,6889,1241,5103,530,480,405,526,7044,1014,432,451,386,500,2783,0.198706643151088,0.815094339622642,0.939583333333333,0.953086419753086,0.950570342205323,0.395088018171494
E02002526,Skelton,Redcar and Cleveland,North East,1467,4718,500,473,270,307,6268,1399,4837,507,502,299,327,6472,1134,256,484,291,318,2483,0.234442836468886,0.504930966469428,0.964143426294821,0.973244147157191,0.972477064220184,0.383652657601978
E02002527,Loftus & Skinningrove,Redcar and Cleveland,North East,1033,3065,278,308,176,218,4045,1075,3129,298,285,192,218,4122,692,133,259,182,203,1469,0.221156919143496,0.446308724832215,0.908771929824561,0.947916666666667,0.931192660550459,0.356380397865114
E02002529,Bankfields,Redcar and Cleveland,North East,1015,3573,383,388,229,291,4864,1007,3753,327,404,274,290,5048,693,266,387,264,275,1885,0.184652278177458,0.813455657492355,0.957920792079208,0.963503649635036,0.948275862068965,0.373415213946117
E02002530,"Boosbeck, Lingdale & Easington",Redcar and Cleveland,North East,1022,3698,423,474,342,373,5310,955,3709,418,481,325,365,5298,817,223,448,314,347,2149,0.220275006740361,0.533492822966507,0.931392931392931,0.966153846153846,0.950684931506849,0.40562476406191
E02002532,Guisborough North,Redcar and Cleveland,North East,1110,4056,397,392,263,437,5545,1176,4382,396,416,282,446,5922,1058,176,382,269,412,2297,0.241442263806481,0.444444444444444,0.918269230769231,0.953900709219858,0.923766816143498,0.387875717662952
E02002533,Guisborough West,Redcar and Cleveland,North East,1132,3464,468,457,285,433,5107,1189,3898,506,506,368,446,5724,919,257,490,359,418,2443,0.235761929194459,0.507905138339921,0.968379446640316,0.97554347826087,0.937219730941704,0.426799440950384
E02002534,Guisborough Outer & Upleatham,Redcar and Cleveland,North East,758,3039,437,578,389,492,4935,693,3032,432,562,415,517,4958,723,211,549,409,499,2391,0.238456464379947,0.488425925925926,0.976868327402135,0.985542168674699,0.965183752417795,0.482250907624042
E02006812,Ormesby,Redcar and Cleveland,North East,1372,4364,474,466,358,514,6176,1337,4746,497,464,350,540,6597,1058,400,438,336,522,2754,0.222924568057311,0.804828973843059,0.943965517241379,0.96,0.966666666666667,0.417462482946794
E02006910,South Bank & Teesville,Redcar and Cleveland,North East,1988,6187,549,512,417,547,8212,2167,7027,647,548,385,556,9163,1255,524,507,371,525,3182,0.17859684075708,0.809891808346213,0.925182481751825,0.963636363636364,0.944244604316547,0.347266179198952
E02002535,Billingham North & Wolviston,Stockton-on-Tees,North East,1465,5918,597,515,355,486,7871,1430,6157,650,606,378,463,8254,1413,570,588,360,448,3379,0.229494883872016,0.876923076923077,0.97029702970297,0.952380952380952,0.967602591792657,0.409377271625878
E02002536,Billingham Central,Stockton-on-Tees,North East,1918,5811,507,474,417,644,7853,1737,5888,534,488,382,574,7866,1351,441,466,368,551,3177,0.22944972826087,0.825842696629213,0.954918032786885,0.963350785340314,0.95993031358885,0.403890160183066
E02002537,Billingham East & Haverton Hill,Stockton-on-Tees,North East,2094,5210,361,287,258,431,6547,1959,5588,377,325,234,408,6932,1183,299,309,222,397,2410,0.211703650680029,0.793103448275862,0.950769230769231,0.948717948717949,0.973039215686275,0.347663012117715
E02002538,Billingham South,Stockton-on-Tees,North East,1224,3434,322,328,195,277,4556,1109,3611,321,331,228,264,4755,839,271,309,217,253,1889,0.232345610634173,0.844236760124611,0.933534743202417,0.951754385964912,0.958333333333333,0.39726603575184
E02002539,"Billingham West, Stillington & Longnewton",Stockton-on-Tees,North East,1617,5599,636,647,423,492,7797,1766,6349,667,685,505,554,8760,1333,588,661,495,529,3606,0.209954323515514,0.881559220389805,0.964963503649635,0.98019801980198,0.954873646209386,0.411643835616438
E02002540,Norton North,Stockton-on-Tees,North East,924,3296,474,512,333,496,5111,903,3440,486,561,362,470,5319,824,381,550,354,456,2565,0.23953488372093,0.783950617283951,0.980392156862745,0.977900552486188,0.970212765957447,0.482233502538071
E02002541,Norton High Street,Stockton-on-Tees,North East,1047,3823,361,352,221,342,5099,980,3817,372,362,233,373,5157,878,285,337,219,356,2075,0.230023578726749,0.766129032258065,0.930939226519337,0.939914163090129,0.954423592493298,0.402365716501842
E02002542,Roseworth,Stockton-on-Tees,North East,2021,4941,396,337,224,323,6221,1918,5328,393,392,217,304,6634,1273,248,356,204,292,2373,0.238926426426426,0.631043256997455,0.908163265306122,0.940092165898618,0.960526315789474,0.35770274344287
E02002543,Hardwick & Salters Lane,Stockton-on-Tees,North East,2383,5481,346,295,203,357,6682,2325,5994,396,343,179,333,7245,1490,242,319,173,310,2534,0.248581915248582,0.611111111111111,0.93002915451895,0.966480446927374,0.930930930930931,0.34975845410628
E02002544,Norton South,Stockton-on-Tees,North East,1557,5881,381,327,212,336,7137,1536,6354,418,353,217,350,7692,1158,306,324,207,331,2326,0.182247403210576,0.732057416267943,0.917847025495751,0.953917050691244,0.945714285714286,0.302392095683827
E02002545,Rimswell & Bishopsgarth,Stockton-on-Tees,North East,761,3000,401,400,260,369,4430,747,3087,369,415,265,339,4475,744,270,396,256,326,1992,0.241010689990282,0.731707317073171,0.954216867469879,0.966037735849057,0.96165191740413,0.445139664804469
E02002546,Eastbourne & Newham Grange,Stockton-on-Tees,North East,1694,4735,323,287,167,297,5809,1630,5099,359,278,186,265,6187,1027,205,250,171,245,1898,0.20141204157678,0.571030640668524,0.899280575539568,0.919354838709677,0.924528301886792,0.306772264425408
E02002547,Elm Tree & Grangefield,Stockton-on-Tees,North East,941,3440,430,509,346,527,5252,910,3552,452,507,351,510,5372,803,325,485,339,488,2440,0.22606981981982,0.719026548672566,0.956607495069034,0.965811965811966,0.956862745098039,0.454206999255398
E02002548,"Central Stockton, Portrack & Low Hartburn",Stockton-on-Tees,North East,2866,9546,475,385,230,341,10977,3062,10543,547,366,224,299,11979,1538,299,322,199,260,2618,0.145878782130323,0.546617915904936,0.879781420765027,0.888392857142857,0.869565217391304,0.218549127640037
E02002549,Fairfield,Stockton-on-Tees,North East,1156,4058,516,588,448,630,6240,1174,4306,509,564,511,630,6520,952,402,545,494,613,3006,0.221086855550395,0.789783889980354,0.966312056737589,0.966731898238747,0.973015873015873,0.461042944785276
E02002550,Hartburn,Stockton-on-Tees,North East,1101,3799,322,334,236,392,5083,1076,3929,378,312,248,373,5240,784,266,288,236,359,1933,0.199541868159837,0.703703703703704,0.923076923076923,0.951612903225806,0.962466487935657,0.368893129770992
E02002551,Thornaby North,Stockton-on-Tees,North East,1171,5173,244,190,128,247,5982,1199,5504,296,202,133,210,6345,514,201,186,128,196,1225,0.0933866279069767,0.679054054054054,0.920792079207921,0.962406015037594,0.933333333333333,0.193065405831363
E02002552,Thornaby Mandale,Stockton-on-Tees,North East,1744,4371,407,312,145,267,5502,1623,4625,395,368,189,221,5798,767,302,347,184,206,1806,0.165837837837838,0.764556962025316,0.942934782608696,0.973544973544973,0.932126696832579,0.311486719558468
E02002553,Thornaby Village,Stockton-on-Tees,North East,1294,3425,352,319,208,351,4655,1160,3519,343,348,225,321,4756,598,267,319,212,303,1699,0.169934640522876,0.778425655976676,0.916666666666667,0.942222222222222,0.94392523364486,0.357232968881413
E02002554,Thornaby South,Stockton-on-Tees,North East,1101,3016,312,320,230,301,4179,991,3236,342,348,237,313,4476,534,262,323,232,299,1650,0.165018541409147,0.766081871345029,0.92816091954023,0.978902953586498,0.955271565495208,0.368632707774799
E02002555,Eaglescliffe,Stockton-on-Tees,North East,1971,5862,624,601,453,620,8160,1908,6304,608,658,464,670,8704,1177,532,630,453,649,3441,0.186706852791878,0.875,0.957446808510638,0.976293103448276,0.96865671641791,0.395335477941176
E02002556,Ingleby Barwick East & Hilton,Stockton-on-Tees,North East,1256,4447,488,355,225,208,5723,1277,4742,525,415,243,251,6176,910,440,402,237,238,2227,0.191902150991143,0.838095238095238,0.968674698795181,0.975308641975309,0.948207171314741,0.360589378238342
E02002557,Ingleby Barwick West,Stockton-on-Tees,North East,4268,10899,460,330,190,238,12117,4252,11455,498,390,214,285,12842,2167,401,361,199,259,3387,0.189175032736796,0.805220883534137,0.925641025641026,0.929906542056075,0.908771929824561,0.263743965114468
E02002558,Yarm,Stockton-on-Tees,North East,1866,6320,787,696,473,649,8925,1860,6814,753,791,539,654,9551,1406,679,749,526,628,3988,0.206339888464925,0.901726427622842,0.946902654867257,0.975881261595547,0.960244648318043,0.417547900743378
E02002559,"Faverdale, Heighington & Sadberge",Darlington,North East,1726,5580,552,573,355,371,7431,1807,6091,547,580,406,408,8032,1064,493,550,396,393,2896,0.174683959940896,0.90127970749543,0.948275862068965,0.975369458128079,0.963235294117647,0.360557768924303
E02002560,Harrowgate Hill,Darlington,North East,1204,3716,326,332,233,276,4883,1179,4120,335,333,238,289,5315,658,273,311,227,279,1748,0.159708737864078,0.814925373134328,0.933933933933934,0.953781512605042,0.965397923875433,0.328880526810913
E02002561,Whinfield,Darlington,North East,832,3136,445,380,217,295,4473,807,3331,438,456,253,312,4790,557,376,436,246,297,1912,0.167217051936355,0.858447488584475,0.956140350877193,0.972332015810277,0.951923076923077,0.399164926931106
E02002562,Rise Carr,Darlington,North East,1014,3741,290,278,198,319,4826,995,3915,307,253,192,283,4950,499,229,222,177,266,1393,0.127458492975734,0.745928338762215,0.877470355731225,0.921875,0.939929328621908,0.281414141414141
E02002563,Haughton Le Skerne,Darlington,North East,902,3101,395,334,239,475,4544,929,3361,406,393,240,409,4809,556,345,363,228,387,1879,0.165426956263017,0.849753694581281,0.923664122137404,0.95,0.946210268948655,0.390725722603452
E02002564,Cockerton & Hopetown,Darlington,North East,2072,5859,474,488,339,497,7657,2008,6409,493,481,362,491,8236,1084,417,447,341,472,2761,0.169137150881573,0.845841784989858,0.929313929313929,0.941988950276243,0.961303462321792,0.335235551238465
E02002565,Pierremont,Darlington,North East,861,3429,214,234,132,204,4213,767,3531,256,255,156,197,4395,560,198,231,145,187,1321,0.158595298782215,0.7734375,0.905882352941176,0.92948717948718,0.949238578680203,0.300568828213879
E02002566,Central Darlington,Darlington,North East,1180,4901,227,246,146,242,5762,1133,5096,252,254,153,233,5988,563,176,220,139,211,1309,0.110478806907378,0.698412698412698,0.866141732283465,0.908496732026144,0.905579399141631,0.218603874415498
E02002567,Albert Hill & Red Hall,Darlington,North East,2021,5202,379,423,289,411,6704,2107,5943,421,440,284,421,7509,805,337,400,271,398,2211,0.13545347467609,0.800475059382423,0.909090909090909,0.954225352112676,0.945368171021378,0.294446664003196
E02002568,College & Park West,Darlington,North East,984,3510,358,388,262,498,5016,945,3703,390,404,287,521,5305,661,345,384,271,502,2163,0.178503915743991,0.884615384615385,0.95049504950495,0.944250871080139,0.963531669865643,0.407728557964185
E02002569,Hummersknott,Darlington,North East,1379,4612,657,731,564,1071,7635,1392,5044,665,694,602,1019,8024,853,581,665,589,981,3669,0.169111816019033,0.873684210526316,0.95821325648415,0.978405315614618,0.962708537782139,0.457253240279163
E02002570,Bank Top,Darlington,North East,1481,4797,420,400,217,456,6290,1418,5276,431,431,249,459,6846,769,310,381,227,424,2111,0.145754359363154,0.719257540603248,0.883990719257541,0.911646586345381,0.923747276688453,0.308355243938066
E02002571,Firthmoor,Darlington,North East,1500,3928,290,269,211,309,5007,1444,4220,295,272,218,294,5299,512,223,242,205,282,1464,0.12132701421801,0.75593220338983,0.889705882352941,0.940366972477064,0.959183673469388,0.276278543121344
E02002572,Park East,Darlington,North East,1440,4090,277,257,164,185,4973,1374,4419,300,269,172,195,5355,574,222,244,154,180,1374,0.12989364109527,0.74,0.907063197026022,0.895348837209302,0.923076923076923,0.256582633053221
E02002573,Middleton & Hurworth,Darlington,North East,1579,5089,559,598,414,554,7214,1706,5731,593,613,460,617,8014,951,502,575,443,594,3065,0.165939626592218,0.846543001686341,0.938009787928222,0.96304347826087,0.962722852512156,0.382455702520589
E02004290,Ouston & Beamish,County Durham,North East,907,3475,404,383,280,327,4869,823,3643,429,392,294,346,5104,835,381,376,287,336,2215,0.229206697776558,0.888111888111888,0.959183673469388,0.976190476190476,0.971098265895954,0.433973354231975
E02004291,Pelton & Perkinsville,County Durham,North East,1302,4625,384,373,241,323,5946,1274,4761,378,373,257,350,6119,1078,355,354,250,339,2376,0.226423020373871,0.939153439153439,0.949061662198391,0.972762645914397,0.968571428571429,0.388298741624448
E02004292,Chester-le-Street North,County Durham,North East,1250,4411,464,637,471,650,6633,1207,4841,471,557,509,703,7081,1108,417,539,501,682,3247,0.228878330923363,0.885350318471338,0.967684021543986,0.984282907662083,0.970128022759602,0.458551052111284
E02004293,Chester-le-Street Town & Pelton Fell,County Durham,North East,1862,6019,495,469,356,557,7896,1804,6392,525,438,392,568,8315,1507,442,422,372,540,3283,0.235763454317897,0.841904761904762,0.963470319634703,0.948979591836735,0.950704225352113,0.394828622970535
E02004294,Chester-le-Street South & East,County Durham,North East,1187,5116,537,607,376,494,7130,1110,5106,553,601,420,531,7211,1147,485,576,410,519,3137,0.22463768115942,0.877034358047016,0.958402662229617,0.976190476190476,0.977401129943503,0.435029815559562
E02004295,Great Lumley & Bournmoor,County Durham,North East,1175,4353,506,524,318,400,6101,1176,4531,503,508,342,444,6328,942,463,493,334,428,2660,0.207901125579342,0.920477137176938,0.970472440944882,0.976608187134503,0.963963963963964,0.420353982300885
E02004296,Sacriston,County Durham,North East,1437,5255,523,460,322,367,6927,1481,5650,498,485,317,386,7336,1179,421,460,306,366,2732,0.208672566371681,0.845381526104418,0.948453608247423,0.965299684542587,0.948186528497409,0.372410032715376
E02004297,Burnopfield,County Durham,North East,1372,4967,451,482,387,466,6753,1312,4940,474,486,389,486,6775,1347,370,463,380,471,3031,0.272672064777328,0.780590717299578,0.952674897119342,0.976863753213368,0.969135802469136,0.447380073800738
E02004298,"Benfieldside, Hamsterley & Medomsley",County Durham,North East,1643,6041,653,658,431,634,8417,1570,6106,704,656,445,651,8562,1544,560,627,424,631,3786,0.252866033409761,0.795454545454545,0.955792682926829,0.952808988764045,0.969278033794163,0.44218640504555
E02004299,Stanley North & East,County Durham,North East,1522,5134,600,511,340,431,7016,1415,5183,574,515,365,454,7091,1313,450,487,350,442,3042,0.25332818830793,0.78397212543554,0.945631067961165,0.958904109589041,0.973568281938326,0.428994500070512
E02004300,Catchgate & Dipton,County Durham,North East,1532,4625,447,515,343,405,6335,1453,4798,466,511,362,408,6545,1260,355,488,343,394,2840,0.262609420591913,0.761802575107296,0.954990215264188,0.947513812154696,0.965686274509804,0.433919022154316
E02004301,Stanley South,County Durham,North East,2087,5903,470,434,264,397,7468,2040,6231,488,449,311,353,7832,1571,372,429,298,333,3003,0.252126464451934,0.762295081967213,0.955456570155902,0.958199356913183,0.943342776203966,0.383426966292135
E02004302,Stanley West & Annfield Plain,County Durham,North East,1485,4798,461,417,304,375,6355,1419,5018,442,435,325,355,6575,1179,312,408,314,332,2545,0.234954165005979,0.705882352941177,0.937931034482759,0.966153846153846,0.935211267605634,0.387072243346008
E02004303,Consett,County Durham,North East,1806,7110,615,613,466,564,9368,1719,7320,654,639,450,652,9715,1813,413,602,432,628,3888,0.247677595628415,0.631498470948012,0.942097026604069,0.96,0.96319018404908,0.400205867215646
E02004304,Delves Lane & Leadgate,County Durham,North East,1859,5543,472,490,329,552,7386,1759,5672,467,449,336,539,7463,1444,311,420,325,511,3011,0.254583921015515,0.665952890792291,0.935412026726058,0.967261904761905,0.948051948051948,0.403457054803698
E02004305,"Bridgehill, Castleside & Harehope Hill",County Durham,North East,2106,6205,505,453,342,382,7887,2073,6521,507,465,330,434,8257,1525,349,431,324,421,3050,0.233859837448244,0.68836291913215,0.926881720430108,0.981818181818182,0.970046082949309,0.369383553348674
E02004306,Lanchester,County Durham,North East,979,3325,455,483,286,408,4957,1046,3547,465,463,347,421,5243,952,354,445,337,409,2497,0.268395827459825,0.761290322580645,0.961123110151188,0.971181556195966,0.971496437054632,0.476254053023078
E02004307,Langley Park & Satley,County Durham,North East,1111,4170,402,358,260,371,5561,1073,4296,412,381,255,320,5664,1124,305,359,243,311,2342,0.261638733705773,0.740291262135922,0.942257217847769,0.952941176470588,0.971875,0.413488700564972
E02004308,Newton Hall & Brasside,County Durham,North East,1133,5056,589,647,371,414,7077,1091,4905,545,626,423,437,6936,1236,461,608,407,422,3134,0.251987767584098,0.845871559633028,0.971246006389776,0.962174940898345,0.965675057208238,0.451845444059977
E02004309,Pity Me & Framwellgate Moor,County Durham,North East,1152,3818,361,362,243,406,5190,1147,4228,363,376,244,420,5631,1034,286,355,237,406,2318,0.244560075685904,0.787878787878788,0.944148936170213,0.971311475409836,0.966666666666667,0.411649795773397
E02004310,Bearpark & Witton Gilbert,County Durham,North East,1387,4833,542,493,304,367,6539,1400,4967,490,503,357,347,6664,1211,400,471,345,333,2760,0.243809140326153,0.816326530612245,0.936381709741551,0.966386554621849,0.959654178674351,0.414165666266507
E02004311,Sherburn & West Rainton,County Durham,North East,1578,5584,603,601,369,447,7604,1511,5774,584,594,393,473,7818,1568,460,567,370,452,3417,0.271562175268445,0.787671232876712,0.954545454545455,0.94147582697201,0.955602536997886,0.437068303914045
E02004312,Belmont & Carrville,County Durham,North East,1085,4013,556,677,474,624,6344,1089,4219,507,666,509,657,6558,1136,432,644,494,637,3343,0.26925811803745,0.85207100591716,0.966966966966967,0.970530451866405,0.969558599695586,0.509759072888076
E02004313,Gilesgate & Old Durham,County Durham,North East,1137,5687,255,298,216,283,6739,1112,5819,269,284,204,261,6837,885,211,264,191,253,1804,0.15208798762674,0.784386617100372,0.929577464788732,0.936274509803922,0.969348659003831,0.263858417434547
E02004314,Durham City,County Durham,North East,295,13305,195,178,158,342,14178,246,19545,190,200,137,312,20384,632,152,180,126,292,1382,0.0323356357124584,0.8,0.9,0.91970802919708,0.935897435897436,0.067798273155416
E02004315,"Aykley Heads, Neville's Cross & Langley Moor",County Durham,North East,2242,10769,548,471,307,438,12533,2236,10139,538,494,342,476,11989,1555,451,472,329,455,3262,0.153368182266496,0.838289962825279,0.955465587044534,0.961988304093567,0.955882352941176,0.272082742513971
E02004316,Esh Winning & Ushaw Moor,County Durham,North East,1187,3969,342,330,209,283,5133,1203,4079,369,345,237,280,5310,1135,244,327,229,269,2204,0.278254474135818,0.661246612466125,0.947826086956522,0.966244725738397,0.960714285714286,0.415065913370998
E02004317,Brandon & Brancepeth,County Durham,North East,1263,4510,530,512,310,450,6312,1150,4675,477,515,330,436,6433,1205,320,492,321,414,2752,0.257754010695187,0.670859538784067,0.955339805825243,0.972727272727273,0.94954128440367,0.427794186227266
E02004318,High Shincliffe & Bowburn,County Durham,North East,1127,4172,392,364,257,349,5534,1195,4417,432,365,288,358,5860,1003,354,352,273,338,2320,0.227077201720625,0.819444444444445,0.964383561643836,0.947916666666667,0.94413407821229,0.395904436860068
E02004319,Coxhoe & Quarrington Hill,County Durham,North East,1422,4884,443,425,332,331,6415,1386,5076,421,405,326,397,6625,1361,346,391,315,382,2795,0.26812450748621,0.821852731591449,0.965432098765432,0.966257668711656,0.962216624685139,0.42188679245283
E02004320,Seaham Northlea & Westlea,County Durham,North East,1542,5525,532,488,313,558,7416,1453,5493,563,496,332,498,7382,1488,359,474,316,482,3119,0.270890223921354,0.63765541740675,0.955645161290323,0.951807228915663,0.967871485943775,0.422514223787591
E02004321,Seaham Central & South,County Durham,North East,1582,5427,484,363,286,417,6977,1511,5524,475,381,302,504,7186,1495,276,360,291,473,2895,0.270637219406227,0.581052631578947,0.944881889763779,0.963576158940397,0.938492063492063,0.402866685221264
E02004322,Murton North & Parkside,County Durham,North East,1768,5047,489,481,333,399,6749,1771,5442,525,508,342,464,7281,1501,332,477,323,431,3064,0.275817714075708,0.632380952380952,0.938976377952756,0.944444444444444,0.928879310344828,0.420821315753331
E02004323,South Murton & South Hetton,County Durham,North East,1469,5210,381,361,246,399,6597,1369,4965,394,355,265,343,6322,1235,295,337,257,333,2457,0.248741188318228,0.748730964467005,0.949295774647887,0.969811320754717,0.970845481049563,0.38864283454603
E02004324,Easington & Hawthorn,County Durham,North East,1001,3485,358,365,225,301,4734,982,3745,352,356,245,290,4988,735,238,330,236,276,1815,0.196261682242991,0.676136363636364,0.926966292134832,0.963265306122449,0.951724137931035,0.363873295910184
E02004325,Peterlee East,County Durham,North East,1809,5293,423,376,226,399,6717,1939,6096,430,387,244,404,7561,1318,263,363,232,376,2552,0.216207349081365,0.611627906976744,0.937984496124031,0.950819672131147,0.930693069306931,0.337521491866155
E02004326,Shotton & Haswell,County Durham,North East,1415,4247,324,324,242,304,5441,1409,4563,369,334,247,318,5831,1065,233,322,234,305,2159,0.233399079552926,0.631436314363144,0.964071856287425,0.947368421052632,0.959119496855346,0.370262390670554
E02004327,Horden,County Durham,North East,946,3509,372,322,285,351,4839,952,3748,335,331,291,368,5073,889,224,309,279,357,2058,0.237193169690502,0.66865671641791,0.933534743202417,0.958762886597938,0.970108695652174,0.405677114133649
E02004328,Peterlee West,County Durham,North East,1506,4456,315,361,253,383,5768,1455,4889,321,331,280,392,6213,1061,215,319,270,376,2241,0.217017795050113,0.669781931464175,0.963746223564955,0.964285714285714,0.959183673469388,0.360695316272332
E02004329,Peterlee South,County Durham,North East,951,3904,462,414,294,368,5442,915,4129,513,401,308,372,5723,991,366,387,300,361,2405,0.240009687575684,0.713450292397661,0.965087281795511,0.974025974025974,0.970430107526882,0.420234142932029
E02004330,Blackhall,County Durham,North East,839,3437,416,399,275,349,4876,940,3809,444,402,308,425,5388,967,285,374,305,413,2344,0.253872407456025,0.641891891891892,0.930348258706468,0.99025974025974,0.971764705882353,0.435040831477357
E02004331,Thornley & Wheatley Hill,County Durham,North East,1363,4481,343,450,288,362,5924,1326,4552,358,420,332,369,6031,1108,274,406,321,352,2461,0.243409490333919,0.76536312849162,0.966666666666667,0.966867469879518,0.953929539295393,0.40805836511358
E02004332,Wingate & Castle Eden,County Durham,North East,1416,4581,404,369,277,306,5937,1381,4842,434,366,263,327,6232,1245,346,344,255,322,2512,0.257125154894672,0.797235023041475,0.939890710382514,0.96958174904943,0.984709480122324,0.403080872913992
E02004333,Tudhoe Grange,County Durham,North East,1014,4058,605,568,303,362,5896,949,4060,589,557,386,388,5980,1007,406,535,370,373,2691,0.248029556650246,0.689303904923599,0.960502692998205,0.958549222797927,0.961340206185567,0.45
E02004334,Trimdon & Fishburn,County Durham,North East,1340,4506,408,404,271,311,5900,1260,4552,446,394,310,302,6004,1169,327,377,292,292,2457,0.256810193321617,0.733183856502242,0.956852791878173,0.941935483870968,0.966887417218543,0.409227181878748
E02004335,Spennymoor East & Ferryhill West,County Durham,North East,1437,4620,415,360,227,310,5932,1537,4912,445,380,265,323,6325,1140,271,348,248,310,2317,0.232084690553746,0.608988764044944,0.91578947368421,0.935849056603774,0.959752321981424,0.366324110671937
E02004336,Ferryhill East & Cornforth,County Durham,North East,1085,3878,486,469,356,429,5618,1123,4234,497,450,372,461,6014,1088,327,414,349,446,2624,0.256967406707605,0.6579476861167,0.92,0.938172043010753,0.967462039045553,0.436315264383106
E02004337,Spennymoor West,County Durham,North East,1886,6182,595,545,329,466,8117,1903,6679,589,632,345,475,8720,1605,385,597,324,450,3361,0.240305434945351,0.65365025466893,0.944620253164557,0.939130434782609,0.947368421052632,0.385435779816514
E02004338,Chilton,County Durham,North East,1249,4428,407,410,272,340,5857,1203,4764,397,425,291,326,6203,1228,259,410,268,310,2475,0.25776658270361,0.652392947103275,0.964705882352941,0.920962199312715,0.950920245398773,0.39900048363695
E02004339,Sedgefield & Bishop Middleham,County Durham,North East,1134,3855,442,571,409,436,5713,1095,4058,462,544,430,459,5953,993,365,522,418,442,2740,0.244701823558403,0.79004329004329,0.959558823529412,0.972093023255814,0.962962962962963,0.460272131698303
E02004340,Shildon,County Durham,North East,1916,6313,581,593,361,571,8419,2018,6798,593,646,376,559,8972,1767,522,614,354,539,3796,0.259929390997352,0.880269814502529,0.95046439628483,0.941489361702128,0.964221824686941,0.423094070441373
E02004341,Newton Aycliffe North,County Durham,North East,1485,5311,581,544,387,363,7186,1382,5737,590,606,405,407,7745,1241,535,576,393,391,3136,0.216315147289524,0.906779661016949,0.95049504950495,0.97037037037037,0.960687960687961,0.404906391220142
E02004342,Newton Aycliffe West,County Durham,North East,1478,3445,214,199,157,273,4288,1410,3771,234,232,162,239,4638,705,201,219,154,228,1507,0.186953062848051,0.858974358974359,0.943965517241379,0.950617283950617,0.95397489539749,0.32492453643812
E02004343,Newton Aycliffe East,County Durham,North East,990,3313,311,291,241,358,4514,977,3565,337,324,233,395,4854,759,308,311,229,382,1989,0.212903225806452,0.913946587537092,0.959876543209877,0.982832618025751,0.967088607594937,0.409765142150803
E02004344,Newton Aycliffe South,County Durham,North East,1239,4039,504,457,334,557,5891,1230,4484,490,471,321,483,6249,958,428,457,313,461,2617,0.213648528099911,0.873469387755102,0.970276008492569,0.975077881619938,0.954451345755693,0.418787005920947
E02004345,"Evenwood, Cockfield & Staindrop",County Durham,North East,1959,7400,982,949,631,807,10769,1897,7823,1021,990,674,852,11360,2227,896,952,661,822,5558,0.284673398951809,0.877571008814887,0.961616161616162,0.980712166172107,0.964788732394366,0.489260563380282
E02004346,Upper Teesdale,County Durham,North East,744,2963,414,454,228,339,4398,658,3064,404,455,301,311,4535,804,361,439,292,298,2194,0.262402088772846,0.893564356435644,0.964835164835165,0.970099667774086,0.958199356913183,0.483792723263506
E02004347,Barnard Castle,County Durham,North East,965,4257,496,514,396,628,6291,1021,4374,498,541,399,667,6479,1109,469,513,387,641,3119,0.253543667123914,0.941767068273092,0.948243992606285,0.969924812030075,0.961019490254873,0.481401450841179
E02004348,Stanhope & Weardale,County Durham,North East,1116,4515,675,698,461,518,6867,977,4561,645,716,490,568,6980,1182,494,679,480,549,3384,0.259153694365271,0.765891472868217,0.948324022346369,0.979591836734694,0.966549295774648,0.484813753581662
E02004349,Crook North & Tow Law,County Durham,North East,1996,5632,542,445,353,474,7446,1834,5729,547,503,366,469,7614,1581,342,465,346,449,3183,0.275964391691395,0.625228519195612,0.924453280318092,0.945355191256831,0.957356076759062,0.418045705279748
E02004350,Crook South,County Durham,North East,1649,5829,650,628,436,500,8043,1653,5993,671,650,456,543,8313,1618,484,627,437,527,3693,0.269981645252795,0.721311475409836,0.964615384615385,0.958333333333333,0.970534069981584,0.444243955250812
E02004351,Coundon North,County Durham,North East,1462,4428,430,428,254,359,5899,1397,4643,423,427,283,353,6129,1370,339,405,273,336,2723,0.295067844066336,0.801418439716312,0.94847775175644,0.964664310954064,0.951841359773371,0.444281285690977
E02004352,Bishop Auckland North & Coundon Grange,County Durham,North East,1436,4930,431,457,270,414,6502,1511,5362,475,437,293,446,7013,1268,350,422,283,422,2745,0.236478925773965,0.736842105263158,0.965675057208238,0.965870307167236,0.946188340807175,0.39141594182233
E02004353,Bishop Auckland Central & West,County Durham,North East,1155,4276,480,518,330,581,6185,1183,4522,470,518,346,547,6403,1187,378,499,334,536,2934,0.2624944714728,0.804255319148936,0.963320463320463,0.965317919075144,0.979890310786106,0.458222708105576
E02004354,Saint Helen Auckland & West Auckland,County Durham,North East,1681,5629,565,588,349,294,7425,1740,5936,577,599,349,370,7831,1497,439,575,340,363,3214,0.252190026954178,0.760831889081456,0.959933222036728,0.974212034383954,0.981081081081081,0.41042012514366
E02004355,Bishop Auckland South,County Durham,North East,1493,4412,421,372,241,326,5772,1502,4784,430,422,248,321,6205,1287,308,389,238,307,2529,0.269021739130435,0.716279069767442,0.921800947867299,0.959677419354839,0.956386292834891,0.407574536663981
E02005702,Longhoughton & Alnmouth,Northumberland,North East,867,3745,499,536,383,576,5739,905,3776,477,586,404,607,5850,447,421,548,394,588,2398,0.118379237288136,0.882599580712788,0.935153583617747,0.975247524752475,0.968698517298188,0.40991452991453
E02005703,Alnwick,Northumberland,North East,974,4058,470,442,331,477,5778,966,4167,524,508,345,493,6037,488,449,478,331,476,2222,0.117110631149508,0.856870229007634,0.940944881889764,0.959420289855072,0.96551724137931,0.368063607752195
E02005704,"Amble, Shilbottle & Swarland",Northumberland,North East,1788,7389,975,978,638,892,10872,1816,7611,1075,1028,741,886,11341,1361,784,981,714,858,4698,0.178820128761004,0.729302325581395,0.954280155642023,0.963562753036437,0.968397291196388,0.414249184375276
E02005705,Rothbury & Longframlington,Northumberland,North East,997,4169,765,641,482,578,6635,963,4212,768,697,500,570,6747,540,595,652,484,545,2816,0.128205128205128,0.774739583333333,0.935437589670014,0.968,0.956140350877193,0.417370683266637
E02005706,Berwick-upon-Tweed Town,Northumberland,North East,1636,5599,638,584,421,672,7914,1636,5741,635,633,419,686,8114,608,176,598,400,651,2433,0.105904894617662,0.277165354330709,0.944707740916272,0.954653937947494,0.948979591836735,0.299852107468573
E02005707,Berwick-upon-Tweed West & Holy Island,Northumberland,North East,948,3868,629,672,520,537,6226,889,3858,578,640,490,538,6104,394,157,607,465,517,2140,0.102125453602903,0.271626297577855,0.9484375,0.948979591836735,0.960966542750929,0.350589777195282
E02005708,"Seahouses, Belford & Wooler",Northumberland,North East,1249,5749,988,954,669,833,9193,1145,5238,957,919,681,817,8612,581,572,872,666,786,3477,0.110920198549065,0.597701149425287,0.94885745375408,0.977973568281938,0.962056303549572,0.403738968880632
E02005709,Blyth Cowpen,Northumberland,North East,1624,4235,338,297,191,324,5385,1544,4465,326,343,227,310,5671,1115,280,324,211,276,2206,0.249720044792833,0.858895705521472,0.944606413994169,0.929515418502203,0.890322580645161,0.388996649620878
E02005710,Blyth Town,Northumberland,North East,1681,5917,508,505,330,490,7750,1573,5986,548,531,350,547,7962,1517,499,505,336,478,3335,0.253424657534247,0.910583941605839,0.951035781544256,0.96,0.873857404021938,0.418864606882693
E02005711,Blyth Isabella,Northumberland,North East,1592,4782,503,523,326,389,6523,1527,4933,506,521,342,405,6707,1302,449,486,329,361,2927,0.263936752483276,0.887351778656127,0.932821497120921,0.961988304093567,0.891358024691358,0.43640972118682
E02005712,Blyth Newsham,Northumberland,North East,1831,5423,405,409,228,280,6745,1848,5691,414,421,254,306,7086,1428,377,407,245,270,2727,0.250922509225092,0.910628019323672,0.966745843230404,0.964566929133858,0.882352941176471,0.384843353090601
E02005713,Blyth South,Northumberland,North East,951,3814,539,505,271,324,5453,909,3799,503,559,322,301,5484,985,474,531,314,264,2568,0.259278757567781,0.94234592445328,0.949910554561717,0.975155279503106,0.877076411960133,0.468271334792123
E02005714,North Cramlington,Northumberland,North East,932,3241,390,296,188,95,4210,817,3473,373,359,193,144,4542,702,312,347,185,135,1681,0.202130722718111,0.836461126005362,0.966573816155989,0.958549222797927,0.9375,0.370101276970498
E02005715,Cramlington Town & Beaconhill,Northumberland,North East,1689,5173,548,486,333,539,7079,1821,5835,522,516,372,506,7751,1356,438,488,351,488,3121,0.232390745501285,0.839080459770115,0.945736434108527,0.943548387096774,0.964426877470356,0.402657721584312
E02005716,East Cramlington & Parkside,Northumberland,North East,1621,5462,601,572,272,368,7275,1669,6057,620,639,322,358,7996,1547,530,614,313,340,3344,0.255406967145452,0.854838709677419,0.960876369327073,0.972049689440994,0.949720670391061,0.418209104552276
E02005717,Holywell & Hartley,Northumberland,North East,1076,4351,556,604,398,598,6507,1047,4443,559,624,481,591,6698,909,445,589,463,549,2955,0.204591492234976,0.796064400715564,0.943910256410256,0.962577962577963,0.928934010152284,0.441176470588235
E02005718,Cramlington South,Northumberland,North East,811,3506,565,703,406,425,5605,826,3600,545,716,486,434,5781,887,478,697,475,408,2945,0.246388888888889,0.877064220183486,0.973463687150838,0.977366255144033,0.940092165898618,0.509427434699879
E02005719,Seaton Delaval & Seghill,Northumberland,North East,1286,5476,518,571,332,368,7265,1233,5148,529,525,366,384,6952,1001,441,490,344,365,2641,0.194444444444444,0.833648393194707,0.933333333333333,0.939890710382514,0.950520833333333,0.379890678941312
E02005720,"Widdrington, Lynemouth & Hadston",Northumberland,North East,1729,7563,868,852,476,586,10345,1732,7968,888,847,559,588,10850,1687,546,809,536,567,4145,0.211721887550201,0.614864864864865,0.955135773317591,0.958855098389982,0.964285714285714,0.382027649769585
E02005721,Morpeth North & Pegswood,Northumberland,North East,899,3430,325,322,191,359,4627,874,3507,385,353,216,356,4817,750,270,337,208,341,1906,0.213857998289136,0.701298701298701,0.954674220963173,0.962962962962963,0.957865168539326,0.395681959725971
E02005722,"Longhorsley, Hepscott & Capheaton",Northumberland,North East,1370,4966,601,587,363,402,6919,1479,5756,713,611,394,475,7949,1035,560,585,381,461,3022,0.179812369701181,0.785413744740533,0.957446808510638,0.967005076142132,0.970526315789474,0.380173606742987
E02005723,Morpeth Central & East,Northumberland,North East,906,3451,460,425,328,607,5271,875,3561,454,433,338,604,5390,665,329,402,317,590,2303,0.186745296265094,0.724669603524229,0.928406466512702,0.937869822485207,0.97682119205298,0.427272727272727
E02005724,Morpeth South & West,Northumberland,North East,1133,3613,473,524,391,534,5535,1127,3771,469,583,393,586,5802,687,396,570,386,582,2621,0.182179793158313,0.844349680170576,0.97770154373928,0.982188295165394,0.993174061433447,0.45174077904171
E02005725,Ponteland,Northumberland,North East,1087,3638,490,516,374,774,5792,1072,3928,467,577,402,773,6147,752,317,547,392,751,2759,0.191446028513238,0.678800856531049,0.948006932409012,0.975124378109453,0.971539456662354,0.448836830974459
E02005726,"Darras Hall, Stamfordham & Heddon",Northumberland,North East,1240,4382,536,590,413,673,6594,1289,4854,546,584,432,684,7100,922,430,561,421,657,2991,0.189946435929131,0.787545787545788,0.960616438356164,0.974537037037037,0.960526315789474,0.421267605633803
E02005727,"Bellingham, Otterburn & Redesdale",Northumberland,North East,918,3731,493,505,299,387,5415,864,3691,514,466,329,405,5405,658,317,445,317,398,2135,0.178271471146031,0.616731517509728,0.954935622317597,0.963525835866261,0.982716049382716,0.395004625346901
E02005728,Haltwhistle & Bardon Mill,Northumberland,North East,1080,3969,546,596,375,464,5950,974,3896,560,574,413,464,5907,640,480,549,396,452,2517,0.164271047227926,0.857142857142857,0.956445993031359,0.958837772397094,0.974137931034483,0.426104621635348
E02005729,Wylam & Ovingham,Northumberland,North East,918,3317,444,403,276,339,4779,862,3416,398,430,309,403,4956,721,327,413,304,391,2156,0.211065573770492,0.821608040201005,0.96046511627907,0.983818770226537,0.970223325062035,0.435028248587571
E02005730,Hexham & Acomb,Northumberland,North East,1932,7453,899,937,668,1137,11094,1856,7564,961,973,731,1114,11343,1642,757,937,721,1075,5132,0.217080909571655,0.787721123829344,0.963001027749229,0.986320109439125,0.964991023339318,0.452437626730142
E02005731,Prudhoe,Northumberland,North East,1988,6803,627,615,481,533,9059,1882,7092,594,677,458,567,9388,1482,454,653,440,535,3564,0.208967851099831,0.764309764309764,0.964549483013294,0.960698689956332,0.943562610229277,0.37963357477631
E02005732,"Stocksfield, Riding Mill & Corbridge",Northumberland,North East,1321,4977,706,786,504,867,7840,1253,4992,757,776,594,848,7967,977,641,737,588,821,3764,0.195713141025641,0.846763540290621,0.949742268041237,0.98989898989899,0.968160377358491,0.472448851512489
E02005733,Haydon Bridge & Allendale,Northumberland,North East,1320,4883,693,681,384,519,7160,1223,4917,718,688,459,541,7323,894,491,651,444,525,3005,0.181818181818182,0.683844011142061,0.946220930232558,0.967320261437908,0.970425138632163,0.410350949064591
E02005734,Newbiggin,Northumberland,North East,1060,3576,426,413,300,358,5073,999,3670,460,424,282,396,5232,807,317,402,267,381,2174,0.219891008174387,0.689130434782609,0.94811320754717,0.946808510638298,0.962121212121212,0.415519877675841
E02005735,Ashington Hirst,Northumberland,North East,1623,4943,366,331,223,313,6176,1488,4973,365,347,235,319,6239,1000,227,327,227,306,2087,0.201085863663784,0.621917808219178,0.942363112391931,0.965957446808511,0.959247648902821,0.334508735374259
E02005736,Ashington East,Northumberland,North East,1681,5045,482,470,272,294,6563,1699,5336,481,498,332,320,6967,1123,330,480,320,309,2562,0.210457271364318,0.686070686070686,0.963855421686747,0.963855421686747,0.965625,0.367733601263097
E02005737,Ashington West,Northumberland,North East,1160,4499,493,488,254,395,6129,1242,4706,503,469,331,385,6394,1108,319,451,325,377,2580,0.235444113897153,0.634194831013916,0.961620469083156,0.981873111782477,0.979220779220779,0.403503284329059
E02005738,Ashington South,Northumberland,North East,747,3070,328,354,199,225,4176,750,3110,337,358,239,244,4288,726,215,343,236,241,1761,0.233440514469453,0.637982195845697,0.958100558659218,0.98744769874477,0.987704918032787,0.410680970149254
E02005739,Guide Post & Stakeford,Northumberland,North East,1464,5453,598,545,524,615,7735,1466,5604,588,585,484,652,7913,1281,454,560,467,634,3396,0.228586723768737,0.772108843537415,0.957264957264957,0.964876033057851,0.97239263803681,0.429167193226336
E02005740,Bedlington Station & Sleekburn,Northumberland,North East,1947,6333,624,585,364,515,8421,1866,6449,585,597,398,521,8550,1361,469,557,385,497,3269,0.211040471390913,0.801709401709402,0.932998324958124,0.967336683417085,0.953934740882918,0.38233918128655
E02005741,Bedlington Town,Northumberland,North East,1367,5156,590,525,343,570,7184,1322,5296,582,572,388,572,7410,1155,454,550,375,557,3091,0.21808912386707,0.780068728522337,0.961538461538461,0.966494845360825,0.973776223776224,0.417139001349528
E02001708,Kingston Park & Dinnington,Newcastle upon Tyne,North East,3026,8053,684,592,331,482,10142,3362,9916,737,668,378,548,12247,1953,631,627,354,526,4091,0.196954417103671,0.856173677069199,0.938622754491018,0.936507936507937,0.95985401459854,0.334040989630114
E02001709,North Gosforth,Newcastle upon Tyne,North East,1975,5874,597,564,424,694,8153,1958,6772,641,621,446,668,9148,1506,573,590,426,630,3725,0.222386296515062,0.893915756630265,0.950080515297907,0.955156950672646,0.94311377245509,0.407192829033669
E02001710,Fawdon South,Newcastle upon Tyne,North East,1933,6007,456,399,282,552,7696,1910,6938,539,472,313,555,8817,1132,431,426,293,514,2796,0.163159411934275,0.799628942486085,0.902542372881356,0.936102236421725,0.926126126126126,0.31711466485199
E02001711,Woolsington & Airport,Newcastle upon Tyne,North East,2120,5536,439,388,313,570,7246,2118,6636,448,460,306,555,8405,1187,378,426,291,516,2798,0.178872814948764,0.84375,0.926086956521739,0.950980392156863,0.92972972972973,0.332897085068412
E02001712,South Gosforth,Newcastle upon Tyne,North East,1551,6155,506,460,284,545,7950,1608,6836,547,505,311,572,8771,1432,470,466,296,534,3198,0.20947922761849,0.859232175502742,0.922772277227723,0.951768488745981,0.933566433566433,0.364610648728765
E02001713,Coxlodge & West Gosforth,Newcastle upon Tyne,North East,1923,6272,565,511,342,616,8306,1882,7000,587,533,384,593,9097,1695,518,493,361,549,3616,0.242142857142857,0.882453151618399,0.924953095684803,0.940104166666667,0.925801011804385,0.397493679234913
E02001714,High Heaton,Newcastle upon Tyne,North East,1782,6009,552,426,235,476,7698,1835,6779,575,506,262,462,8584,1491,519,478,246,435,3169,0.219943944534592,0.902608695652174,0.944664031620553,0.938931297709924,0.941558441558442,0.369175209692451
E02001715,Kenton,Newcastle upon Tyne,North East,2763,6998,482,450,264,492,8686,2747,8031,528,490,281,449,9779,1380,441,445,257,413,2936,0.171834142697049,0.835227272727273,0.908163265306122,0.914590747330961,0.919821826280624,0.300235197872993
E02001718,Blakelaw,Newcastle upon Tyne,North East,1306,3627,307,300,190,277,4701,1394,4426,325,314,216,276,5557,779,280,293,206,258,1816,0.176005422503389,0.861538461538462,0.93312101910828,0.953703703703704,0.934782608695652,0.326795033291344
E02001719,North Heaton,Newcastle upon Tyne,North East,1395,5470,451,417,295,492,7125,1392,6139,487,438,307,469,7840,1197,441,415,285,439,2777,0.194982896237172,0.905544147843943,0.947488584474886,0.928338762214984,0.936034115138593,0.354209183673469
E02001720,North Jesmond,Newcastle upon Tyne,North East,526,7980,225,219,132,217,8773,517,6812,269,245,152,208,7686,1247,231,222,144,195,2039,0.183059307105109,0.858736059479554,0.906122448979592,0.947368421052632,0.9375,0.265287535779339
E02001721,Throckley & Newburn,Newcastle upon Tyne,North East,1861,6194,538,629,433,666,8460,1904,6946,551,630,418,666,9211,1341,489,596,393,634,3453,0.193060754391016,0.887477313974592,0.946031746031746,0.940191387559809,0.951951951951952,0.374877863424167
E02001722,Denton,Newcastle upon Tyne,North East,2086,5802,442,480,345,770,7839,1963,5949,461,451,352,697,7910,1134,384,410,339,661,2928,0.190620272314675,0.832971800433839,0.909090909090909,0.963068181818182,0.948350071736012,0.370164348925411
E02001723,Cowgate,Newcastle upon Tyne,North East,1669,4040,259,202,167,302,4970,1740,4948,295,228,175,291,5937,829,239,199,158,259,1684,0.167542441390461,0.810169491525424,0.87280701754386,0.902857142857143,0.890034364261168,0.283644938521139
E02001724,South Jesmond & Sandyford,Newcastle upon Tyne,North East,453,7534,240,233,176,339,8522,439,6771,243,240,178,315,7747,1025,194,218,170,298,1905,0.151380889085807,0.798353909465021,0.908333333333333,0.955056179775281,0.946031746031746,0.245901639344262
E02001725,Heaton South,Newcastle upon Tyne,North East,954,8419,219,210,131,245,9224,960,8573,241,224,141,207,9386,1161,183,206,132,184,1866,0.135425172051791,0.759336099585062,0.919642857142857,0.936170212765957,0.888888888888889,0.198806733432772
E02001726,Fenham,Newcastle upon Tyne,North East,2693,7772,477,458,298,470,9475,2642,8615,534,467,309,471,10396,1326,433,435,290,424,2908,0.1539175856065,0.810861423220974,0.931477516059957,0.938511326860841,0.900212314225053,0.27972297037322
E02001727,Walkergate,Newcastle upon Tyne,North East,1437,5288,468,459,314,429,6958,1471,5914,571,458,309,474,7726,998,473,422,302,447,2642,0.168752113628678,0.828371278458844,0.921397379912664,0.977346278317152,0.943037974683544,0.341962205539736
E02001728,Lemington,Newcastle upon Tyne,North East,1795,5654,541,524,351,497,7567,1766,6165,530,578,380,443,8096,1202,457,538,361,414,2972,0.194971613949716,0.862264150943396,0.930795847750865,0.95,0.934537246049661,0.367094861660079
E02001729,Nunsmoor,Newcastle upon Tyne,North East,2822,10556,260,183,118,230,11347,2922,14087,331,211,130,267,15026,970,212,170,104,232,1688,0.0688578121672464,0.640483383685801,0.805687203791469,0.8,0.868913857677903,0.112338613070678
E02001730,Shieldfield & Heaton Park,Newcastle upon Tyne,North East,908,18666,302,230,158,186,19542,840,17162,309,241,150,186,18048,1208,243,207,130,160,1948,0.0703880666588976,0.786407766990291,0.858921161825726,0.866666666666667,0.860215053763441,0.107934397163121
E02001731,City Centre & Arthur's Hill,Newcastle upon Tyne,North East,1421,19214,272,253,146,270,20155,1343,25249,337,269,161,258,26274,1176,247,231,127,220,2001,0.0465761020238425,0.732937685459941,0.858736059479554,0.788819875776398,0.852713178294574,0.076158940397351
E02001732,Scotswood,Newcastle upon Tyne,North East,1219,3161,332,258,150,215,4116,1245,3750,311,276,147,190,4674,625,246,248,134,180,1433,0.166666666666667,0.790996784565916,0.898550724637681,0.91156462585034,0.947368421052632,0.306589644843817
E02001733,Byker,Newcastle upon Tyne,North East,2398,8169,520,484,300,483,9956,2605,9306,574,495,329,470,11174,1255,453,431,304,430,2873,0.134859230603911,0.789198606271777,0.870707070707071,0.924012158054711,0.914893617021277,0.257114730624664
E02001734,Benwell,Newcastle upon Tyne,North East,2072,5150,345,354,223,373,6445,2054,6068,353,358,248,373,7400,852,282,321,236,349,2040,0.140408701384311,0.798866855524079,0.896648044692737,0.951612903225806,0.935656836461126,0.275675675675676
E02001735,Walker North,Newcastle upon Tyne,North East,1731,4065,259,244,167,267,5002,1642,4651,287,242,170,289,5639,738,215,216,155,269,1593,0.158675553644378,0.749128919860627,0.892561983471074,0.911764705882353,0.930795847750865,0.282496896612875
E02001736,Elswick,Newcastle upon Tyne,North East,3958,9383,433,322,203,339,10680,4273,12626,490,387,204,326,14033,1135,319,297,179,267,2197,0.0898938697924917,0.651020408163265,0.767441860465116,0.877450980392157,0.819018404907976,0.156559538231312
E02001737,Walker South,Newcastle upon Tyne,North East,1279,3643,284,301,197,333,4758,1339,4264,299,288,189,291,5331,660,243,258,169,261,1591,0.154784240150094,0.812709030100334,0.895833333333333,0.894179894179894,0.896907216494845,0.298443068842619
E02006893,Westerhope,Newcastle upon Tyne,North East,1566,5667,735,850,591,863,8706,1570,6243,730,880,663,934,9450,1253,658,843,647,893,4294,0.200704789364088,0.901369863013699,0.957954545454546,0.975867269984917,0.95610278372591,0.454391534391534
E02001738,Whitley Bay North,North Tyneside,North East,972,3070,478,559,364,613,5084,1068,3398,454,528,419,598,5397,601,414,508,412,583,2518,0.176868746321366,0.911894273127753,0.962121212121212,0.983293556085919,0.974916387959866,0.466555493792848
E02001739,Fordley,North Tyneside,North East,1187,4454,523,512,295,332,6116,1165,4711,487,530,327,376,6431,925,421,507,316,356,2525,0.196348970494587,0.864476386036961,0.956603773584906,0.966360856269113,0.946808510638298,0.392629451096253
E02001740,Whitley Sands,North Tyneside,North East,1320,3453,316,383,227,357,4736,1279,3667,318,367,255,385,4992,636,282,350,246,380,1894,0.173438778292882,0.886792452830189,0.953678474114441,0.964705882352941,0.987012987012987,0.379407051282051
E02001741,Wideopen & Seaton Burn,North Tyneside,North East,1220,4353,548,576,393,677,6547,1182,4526,543,605,392,655,6721,891,482,575,384,629,2961,0.196862571807335,0.887661141804788,0.950413223140496,0.979591836734694,0.96030534351145,0.440559440559441
E02001742,West Monkseaton,North Tyneside,North East,969,3441,404,429,269,398,4941,939,3609,395,444,317,414,5179,635,353,425,309,400,2122,0.175949016348019,0.893670886075949,0.957207207207207,0.974763406940063,0.966183574879227,0.409731608418614
E02001743,Whitley Bay Promenade,North Tyneside,North East,1450,4916,406,385,230,312,6249,1397,5199,440,418,250,355,6662,901,367,378,231,329,2206,0.173302558184266,0.834090909090909,0.904306220095694,0.924,0.926760563380282,0.331131792254578
E02001744,Shiremoor North & South Wellfield,North Tyneside,North East,1540,4607,374,347,217,410,5955,1569,5166,376,373,233,395,6543,955,318,349,224,380,2226,0.184862562911343,0.845744680851064,0.935656836461126,0.96137339055794,0.962025316455696,0.340210912425493
E02001745,Killingworth West & Camperdown,North Tyneside,North East,1274,4122,342,405,180,293,5342,1316,4305,383,377,235,265,5565,850,330,359,221,259,2019,0.197444831591173,0.861618798955614,0.952254641909814,0.940425531914894,0.977358490566038,0.362803234501348
E02001746,Monkseaton,North Tyneside,North East,1607,4994,483,429,318,463,6687,1498,5330,438,484,318,488,7058,888,373,456,303,467,2487,0.166604127579737,0.851598173515982,0.942148760330578,0.952830188679245,0.956967213114754,0.352366109379428
E02001747,Cullercoats,North Tyneside,North East,950,3455,435,446,356,580,5272,985,3617,441,464,345,619,5486,656,383,441,338,604,2422,0.18136577273984,0.868480725623583,0.950431034482759,0.979710144927536,0.975767366720517,0.441487422530077
E02001748,Shiremoor South & West Allotment,North Tyneside,North East,1839,5397,381,359,185,269,6591,1796,5739,409,373,196,299,7016,845,349,349,185,289,2017,0.147238194807458,0.853300733496333,0.935656836461126,0.943877551020408,0.966555183946488,0.28748574686431
E02001749,Killingworth East,North Tyneside,North East,1028,3850,457,415,250,358,5330,1093,3911,435,470,239,384,5439,691,377,448,231,366,2113,0.176681155714651,0.866666666666667,0.953191489361702,0.96652719665272,0.953125,0.388490531347674
E02001750,Preston Grange,North Tyneside,North East,1190,4009,434,421,325,500,5689,1176,4186,460,439,314,552,5951,786,388,419,301,532,2426,0.187768752986144,0.843478260869565,0.954441913439636,0.95859872611465,0.963768115942029,0.407662577718031
E02001751,Forest Hall & West Moor,North Tyneside,North East,1106,3763,342,348,208,378,5039,1131,4220,370,344,249,368,5551,811,319,320,242,358,2050,0.19218009478673,0.862162162162162,0.930232558139535,0.971887550200803,0.972826086956522,0.369302828319222
E02001752,New York,North Tyneside,North East,1329,3851,365,346,212,327,5101,1346,4148,336,319,217,322,5342,706,273,289,202,306,1776,0.170202507232401,0.8125,0.905956112852665,0.930875576036866,0.950310559006211,0.332459752901535
E02001753,Tynemouth Priory,North Tyneside,North East,970,3815,479,377,253,406,5330,931,3799,446,443,274,402,5364,642,367,407,261,380,2057,0.168991839957884,0.822869955156951,0.918735891647855,0.952554744525547,0.945273631840796,0.383482475764355
E02001754,Tynemouth West,North Tyneside,North East,877,3612,345,344,278,422,5001,838,3652,386,364,276,425,5103,640,330,355,266,409,2000,0.175246440306681,0.854922279792746,0.975274725274725,0.963768115942029,0.962352941176471,0.391926317852244
E02001755,Holystone & Benton,North Tyneside,North East,1704,5733,452,469,309,508,7471,1779,6145,514,478,341,496,7974,1174,449,451,326,485,2885,0.191049633848657,0.873540856031129,0.943514644351465,0.956011730205279,0.977822580645161,0.361800852771507
E02001756,Longbenton,North Tyneside,North East,1800,6259,420,341,263,440,7723,1806,6583,469,380,265,403,8100,1234,406,356,256,382,2634,0.187452529241987,0.865671641791045,0.936842105263158,0.966037735849057,0.947890818858561,0.325185185185185
E02001757,Preston Billy Mill,North Tyneside,North East,915,3463,378,395,243,410,4889,872,3722,386,399,248,398,5153,688,315,367,238,387,1995,0.184846856528748,0.816062176165803,0.919799498746867,0.959677419354839,0.972361809045226,0.387153114690472
E02001758,Battle Hill East,North Tyneside,North East,1019,3412,410,350,184,169,4525,1041,3542,396,386,227,185,4736,662,349,369,217,176,1773,0.186900056465274,0.881313131313131,0.955958549222798,0.955947136563877,0.951351351351351,0.374366554054054
E02001759,North Shields,North Tyneside,North East,803,4092,368,345,217,326,5348,807,4196,367,339,223,361,5486,692,276,300,208,332,1808,0.164918970448046,0.752043596730245,0.88495575221239,0.932735426008969,0.919667590027701,0.329566168428728
E02001760,Chirton,North Tyneside,North East,1867,5003,272,283,209,271,6038,1899,5335,337,278,199,259,6408,773,260,255,191,239,1718,0.144892221180881,0.771513353115727,0.91726618705036,0.959798994974874,0.922779922779923,0.268102372034956
E02001761,Battle Hill West,North Tyneside,North East,841,3246,327,336,281,349,4539,893,3423,365,353,284,370,4795,715,334,334,271,352,2006,0.208881098451651,0.915068493150685,0.946175637393768,0.954225352112676,0.951351351351351,0.418352450469239
E02001762,East Benton,North Tyneside,North East,971,3856,426,339,198,227,5046,1144,4112,464,351,226,226,5379,864,416,334,217,213,2044,0.21011673151751,0.896551724137931,0.951566951566952,0.960176991150442,0.942477876106195,0.379996281836773
E02001763,Howdon,North Tyneside,North East,1144,4044,384,340,177,273,5218,1140,4317,372,337,222,262,5510,861,319,321,207,251,1959,0.199444058373871,0.85752688172043,0.952522255192878,0.932432432432432,0.958015267175572,0.355535390199637
E02001764,Percy Main,North Tyneside,North East,1400,5188,426,317,192,303,6426,1416,5285,441,368,205,320,6619,798,320,339,190,291,1938,0.150993377483444,0.72562358276644,0.921195652173913,0.926829268292683,0.909375,0.292793473334341
E02001765,Willington Quay,North Tyneside,North East,1674,4940,353,278,218,327,6116,1599,5024,409,306,227,324,6290,845,340,289,217,307,1998,0.168192675159236,0.831295843520783,0.944444444444444,0.955947136563877,0.947530864197531,0.317647058823529
E02001766,Wallsend East,North Tyneside,North East,1473,5182,279,283,163,181,6088,1383,5264,351,289,169,206,6279,845,300,260,160,192,1757,0.160524316109423,0.854700854700855,0.899653979238754,0.946745562130177,0.932038834951456,0.279821627647715
E02001767,Wallsend West,North Tyneside,North East,1154,4637,377,307,216,346,5883,1147,4753,402,351,264,338,6108,950,357,323,261,318,2209,0.199873763938565,0.888059701492537,0.92022792022792,0.988636363636364,0.940828402366864,0.361656843483956
E02001768,South Shields East,South Tyneside,North East,1495,5588,446,388,257,344,7023,1438,6035,508,407,297,325,7572,1354,413,377,279,301,2724,0.224357912178956,0.812992125984252,0.926289926289926,0.939393939393939,0.926153846153846,0.359746434231379
E02001769,South Shields West,South Tyneside,North East,1304,5668,427,367,205,294,6961,1267,6918,454,364,218,298,8252,1269,374,340,202,265,2450,0.183434518647008,0.823788546255507,0.934065934065934,0.926605504587156,0.889261744966443,0.296897721764421
E02001770,Westoe,South Tyneside,North East,832,4391,366,322,211,365,5655,815,4817,371,329,240,353,6110,1018,323,311,233,334,2219,0.211334855719327,0.870619946091644,0.945288753799392,0.970833333333333,0.946175637393768,0.363175122749591
E02001771,Horsley Hill,South Tyneside,North East,1263,3712,391,359,269,587,5318,1217,3931,411,371,283,439,5435,980,378,349,271,410,2388,0.249300432459934,0.91970802919708,0.940700808625337,0.957597173144876,0.933940774487471,0.439374425022999
E02001772,West Park,South Tyneside,North East,897,3357,312,330,213,378,4590,828,3561,309,305,242,382,4799,863,273,287,232,362,2017,0.242347655153047,0.883495145631068,0.940983606557377,0.958677685950413,0.947643979057592,0.42029589497812
E02001773,Harton West,South Tyneside,North East,763,3050,404,403,250,410,4517,747,3198,426,426,297,432,4779,858,392,408,283,417,2358,0.268292682926829,0.92018779342723,0.957746478873239,0.952861952861953,0.965277777777778,0.493408662900188
E02001774,Jarrow Town,South Tyneside,North East,1015,3498,311,326,199,214,4548,957,3604,325,316,217,228,4690,710,288,296,196,216,1706,0.19700332963374,0.886153846153846,0.936708860759494,0.903225806451613,0.947368421052632,0.363752665245203
E02001775,Harton East,South Tyneside,North East,1092,3314,329,305,192,318,4458,1082,3563,319,337,209,354,4782,858,289,320,199,337,2003,0.24080830760595,0.905956112852665,0.949554896142433,0.952153110047847,0.951977401129944,0.418862400669176
E02001776,Hebburn North,South Tyneside,North East,1664,5655,461,372,252,382,7122,1737,6009,505,396,218,422,7550,1155,440,371,212,407,2585,0.192211682476286,0.871287128712871,0.936868686868687,0.972477064220184,0.964454976303318,0.342384105960265
E02001777,Hebburn West,South Tyneside,North East,1074,4100,341,302,189,296,5228,1067,4448,346,348,201,296,5639,831,308,323,193,280,1935,0.186825539568345,0.890173410404624,0.92816091954023,0.960199004975124,0.945945945945946,0.343145947863096
E02001778,West Harton,South Tyneside,North East,904,3928,305,295,202,298,5028,878,4041,323,310,188,305,5167,1036,282,288,177,288,2071,0.256372185102697,0.873065015479876,0.929032258064516,0.941489361702128,0.944262295081967,0.40081285078382
E02001779,Simonside,South Tyneside,North East,1074,3465,327,330,176,275,4573,1016,3606,338,315,197,274,4730,922,297,300,190,258,1967,0.255684969495286,0.878698224852071,0.952380952380952,0.964467005076142,0.941605839416058,0.415856236786469
E02001780,Cleadon Park,South Tyneside,North East,1134,3560,351,386,241,346,4884,1174,3862,342,391,281,343,5219,950,307,376,275,322,2230,0.245986535473848,0.89766081871345,0.961636828644501,0.97864768683274,0.938775510204082,0.427284920482851
E02001781,Brockley Whins,South Tyneside,North East,1092,3335,299,254,143,255,4286,1112,3513,301,262,135,228,4439,870,265,235,127,215,1712,0.247651579846285,0.880398671096346,0.896946564885496,0.940740740740741,0.942982456140351,0.385672448749718
E02001782,Hebburn South,South Tyneside,North East,1987,5787,541,446,318,562,7654,2043,6378,563,475,330,565,8311,1205,504,446,314,525,2994,0.188930699278771,0.895204262877442,0.938947368421053,0.951515151515152,0.929203539823009,0.360245457826976
E02001783,Biddick Hill,South Tyneside,North East,1770,4374,354,255,185,272,5440,1838,4809,340,296,173,266,5884,1187,302,281,160,249,2179,0.246828862549387,0.888235294117647,0.949324324324324,0.92485549132948,0.93609022556391,0.370326308633583
E02001784,Primrose,South Tyneside,North East,1192,4050,413,340,267,373,5443,1189,4264,390,353,290,381,5678,883,356,322,273,354,2188,0.207082551594747,0.912820512820513,0.912181303116147,0.941379310344828,0.929133858267716,0.385346953152519
E02001785,Whitburn & Marsden,South Tyneside,North East,1307,4539,525,545,373,506,6488,1280,4654,519,550,393,523,6639,1168,448,527,372,483,2998,0.250966910184787,0.863198458574181,0.958181818181818,0.946564885496183,0.923518164435946,0.45157403223377
E02001786,Whiteleas,South Tyneside,North East,1219,4224,374,333,236,418,5585,1192,4424,416,351,228,407,5826,1271,368,332,219,379,2569,0.287296564195298,0.884615384615385,0.945868945868946,0.960526315789474,0.931203931203931,0.440954342602128
E02001787,Fellgate & Hedworth,South Tyneside,North East,1009,3160,345,431,230,231,4397,988,3333,343,431,267,279,4653,805,309,418,254,266,2052,0.241524152415242,0.900874635568513,0.969837587006961,0.951310861423221,0.953405017921147,0.44100580270793
E02001788,Boldon Colliery,South Tyneside,North East,1009,3737,356,296,188,260,4837,1024,3900,399,339,177,288,5103,950,366,329,170,274,2089,0.243589743589744,0.917293233082707,0.970501474926254,0.96045197740113,0.951388888888889,0.409367038996669
E02001789,Cleadon & East Boldon,South Tyneside,North East,906,3137,408,440,311,475,4771,892,3393,387,454,329,507,5070,889,354,431,306,478,2458,0.26201002063071,0.914728682170543,0.949339207048458,0.930091185410334,0.942800788954635,0.484812623274162
E02001790,West Boldon,South Tyneside,North East,1068,3684,369,343,265,439,5100,1024,3670,372,380,255,455,5132,981,348,359,246,436,2370,0.267302452316076,0.935483870967742,0.944736842105263,0.964705882352941,0.958241758241758,0.461808261886204
E02001791,Fulwell,Sunderland,North East,819,3380,280,359,275,407,4701,796,3447,313,332,261,437,4790,743,289,317,252,425,2026,0.215549753408761,0.92332268370607,0.954819277108434,0.96551724137931,0.97254004576659,0.422964509394572
E02001792,Seaburn,Sunderland,North East,865,3960,454,461,348,618,5841,847,4282,507,475,349,631,6244,929,468,452,338,609,2796,0.216954694068192,0.923076923076923,0.951578947368421,0.968481375358166,0.96513470681458,0.447789878283152
E02001793,Town End Farm,Sunderland,North East,1767,5262,319,312,199,420,6512,1763,5601,385,309,207,382,6884,1110,337,292,195,360,2294,0.198178896625603,0.875324675324675,0.944983818770227,0.942028985507246,0.942408376963351,0.333236490412551
E02001794,Hylton Red House & Marley Pots,Sunderland,North East,1804,5290,444,369,350,524,6977,1819,5742,473,404,334,545,7498,1149,410,382,319,508,2768,0.200104493207941,0.866807610993658,0.945544554455445,0.955089820359282,0.932110091743119,0.369165110696186
E02001795,Southwick,Sunderland,North East,1323,4620,459,394,264,396,6133,1304,4872,486,445,272,386,6461,953,440,415,254,367,2429,0.195607553366174,0.905349794238683,0.932584269662921,0.933823529411765,0.950777202072539,0.375947995666306
E02001796,Monkwearmouth,Sunderland,North East,1225,6408,587,519,397,556,8467,1147,6526,548,580,372,599,8625,1096,484,547,356,563,3046,0.167943610174686,0.883211678832117,0.943103448275862,0.956989247311828,0.939899833055092,0.353159420289855
E02001797,Springwell & Usworth,Sunderland,North East,934,3496,422,407,251,291,4867,887,3663,406,456,278,349,5152,610,362,432,273,331,2008,0.166530166530167,0.891625615763547,0.947368421052632,0.982014388489209,0.948424068767908,0.389751552795031
E02001798,North Hylton,Sunderland,North East,1581,5151,473,376,273,387,6660,1575,5496,482,404,285,375,7042,1137,421,375,273,353,2559,0.206877729257642,0.87344398340249,0.928217821782178,0.957894736842105,0.941333333333333,0.363391082078955
E02001799,Concord and Sulgrave,Sunderland,North East,2069,6063,481,422,239,444,7649,1937,6348,511,457,270,440,8026,768,439,430,255,408,2300,0.120982986767486,0.859099804305284,0.940919037199125,0.944444444444444,0.927272727272727,0.286568651881385
E02001800,Albany and Blackfell,Sunderland,North East,1257,4190,495,468,237,195,5585,1130,4348,481,505,250,259,5843,667,437,488,241,253,2086,0.153403863845446,0.908523908523908,0.966336633663366,0.964,0.976833976833977,0.357008386103029
E02001801,Millfield,Sunderland,North East,1109,4793,260,227,105,213,5598,1179,5463,278,239,112,188,6280,962,218,215,100,168,1663,0.176093721398499,0.784172661870504,0.899581589958159,0.892857142857143,0.893617021276596,0.264808917197452
E02001802,Pallion North,Sunderland,North East,1654,4225,323,281,200,265,5294,1640,4872,325,315,209,316,6037,1136,286,291,194,298,2205,0.233169129720854,0.88,0.923809523809524,0.92822966507177,0.943037974683544,0.365247639556071
E02001803,Sunderland Central & Deptford,Sunderland,North East,1177,7705,364,286,180,312,8847,1168,8382,385,322,183,295,9567,1074,278,274,164,261,2051,0.128131710808876,0.722077922077922,0.850931677018634,0.896174863387978,0.884745762711864,0.214382774119369
E02001804,South Hylton,Sunderland,North East,1145,4091,317,378,248,360,5394,1089,4164,338,341,256,376,5475,1177,297,324,254,351,2403,0.282660902977906,0.878698224852071,0.950146627565982,0.9921875,0.933510638297872,0.438904109589041
E02001805,Pallion South & High Barnes,Sunderland,North East,840,3493,360,304,296,488,4941,792,3572,377,338,261,481,5029,919,334,317,248,461,2279,0.257278835386338,0.885941644562334,0.937869822485207,0.950191570881226,0.958419958419958,0.453171604692782
E02001806,Hendon & Docks,Sunderland,North East,1408,5453,428,351,209,334,6775,1452,6089,454,410,243,340,7536,1067,386,368,222,306,2349,0.175234028576121,0.850220264317181,0.897560975609756,0.91358024691358,0.9,0.311703821656051
E02001807,"Columbia, Barmston & Teal Farm",Sunderland,North East,1753,4956,430,448,229,272,6335,1833,5452,473,470,269,337,7001,825,420,435,260,321,2261,0.151320616287601,0.887949260042283,0.925531914893617,0.966542750929368,0.952522255192878,0.322953863733752
E02001808,Barnes Park,Sunderland,North East,1088,3990,254,256,170,268,4938,1121,4423,311,241,176,277,5428,839,273,217,164,252,1745,0.189690255482704,0.877813504823151,0.900414937759336,0.931818181818182,0.909747292418773,0.321481208548268
E02001809,Washington Town Centre & Biddick,Sunderland,North East,1094,3600,540,560,306,331,5337,1117,3845,525,577,335,351,5633,647,471,551,325,343,2337,0.168270481144343,0.897142857142857,0.954939341421144,0.970149253731343,0.977207977207977,0.414876619918338
E02001810,Oxclose and Lambton,Sunderland,North East,1404,5331,657,495,244,238,6965,1334,5444,661,591,288,265,7249,873,589,569,274,256,2561,0.160360029390154,0.8910741301059,0.962774957698816,0.951388888888889,0.966037735849057,0.353290108980549
E02001811,Pennywell and Grindon,Sunderland,North East,1766,5504,467,477,308,447,7203,1699,5770,451,482,345,451,7499,1364,395,470,333,434,2996,0.236395147313692,0.875831485587583,0.975103734439834,0.965217391304348,0.962305986696231,0.399519935991466
E02001812,Hill View & Tunstall,Sunderland,North East,1450,5953,707,712,497,777,8646,1362,6236,731,733,523,833,9056,1403,670,703,512,791,4079,0.224983964079538,0.916552667578659,0.959072305593452,0.978967495219885,0.949579831932773,0.450419611307421
E02001813,Thorney Close & Plains Farm,Sunderland,North East,2105,6248,395,452,275,340,7710,2121,6710,389,432,311,400,8242,1556,343,405,295,373,2972,0.231892697466468,0.881748071979435,0.9375,0.948553054662379,0.9325,0.360592089298714
E02001814,Grangetown,Sunderland,North East,1138,3867,347,288,220,325,5047,1095,4118,350,331,207,355,5361,980,325,311,192,337,2145,0.237979601748422,0.928571428571429,0.939577039274924,0.927536231884058,0.949295774647887,0.400111919418019
E02001815,"Harraton, Rickleton & Fatfield",Sunderland,North East,1653,5900,810,738,432,411,8291,1557,6249,867,801,485,493,8895,1032,794,772,466,474,3538,0.165146423427748,0.915801614763553,0.963795255930087,0.960824742268041,0.961460446247465,0.397751545812254
E02001816,Lakeside & Farrington,Sunderland,North East,1119,4146,452,380,311,486,5775,1143,4372,445,445,277,474,6013,1127,415,422,267,446,2677,0.257776761207685,0.932584269662921,0.948314606741573,0.963898916967509,0.940928270042194,0.44520206219857
E02001817,Silksworth,Sunderland,North East,1219,3987,341,338,269,418,5353,1228,4310,399,319,269,401,5698,1231,368,309,260,386,2554,0.285614849187935,0.922305764411028,0.968652037617555,0.966542750929368,0.962593516209476,0.448227448227448
E02001818,Ryhope,Sunderland,North East,1845,5820,468,375,246,433,7342,1837,6149,504,374,262,435,7724,1650,457,361,253,419,3140,0.268336314847943,0.906746031746032,0.96524064171123,0.965648854961832,0.963218390804598,0.406525116519938
E02001819,Herrington & Doxford,Sunderland,North East,899,3844,512,549,367,496,5768,912,4143,523,574,403,573,6216,1047,495,545,398,552,3037,0.252715423606083,0.946462715105163,0.949477351916376,0.987593052109181,0.963350785340314,0.488577863577864
E02001820,Shiney Row,Sunderland,North East,1843,5719,474,454,323,391,7361,1896,6218,504,505,329,478,8034,1105,454,473,314,457,2803,0.177709874557736,0.900793650793651,0.936633663366337,0.954407294832827,0.956066945606695,0.348892208115509
E02001821,Hall Farm,Sunderland,North East,864,3595,356,309,182,233,4675,859,3845,378,329,186,274,5012,1101,340,318,184,261,2204,0.286345903771131,0.899470899470899,0.966565349544073,0.989247311827957,0.952554744525547,0.43974461292897
E02001822,Newbottle & Penshaw,Sunderland,North East,1265,4959,430,375,259,327,6350,1250,5054,446,425,277,370,6572,911,391,407,268,357,2334,0.180253264740799,0.876681614349776,0.957647058823529,0.967509025270758,0.964864864864865,0.355143031040779
E02001823,Houghton West,Sunderland,North East,1562,4821,406,363,241,339,6170,1573,5233,437,387,247,335,6639,946,389,373,238,317,2263,0.180775845595261,0.890160183066362,0.963824289405685,0.963562753036437,0.946268656716418,0.340864588040368
E02001824,Houghton Town,Sunderland,North East,1555,5076,533,524,394,579,7106,1554,5275,496,542,435,623,7371,903,461,524,429,599,2916,0.171184834123223,0.929435483870968,0.966789667896679,0.986206896551724,0.961476725521669,0.395604395604396
E02001825,Hetton-le-Hole North,Sunderland,North East,1036,4332,457,520,343,546,6198,1096,4659,472,501,411,550,6593,999,429,472,399,530,2829,0.214423696072118,0.908898305084746,0.942115768463074,0.970802919708029,0.963636363636364,0.429091460640073
E02001826,Hetton-le-Hole South,Sunderland,North East,1599,4400,393,396,234,237,5660,1570,4696,376,408,274,277,6031,965,332,379,264,261,2201,0.205494037478705,0.882978723404255,0.928921568627451,0.963503649635036,0.942238267148014,0.364947769855745
E02001682,Ryton,Gateshead,North East,1483,5060,492,530,334,543,6959,1500,5323,494,524,363,528,7232,775,406,503,351,509,2544,0.14559458951719,0.821862348178138,0.959923664122137,0.966942148760331,0.964015151515152,0.351769911504425
E02001683,Crawcrook & Greenside,Gateshead,North East,1462,5560,532,543,390,567,7592,1470,5725,569,590,445,576,7905,870,458,564,428,535,2855,0.151965065502183,0.804920913884007,0.95593220338983,0.961797752808989,0.928819444444444,0.361163820366856
E02001684,"Pelaw, Felling Shore & Bill Quay",Gateshead,North East,1207,4281,333,307,183,331,5435,1328,4542,350,320,184,329,5725,955,224,297,173,309,1958,0.210259797446059,0.64,0.928125,0.940217391304348,0.939209726443769,0.342008733624454
E02001685,Blaydon South,Gateshead,North East,1624,5145,316,405,279,407,6552,1578,5298,370,384,281,409,6742,704,286,352,259,377,1978,0.132880332200831,0.772972972972973,0.916666666666667,0.921708185053381,0.921760391198044,0.293384752299021
E02001686,Blaydon North & Winlaton Mill,Gateshead,North East,939,4047,423,399,386,477,5732,973,4172,442,409,375,524,5922,601,358,388,363,485,2195,0.14405560882071,0.809954751131222,0.948655256723716,0.968,0.925572519083969,0.37065180682202
E02001688,Dunston & Teams,Gateshead,North East,1329,5429,322,269,185,272,6477,1307,5543,307,289,176,258,6573,857,233,265,167,228,1750,0.15460941728306,0.758957654723127,0.916955017301038,0.948863636363636,0.883720930232558,0.266240681576145
E02001689,Bensham North,Gateshead,North East,1738,5888,355,327,186,334,7090,1800,6592,363,328,196,354,7833,907,266,296,183,333,1985,0.137591019417476,0.732782369146006,0.902439024390244,0.933673469387755,0.940677966101695,0.253415038937827
E02001690,Swalwell,Gateshead,North East,1204,4530,423,405,260,399,6017,1157,4580,442,420,260,426,6128,762,329,398,242,400,2131,0.166375545851528,0.744343891402715,0.947619047619048,0.930769230769231,0.938967136150235,0.347748041775457
E02001691,Bensham South & Saltwell,Gateshead,North East,1813,6767,287,232,158,301,7745,1796,7092,336,266,166,237,8097,1107,236,246,151,214,1954,0.156091370558376,0.702380952380952,0.924812030075188,0.909638554216867,0.90295358649789,0.241323947140916
E02001692,Mount Pleasant & Deckham East,Gateshead,North East,1441,4118,301,234,132,206,4991,1422,4375,260,253,137,203,5228,954,163,234,127,189,1667,0.218057142857143,0.626923076923077,0.924901185770751,0.927007299270073,0.931034482758621,0.318859984697781
E02001693,Felling South,Gateshead,North East,1022,3423,323,302,205,369,4622,888,3594,335,313,203,334,4779,917,220,294,195,314,1940,0.255147468002226,0.656716417910448,0.939297124600639,0.960591133004926,0.940119760479042,0.405942665829672
E02001694,Dunston Hill,Gateshead,North East,1075,4142,324,356,242,320,5384,1034,4109,362,346,253,349,5419,702,291,331,238,322,1884,0.170844487709905,0.803867403314917,0.956647398843931,0.940711462450593,0.922636103151862,0.347665620963277
E02001695,Wardley,Gateshead,North East,980,3750,412,349,232,415,5158,873,3649,417,363,257,347,5033,847,317,354,251,331,2100,0.232118388599616,0.760191846522782,0.975206611570248,0.976653696498054,0.953890489913545,0.417246175243394
E02001696,Heworth,Gateshead,North East,1839,5558,540,472,240,504,7314,1773,6029,521,517,285,523,7875,1497,339,484,274,487,3081,0.24829988389451,0.650671785028791,0.936170212765957,0.96140350877193,0.931166347992352,0.391238095238095
E02001697,Low Fell East,Gateshead,North East,1202,4669,412,415,286,420,6202,1204,4977,439,440,296,470,6622,1314,353,427,288,460,2842,0.264014466546112,0.804100227790433,0.970454545454546,0.972972972972973,0.978723404255319,0.429175475687104
E02001698,Whickham,Gateshead,North East,1003,3602,504,701,501,700,6008,975,3766,525,692,485,771,6239,657,417,671,470,741,2956,0.174455655868295,0.794285714285714,0.969653179190751,0.969072164948454,0.961089494163424,0.473793877223914
E02001699,Windy Nook & Whitehills,Gateshead,North East,1096,4171,400,329,298,403,5601,1074,4238,421,370,264,426,5719,1166,290,348,259,411,2474,0.275129778197263,0.688836104513064,0.940540540540541,0.981060606060606,0.964788732394366,0.432593110683686
E02001700,Sunniside & Lobley Hill,Gateshead,North East,1777,6194,611,603,408,600,8416,1742,6454,608,688,436,557,8743,1239,470,659,419,529,3316,0.191973969631236,0.773026315789474,0.957848837209302,0.961009174311927,0.949730700179533,0.379274848450189
E02001701,Low Fell West,Gateshead,North East,947,3683,374,437,349,520,5363,957,3816,390,445,339,518,5508,937,316,435,329,502,2519,0.245545073375262,0.81025641025641,0.97752808988764,0.970501474926254,0.969111969111969,0.457334785766158
E02001702,Beacon Lough & Wrekenton,Gateshead,North East,1687,4874,335,355,238,419,6221,1639,5345,358,362,228,403,6696,1178,256,341,219,371,2365,0.220392890551918,0.715083798882682,0.941988950276243,0.960526315789474,0.920595533498759,0.353195937873357
E02001703,Rowlands Gill & Lockhaugh,Gateshead,North East,855,3074,375,429,313,436,4627,826,3301,369,430,321,456,4877,547,312,404,305,425,1993,0.165707361405635,0.845528455284553,0.93953488372093,0.950155763239875,0.932017543859649,0.408652860364979
E02001704,Easedale Gardens,Gateshead,North East,1096,4334,256,344,330,483,5747,1107,4576,294,316,301,526,6013,1106,223,298,284,503,2414,0.241695804195804,0.758503401360544,0.943037974683544,0.943521594684385,0.956273764258555,0.401463495759188
E02001705,Chopwell & High Spen,Gateshead,North East,1180,4198,457,458,266,410,5789,1110,4306,478,459,294,386,5923,822,389,427,280,351,2269,0.190896423594984,0.813807531380753,0.930283224400871,0.952380952380952,0.909326424870466,0.383082897180483
E02001706,Birtley North & Kibblesworth,Gateshead,North East,1623,4718,421,378,303,349,6169,1569,4730,416,391,267,360,6164,1107,337,375,255,351,2425,0.234038054968288,0.810096153846154,0.959079283887468,0.955056179775281,0.975,0.393413367942894
E02001707,Birtley South,Gateshead,North East,1356,4805,439,536,380,594,6754,1326,5185,490,507,399,623,7204,1345,385,488,389,592,3199,0.259402121504339,0.785714285714286,0.962524654832347,0.974937343358396,0.95024077046549,0.444058856191005
E02006841,Gateshead Town,Gateshead,North East,928,7822,261,257,141,203,8684,984,7119,275,265,143,209,8011,938,178,236,130,186,1668,0.131760078662734,0.647272727272727,0.890566037735849,0.909090909090909,0.889952153110048,0.208213706154038
E02006842,Gateshead South,Gateshead,North East,1162,3441,207,205,147,338,4338,1132,3634,230,224,164,300,4552,649,165,207,156,291,1468,0.178591084204733,0.717391304347826,0.924107142857143,0.951219512195122,0.97,0.322495606326889
E02002574,Farnworth,Halton,North West,1639,5300,437,512,333,420,7002,1601,5557,442,537,368,428,7332,1444,410,492,363,400,3109,0.259852438366025,0.927601809954751,0.916201117318436,0.986413043478261,0.934579439252336,0.424031642116749
E02002575,Upton Rocks,Halton,North West,1739,6379,566,439,297,332,8013,1671,6453,556,512,313,374,8208,1698,521,484,286,361,3350,0.263133426313343,0.93705035971223,0.9453125,0.913738019169329,0.96524064171123,0.408138401559454
E02002576,Halton View,Halton,North West,1311,4476,464,405,261,424,6030,1309,4880,467,438,267,388,6440,1249,421,402,248,359,2679,0.25594262295082,0.901498929336188,0.917808219178082,0.928838951310862,0.925257731958763,0.415993788819876
E02002577,Hough Green,Halton,North West,1658,4588,400,319,275,391,5973,1589,4982,376,368,254,366,6346,1069,328,340,231,348,2316,0.214572460859093,0.872340425531915,0.923913043478261,0.909448818897638,0.950819672131147,0.364954301922471
E02002578,Victoria Park,Halton,North West,1750,5185,446,365,258,397,6651,1667,5584,427,386,253,356,7006,1322,382,355,236,329,2624,0.236747851002865,0.894613583138173,0.919689119170985,0.932806324110672,0.924157303370787,0.374536111904082
E02002579,Ditton,Halton,North West,1753,4858,397,361,237,332,6185,1761,5315,431,397,256,364,6763,1194,389,367,240,332,2522,0.224647224835372,0.902552204176334,0.924433249370277,0.9375,0.912087912087912,0.372911429838829
E02002580,Widnes Riverside,Halton,North West,1719,5304,304,265,183,271,6327,1828,5810,340,281,199,290,6920,1124,286,250,183,262,2105,0.193459552495697,0.841176470588235,0.889679715302491,0.919597989949749,0.903448275862069,0.304190751445087
E02002581,Hale Bank,Halton,North West,1250,4320,494,514,314,430,6072,1176,4471,463,529,355,488,6306,1037,416,496,345,462,2756,0.231939163498099,0.898488120950324,0.937618147448015,0.971830985915493,0.94672131147541,0.437044084998414
E02002582,"Sandymoor, Daresbury & Preston Brook",Halton,North West,1690,5658,527,415,206,290,7096,1726,6527,536,501,236,256,8056,1405,463,457,223,235,2783,0.215259690516317,0.863805970149254,0.912175648702595,0.944915254237288,0.91796875,0.345456802383317
E02002583,Halton Castlefield,Halton,North West,1755,4585,397,435,210,217,5844,1801,5151,407,407,245,220,6430,1032,298,376,224,207,2137,0.200349446709377,0.732186732186732,0.923832923832924,0.914285714285714,0.940909090909091,0.332348367029549
E02002584,Runcorn Halton Road,Halton,North West,1497,4480,403,380,253,390,5906,1456,4932,419,405,258,374,6388,1010,340,390,245,349,2334,0.204785077047851,0.81145584725537,0.962962962962963,0.949612403100775,0.933155080213904,0.365372573575454
E02002585,Runcorn Town & Westfield,Halton,North West,1911,6914,552,462,326,415,8669,1868,7389,567,497,333,363,9149,1383,453,457,310,336,2939,0.18717011774259,0.798941798941799,0.919517102615694,0.930930930930931,0.925619834710744,0.3212372936933
E02002586,"Grange, Halton Brook & Hallwood Park",Halton,North West,2340,6086,478,479,279,364,7686,2268,6813,490,492,291,356,8442,1338,383,446,260,341,2768,0.196389255834434,0.781632653061225,0.90650406504065,0.893470790378007,0.957865168539326,0.32788438758588
E02002587,Norton,Halton,North West,1487,3866,507,336,195,141,5045,1355,4365,488,417,189,158,5617,961,390,374,178,148,2051,0.220160366552119,0.799180327868853,0.896882494004796,0.941798941798942,0.936708860759494,0.365141534627025
E02002588,Halton Lea & Brookvale,Halton,North West,1520,4238,559,469,238,228,5732,1459,4771,502,491,243,274,6281,1008,396,445,218,257,2324,0.211276461957661,0.788844621513944,0.906313645621181,0.897119341563786,0.937956204379562,0.370004776309505
E02002589,Beechwood & Heath,Halton,North West,911,3431,580,573,320,345,5249,930,3697,576,610,352,385,5620,847,526,587,335,363,2658,0.22910467946984,0.913194444444444,0.962295081967213,0.951704545454545,0.942857142857143,0.472953736654804
E02002590,Culcheth West & Croft,Warrington,North West,1047,4724,350,395,345,449,6263,1052,5229,367,370,364,467,6797,983,328,344,346,457,2458,0.187990055459935,0.893732970027248,0.92972972972973,0.950549450549451,0.978586723768737,0.361630130940121
E02002591,Culcheth East & Hollins Green,Warrington,North West,1122,3675,417,437,312,488,5329,1102,4056,428,404,354,491,5733,943,377,384,326,463,2493,0.232495069033531,0.880841121495327,0.95049504950495,0.92090395480226,0.942973523421589,0.434850863422292
E02002592,Winwick & Burtonwood,Warrington,North West,1005,3728,329,420,394,468,5339,1002,4000,331,397,370,505,5603,962,305,372,349,457,2445,0.2405,0.921450151057402,0.937027707808564,0.943243243243243,0.904950495049505,0.436373371408174
E02002593,Locking Stumps,Warrington,North West,869,2972,342,341,220,215,4090,847,3356,403,320,242,252,4573,769,338,297,228,236,1868,0.229141835518474,0.838709677419355,0.928125,0.942148760330578,0.936507936507937,0.408484583424448
E02002594,Oakwood & Gorse Covert,Warrington,North West,967,3455,341,286,123,130,4335,1000,3953,363,315,159,129,4919,809,279,296,149,123,1656,0.204654692638502,0.768595041322314,0.93968253968254,0.937106918238994,0.953488372093023,0.336653791421021
E02002595,Hulme,Warrington,North West,2040,5354,272,235,183,238,6282,1916,5857,314,237,161,245,6814,1256,247,212,146,222,2083,0.21444425473792,0.786624203821656,0.894514767932489,0.906832298136646,0.906122448979592,0.305694159084238
E02002596,Houghton Green & Fearnhead,Warrington,North West,1222,4800,617,630,370,374,6791,1243,5185,643,643,405,379,7255,1214,565,611,385,366,3141,0.234136933461909,0.878693623639191,0.950233281493002,0.950617283950617,0.965699208443272,0.432942798070296
E02002597,Blackbrook,Warrington,North West,2275,5668,440,374,268,255,7005,2231,6399,433,412,300,297,7841,1430,353,378,276,276,2713,0.223472417565245,0.815242494226328,0.91747572815534,0.92,0.929292929292929,0.346001785486545
E02002598,Kingswood & Whittle Hall,Warrington,North West,2345,6965,347,295,133,187,7927,2457,7424,420,346,166,202,8558,1737,370,318,159,189,2773,0.233970905172414,0.880952380952381,0.919075144508671,0.957831325301205,0.935643564356436,0.324024304744099
E02002599,Callands & Old Hall,Warrington,North West,2262,7185,573,508,281,356,8903,2189,7765,628,545,345,392,9675,2001,559,508,327,359,3754,0.257694784288474,0.890127388535032,0.932110091743119,0.947826086956522,0.915816326530612,0.388010335917313
E02002600,Orford,Warrington,North West,1638,5802,438,316,337,418,7311,1748,6709,428,374,325,439,8275,1454,346,346,309,412,2867,0.216723803845581,0.808411214953271,0.925133689839572,0.950769230769231,0.938496583143508,0.346465256797583
E02002601,Padgate & Paddington,Warrington,North West,1613,5286,436,485,387,547,7141,1614,5923,447,503,433,525,7831,1371,391,475,415,510,3162,0.231470538578423,0.874720357941835,0.944333996023857,0.958429561200924,0.971428571428571,0.403779849316818
E02002602,Bewsey & Dallam,Warrington,North West,1974,5584,257,209,174,141,6365,2085,6369,265,253,144,159,7190,1420,206,224,132,141,2123,0.222954937980845,0.777358490566038,0.885375494071146,0.916666666666667,0.886792452830189,0.295271210013908
E02002603,Woolston,Warrington,North West,1123,4004,518,593,294,380,5789,1096,4529,499,565,365,390,6348,972,437,539,341,374,2663,0.214616913225878,0.875751503006012,0.953982300884956,0.934246575342466,0.958974358974359,0.41950220541903
E02002604,Great Sankey,Warrington,North West,1202,4297,457,545,419,457,6175,1212,4753,478,502,429,502,6664,1333,445,476,421,487,3162,0.280454449821166,0.930962343096234,0.948207171314741,0.981351981351981,0.970119521912351,0.474489795918367
E02002605,Hood Manor & Sankey Bridges,Warrington,North West,1751,5632,533,483,288,348,7284,1680,5979,546,528,299,364,7716,1622,487,492,286,343,3230,0.271282823214584,0.891941391941392,0.931818181818182,0.956521739130435,0.942307692307692,0.418610679108346
E02002606,Fairfield & Howley,Warrington,North West,2214,8381,351,366,237,432,9767,2118,8636,367,365,253,428,10049,1635,282,333,227,393,2870,0.189323761000463,0.768392370572207,0.912328767123288,0.897233201581028,0.918224299065421,0.28560055726938
E02002607,Central Warrington,Warrington,North West,1976,7732,471,513,417,512,9645,1893,8389,491,521,415,552,10368,1588,405,469,395,512,3369,0.189295506019788,0.824847250509165,0.900191938579655,0.951807228915663,0.927536231884058,0.32494212962963
E02002608,Penketh & Cuerdley,Warrington,North West,1194,4557,503,593,589,800,7042,1158,4775,468,574,566,848,7231,1406,429,555,552,820,3762,0.294450261780105,0.916666666666667,0.966898954703833,0.975265017667845,0.966981132075472,0.520259991702393
E02002609,Latchford,Warrington,North West,2182,6366,320,305,228,299,7518,2133,6698,363,322,197,331,7911,1451,299,291,183,312,2536,0.216631830397133,0.823691460055096,0.903726708074534,0.928934010152284,0.942598187311178,0.320566300088484
E02002610,Lymm,Warrington,North West,2650,7302,695,759,592,711,10059,2538,7928,707,715,632,812,10794,1750,636,675,609,789,4459,0.220736629667003,0.8995756718529,0.944055944055944,0.963607594936709,0.971674876847291,0.413099870298314
E02002611,Grappenhall,Warrington,North West,1408,4595,408,432,350,589,6374,1368,4980,414,435,351,627,6807,1147,369,409,342,594,2861,0.230321285140562,0.891304347826087,0.940229885057471,0.974358974358974,0.947368421052632,0.420302629645953
E02002612,Stockton Heath & Hillcliffe,Warrington,North West,1666,5405,482,517,374,686,7464,1615,6005,494,514,416,656,8085,1440,416,491,396,619,3362,0.239800166527893,0.842105263157895,0.955252918287938,0.951923076923077,0.94359756097561,0.415831787260359
E02002613,"Appleton Thorn, Stretton & Walton",Warrington,North West,1044,4039,383,361,278,350,5411,1158,4746,403,399,315,366,6229,1070,362,378,302,348,2460,0.225453013063633,0.898263027295285,0.947368421052632,0.958730158730159,0.950819672131147,0.394926954567346
E02002614,Appleton,Warrington,North West,850,3222,424,441,295,384,4766,891,3670,441,462,340,465,5378,931,405,439,327,446,2548,0.253678474114441,0.918367346938776,0.95021645021645,0.961764705882353,0.959139784946237,0.473782075120863
E02002615,"Roe Lee, Brownhill & Sunnybower",Blackburn with Darwen,North West,2535,6010,392,497,311,532,7742,2669,6878,422,497,365,577,8739,1219,336,458,342,543,2898,0.177231753416691,0.796208530805687,0.921529175050302,0.936986301369863,0.94107452339688,0.331616889804325
E02002616,Lammack & Revidge,Blackburn with Darwen,North West,2371,5243,368,324,245,340,6520,2516,6182,382,337,260,367,7528,1078,328,308,240,331,2285,0.174377224199288,0.858638743455497,0.913946587537092,0.923076923076923,0.901907356948229,0.303533475026567
E02002617,Little Harwood,Blackburn with Darwen,North West,2604,5796,299,206,143,213,6657,2795,7165,347,242,142,201,8097,855,233,192,121,159,1560,0.119330076762038,0.671469740634006,0.793388429752066,0.852112676056338,0.791044776119403,0.192663949610967
E02002618,Bastwell,Blackburn with Darwen,North West,1980,4759,301,165,85,200,5510,2204,5646,329,210,108,191,6484,710,250,166,86,156,1368,0.125752745306412,0.759878419452888,0.79047619047619,0.796296296296296,0.816753926701571,0.210980876002468
E02002619,Wensley Fold,Blackburn with Darwen,North West,2310,5704,326,232,168,257,6687,2625,6951,345,268,188,296,8048,808,245,212,157,251,1673,0.116242267299669,0.710144927536232,0.791044776119403,0.835106382978723,0.847972972972973,0.20787773359841
E02002620,Central Blackburn,Blackburn with Darwen,North West,1988,5959,360,228,160,209,6916,2143,6592,440,272,170,232,7706,808,294,222,140,200,1664,0.122572815533981,0.668181818181818,0.816176470588235,0.823529411764706,0.862068965517241,0.215935634570465
E02002621,Audley,Blackburn with Darwen,North West,2362,5520,284,203,113,132,6252,2432,6369,319,246,120,175,7229,628,196,183,89,126,1222,0.0986026063746271,0.614420062695925,0.74390243902439,0.741666666666667,0.72,0.16904136118412
E02002622,Shadsworth & Intack,Blackburn with Darwen,North West,3073,6491,394,317,197,242,7641,3227,7597,409,324,198,257,8785,896,284,280,172,235,1867,0.117941292615506,0.694376528117359,0.864197530864198,0.868686868686869,0.914396887159533,0.212521343198634
E02002623,"Witton, Mill Hill & Hollin Bank",Blackburn with Darwen,North West,2481,6640,385,348,263,346,7982,2595,7698,400,397,243,331,9069,1247,304,359,222,308,2440,0.161990127305794,0.76,0.904282115869018,0.91358024691358,0.930513595166163,0.269048406660051
E02002624,"Beardwood, Pleasington & Livesey",Blackburn with Darwen,North West,1319,4857,480,561,390,613,6901,1429,5321,520,549,442,617,7449,1232,473,521,427,590,3243,0.231535425671866,0.909615384615385,0.948998178506375,0.96606334841629,0.956239870340356,0.435360451067257
E02002625,Queen's Park & Higher Croft,Blackburn with Darwen,North West,2334,6220,369,344,217,251,7401,2493,7154,416,379,226,270,8445,1267,330,338,202,249,2386,0.177103718199609,0.793269230769231,0.891820580474934,0.893805309734513,0.922222222222222,0.282534043812907
E02002626,Meadowhead,Blackburn with Darwen,North West,1482,4187,387,417,254,394,5639,1565,4862,406,422,265,407,6362,986,346,396,254,382,2364,0.202797202797203,0.852216748768473,0.938388625592417,0.958490566037736,0.938574938574938,0.371581263753537
E02002627,Ewood & Fernhurst,Blackburn with Darwen,North West,1665,5072,277,299,165,209,6022,1554,5230,309,290,198,189,6216,1119,277,269,185,175,2025,0.21395793499044,0.896440129449838,0.927586206896552,0.934343434343434,0.925925925925926,0.325772200772201
E02002628,North Darwen,Blackburn with Darwen,North West,1248,4142,362,379,239,306,5428,1258,4729,380,385,256,319,6069,938,327,355,240,297,2157,0.198350602664411,0.860526315789474,0.922077922077922,0.9375,0.931034482758621,0.355412753336629
E02002629,East Darwen,Blackburn with Darwen,North West,1237,3588,285,222,184,196,4475,1275,4091,311,217,170,209,4998,730,254,195,156,197,1532,0.178440479100464,0.816720257234727,0.898617511520737,0.917647058823529,0.942583732057416,0.306522609043617
E02002630,Darwen Town,Blackburn with Darwen,North West,1294,4021,312,259,189,278,5059,1211,4369,285,276,178,321,5429,872,231,248,166,304,1821,0.199588006408789,0.810526315789474,0.898550724637681,0.932584269662921,0.947040498442368,0.335420887824645
E02002631,South Darwen & Whitehall,Blackburn with Darwen,North West,1344,5295,520,562,328,359,7064,1449,5921,513,623,345,379,7781,1275,450,582,328,362,2997,0.215335247424422,0.87719298245614,0.934189406099519,0.950724637681159,0.955145118733509,0.3851690014137
E02002632,"Tockholes, Edgworth & Hoddlesden",Blackburn with Darwen,North West,960,3831,442,451,244,245,5213,960,3979,486,450,328,296,5539,962,444,428,311,294,2439,0.241769288766022,0.91358024691358,0.951111111111111,0.948170731707317,0.993243243243243,0.440332189925979
E02002633,Little Bispham & Anchorsholme,Blackpool,North West,1238,4141,506,620,481,725,6473,1107,4498,507,616,517,725,6863,1371,464,578,485,687,3585,0.304802134281903,0.915187376725838,0.938311688311688,0.938104448742747,0.947586206896552,0.522366312108407
E02002634,Churchtown,Blackpool,North West,1245,4543,504,610,424,628,6709,1190,5030,532,638,467,699,7366,1546,472,583,447,652,3700,0.307355864811133,0.887218045112782,0.913793103448276,0.957173447537473,0.932761087267525,0.502307901167526
E02002635,Norbreck & Bispham,Blackpool,North West,1208,4484,527,590,451,683,6735,1155,4708,547,622,469,706,7052,1366,491,581,434,652,3524,0.290144435004248,0.897623400365631,0.934083601286174,0.925373134328358,0.923512747875354,0.499716392512762
E02002636,Warbreck & Bispham Road,Blackpool,North West,1643,5050,421,472,328,375,6646,1473,5311,470,458,330,407,6976,1526,405,421,315,378,3045,0.28732818678215,0.861702127659575,0.919213973799127,0.954545454545455,0.928746928746929,0.436496559633028
E02002637,Hoohill,Blackpool,North West,1147,3587,317,334,263,398,4899,1151,4105,335,335,308,370,5453,1104,300,304,288,344,2340,0.268940316686967,0.895522388059702,0.907462686567164,0.935064935064935,0.92972972972973,0.429121584448927
E02002638,North Shore,Blackpool,North West,917,4036,324,288,175,258,5081,1053,5170,364,351,224,290,6399,914,275,296,195,265,1945,0.17678916827853,0.755494505494506,0.843304843304843,0.870535714285714,0.913793103448276,0.303953742772308
E02002639,Little Layton & Little Carleton,Blackpool,North West,1492,3791,248,275,150,154,4618,1469,4262,285,268,145,180,5140,1006,232,221,136,162,1757,0.236039418113562,0.814035087719298,0.824626865671642,0.937931034482759,0.9,0.341828793774319
E02002640,North East Centre,Blackpool,North West,1749,4288,257,228,158,197,5128,1802,5221,327,258,167,214,6187,1024,240,222,139,183,1808,0.196131009385175,0.73394495412844,0.86046511627907,0.832335329341317,0.855140186915888,0.292225634394699
E02002641,Queenstown & Layton,Blackpool,North West,1481,5138,422,349,254,444,6607,1403,5643,412,416,291,418,7180,1702,346,375,266,392,3081,0.301612617402091,0.839805825242718,0.901442307692308,0.914089347079038,0.937799043062201,0.429108635097493
E02002642,Central Blackpool,Blackpool,North West,1216,4809,323,328,164,279,5903,1504,6101,383,301,226,281,7292,1124,268,253,200,235,2080,0.184232093099492,0.699738903394256,0.840531561461794,0.88495575221239,0.836298932384342,0.285244103126714
E02002643,Park Road,Blackpool,North West,1755,4775,327,304,186,239,5831,1815,5810,361,324,204,267,6966,1394,291,280,185,234,2384,0.239931153184165,0.806094182825485,0.864197530864198,0.906862745098039,0.876404494382023,0.342233706574792
E02002644,Stanley Park & Great Marton,Blackpool,North West,1404,4728,372,422,310,428,6260,1385,5201,442,420,308,449,6820,1543,387,375,287,423,3015,0.296673716592963,0.875565610859729,0.892857142857143,0.931818181818182,0.942093541202673,0.44208211143695
E02002645,South Promenade & Seasiders Way,Blackpool,North West,1038,4121,315,295,134,144,5009,1241,5155,388,304,174,173,6194,941,272,252,154,145,1764,0.182541222114452,0.701030927835052,0.828947368421053,0.885057471264368,0.838150289017341,0.284791733936067
E02002646,Little Marton & Marton Moss Side,Blackpool,North West,1278,3964,434,441,299,388,5526,1238,4535,435,492,311,431,6204,1109,376,457,288,407,2637,0.244542447629548,0.864367816091954,0.928861788617886,0.92604501607717,0.944315545243619,0.42504835589942
E02002647,Victoria,Blackpool,North West,1705,4908,354,369,282,319,6232,1717,5607,404,403,261,333,7008,1414,324,351,245,304,2638,0.252184769038702,0.801980198019802,0.870967741935484,0.938697318007663,0.912912912912913,0.376426940639269
E02002648,Hawes Side,Blackpool,North West,1579,4281,376,360,269,315,5601,1532,4591,384,388,277,322,5962,1222,328,354,254,299,2457,0.266172947070355,0.854166666666667,0.912371134020619,0.916967509025271,0.928571428571429,0.412110030191211
E02002649,South Shore,Blackpool,North West,1480,4891,440,454,351,517,6653,1433,5686,449,491,402,574,7602,1422,375,434,371,539,3141,0.250087935279634,0.835189309576838,0.883910386965377,0.922885572139304,0.939024390243902,0.413180741910024
E02002650,Common Edge,Blackpool,North West,1306,4650,522,598,430,577,6777,1303,5187,574,603,454,621,7439,1356,509,567,436,591,3459,0.261422787738577,0.886759581881533,0.940298507462687,0.960352422907489,0.951690821256039,0.464981852399516
E02002651,Squires Gate,Blackpool,North West,1350,4535,409,520,402,661,6527,1283,4957,468,516,457,647,7045,1323,399,479,428,607,3236,0.266895299576357,0.852564102564103,0.928294573643411,0.936542669584245,0.938176197836167,0.459332860184528
E02003811,Cranage & Goostrey,Cheshire East,North West,1130,3771,508,552,359,445,5635,1270,4319,503,527,422,483,6254,925,448,494,409,461,2737,0.214169946746932,0.89065606361829,0.937381404174573,0.969194312796209,0.954451345755693,0.437639910457307
E02003812,Holmes Chapel,Cheshire East,North West,1091,3270,404,525,351,562,5112,1163,3800,365,524,393,548,5630,767,339,489,378,524,2497,0.201842105263158,0.928767123287671,0.933206106870229,0.961832061068702,0.956204379562044,0.443516873889876
E02003813,Middlewich West,Cheshire East,North West,858,3603,456,412,299,485,5255,816,3737,463,431,332,431,5394,911,401,406,320,413,2451,0.243778431897244,0.866090712742981,0.94199535962877,0.963855421686747,0.958236658932715,0.454393770856507
E02003814,Middlewich East,Cheshire East,North West,1743,5118,408,324,205,219,6274,1731,5761,421,390,233,261,7066,1271,359,362,225,244,2461,0.22062141989238,0.852731591448931,0.928205128205128,0.965665236051502,0.934865900383142,0.348287574299462
E02003815,Buglawton,Cheshire East,North West,1583,4139,379,388,290,429,5625,1608,4699,371,386,287,393,6136,1023,292,355,270,380,2320,0.217705894871249,0.787061994609164,0.919689119170985,0.940766550522648,0.966921119592875,0.378096479791395
E02003816,Congleton Town,Cheshire East,North West,1193,4254,445,488,331,452,5970,1158,4564,419,502,376,442,6303,994,354,459,350,413,2570,0.217791411042945,0.844868735083532,0.914342629482072,0.930851063829787,0.934389140271493,0.40774234491512
E02003817,Congleton West Heath,Cheshire East,North West,1155,3688,521,527,388,606,5730,1230,4331,513,606,426,572,6448,1011,466,585,411,542,3015,0.233433387208497,0.908382066276803,0.965346534653465,0.964788732394366,0.947552447552448,0.467586848635236
E02003818,"Hightown, Mossley & Timbersbrook",Cheshire East,North West,791,3009,446,444,324,366,4589,824,3363,455,493,372,456,5139,736,420,468,355,442,2421,0.218852215283973,0.923076923076923,0.949290060851927,0.954301075268817,0.969298245614035,0.471103327495622
E02003819,Sandbach North,Cheshire East,North West,959,3360,428,539,402,500,5229,1001,3939,435,548,432,540,5894,896,392,534,421,526,2769,0.227468900736228,0.901149425287356,0.974452554744525,0.974537037037037,0.974074074074074,0.469799796403122
E02003820,Sandbach Ettiley Heath & Wheelock,Cheshire East,North West,1931,5905,418,356,271,270,7220,2005,6512,380,370,273,323,7858,1339,339,360,267,309,2614,0.205620393120393,0.892105263157895,0.972972972972973,0.978021978021978,0.956656346749226,0.332654619496055
E02003821,Sandbach Heath,Cheshire East,North West,768,3149,362,399,337,401,4648,846,3509,404,389,327,449,5078,819,347,374,318,429,2287,0.233399829011114,0.858910891089109,0.961439588688946,0.972477064220184,0.955456570155902,0.450374163056321
E02003822,"Scholar Green, Rode Heath & Brereton",Cheshire East,North West,1679,6205,786,896,622,698,9207,1750,6908,804,896,657,721,9986,1629,738,869,637,703,4576,0.235813549507817,0.917910447761194,0.969866071428571,0.969558599695586,0.9750346740638,0.458241538153415
E02003823,Alsager East,Cheshire East,North West,1097,3452,434,540,424,588,5438,1145,3924,412,522,455,606,5919,1020,367,511,438,590,2926,0.259938837920489,0.890776699029126,0.978927203065134,0.962637362637363,0.973597359735974,0.494340260179084
E02003824,Alsager West,Cheshire East,North West,1076,3227,353,414,276,334,4604,1213,3829,341,425,304,370,5269,953,317,400,287,355,2312,0.248890049621311,0.929618768328446,0.941176470588235,0.944078947368421,0.959459459459459,0.438792939836781
E02003825,Crewe Leighton,Cheshire East,North West,1229,4333,305,230,128,122,5118,1145,4455,313,271,149,134,5322,1126,281,256,139,131,1933,0.252749719416386,0.897763578274761,0.944649446494465,0.932885906040269,0.977611940298507,0.363209319804585
E02003826,Crewe North East,Cheshire East,North West,1915,4973,334,343,229,326,6205,1995,5705,387,351,247,300,6990,1229,306,326,235,275,2371,0.215425065731814,0.790697674418605,0.928774928774929,0.951417004048583,0.916666666666667,0.339198855507868
E02003827,Crewe Coppenhall & Underwood,Cheshire East,North West,2241,6040,381,377,289,380,7467,2184,6773,395,367,314,388,8237,1154,310,343,300,371,2478,0.170382400708696,0.784810126582278,0.934604904632153,0.955414012738854,0.956185567010309,0.300837683622678
E02003828,Crewe North West,Cheshire East,North West,1665,4025,295,313,241,341,5215,1655,4576,262,310,199,258,5605,859,211,287,189,248,1794,0.187718531468531,0.805343511450382,0.925806451612903,0.949748743718593,0.961240310077519,0.32007136485281
E02003829,Crewe Sydney & Gateway,Cheshire East,North West,779,3382,400,407,333,386,4908,704,3576,370,413,351,412,5122,813,319,390,330,392,2244,0.227348993288591,0.862162162162162,0.944309927360775,0.94017094017094,0.951456310679612,0.438110113237017
E02003830,Crewe Town & Victoria Avenue,Cheshire East,North West,1747,5408,306,243,199,283,6439,1759,5990,331,257,186,313,7077,1058,240,231,172,298,1999,0.176627712854758,0.725075528700906,0.898832684824903,0.924731182795699,0.952076677316294,0.282464321039989
E02003831,Haslington & Weston,Cheshire East,North West,1628,5816,614,631,451,567,8079,1619,6204,606,664,490,587,8551,1480,539,643,476,564,3702,0.238555770470664,0.88943894389439,0.968373493975904,0.971428571428571,0.960817717206133,0.432931820839668
E02003832,Crewe Mill Street & College,Cheshire East,North West,1229,4667,209,184,98,167,5325,1211,5247,237,196,126,173,5979,583,179,174,109,156,1201,0.111111111111111,0.755274261603376,0.887755102040816,0.865079365079365,0.901734104046243,0.200869710653956
E02003833,Wistaston Green,Cheshire East,North West,1145,3772,315,316,245,301,4949,1233,4256,325,309,262,302,5454,936,263,294,252,292,2037,0.219924812030075,0.809230769230769,0.951456310679612,0.961832061068702,0.966887417218543,0.373487348734874
E02003834,Crewe Gresty Road,Cheshire East,North West,1413,4773,267,244,170,256,5710,1343,5243,244,244,153,233,6117,811,180,213,142,220,1566,0.154682433721152,0.737704918032787,0.872950819672131,0.928104575163399,0.944206008583691,0.256007846983816
E02003835,Crewe South West & Wistaston,Cheshire East,North West,1124,4305,573,675,469,652,6674,1181,4800,596,631,535,734,7296,1081,529,603,522,717,3452,0.225208333333333,0.88758389261745,0.955625990491284,0.975700934579439,0.976839237057221,0.473135964912281
E02003836,Nantwich North East,Cheshire East,North West,972,3922,473,571,362,708,6036,1010,4059,477,553,377,741,6207,805,426,517,355,713,2816,0.198324710519832,0.893081761006289,0.934900542495479,0.941644562334218,0.96221322537112,0.45368132753343
E02003837,Nantwich South East & Wybunbury,Cheshire East,North West,2857,8999,674,705,442,567,11387,2894,9994,732,813,535,590,12664,1928,630,771,507,552,4388,0.19291574944967,0.860655737704918,0.948339483394834,0.947663551401869,0.935593220338983,0.346493998736576
E02003838,Willaston & Shavington,Cheshire East,North West,1286,4018,446,479,331,434,5708,1442,4812,438,512,387,441,6590,1015,383,496,376,424,2694,0.210931005818786,0.874429223744292,0.96875,0.971576227390181,0.961451247165533,0.408801213960546
E02003839,Nantwich South West,Cheshire East,North West,1133,3821,456,512,422,654,5865,1054,4155,430,533,443,663,6224,789,388,502,418,631,2728,0.189891696750903,0.902325581395349,0.941838649155722,0.943566591422122,0.951734539969834,0.438303341902314
E02003840,"Audlem, Bunbury & Wrenbury",Cheshire East,North West,1592,5943,870,805,548,794,8960,1646,6614,906,861,598,847,9826,1458,823,819,564,816,4480,0.220441487753251,0.908388520971302,0.951219512195122,0.94314381270903,0.963400236127509,0.455933238347242
E02003853,Disley & Lyme Park,Cheshire East,North West,992,3430,391,452,294,543,5110,994,3874,415,467,341,440,5537,911,364,446,324,408,2453,0.235157459989675,0.87710843373494,0.955032119914347,0.950146627565982,0.927272727272727,0.443019685750406
E02003854,Poynton West,Cheshire East,North West,1155,3390,487,511,315,437,5140,1143,3882,435,512,363,470,5662,858,388,490,356,455,2547,0.221020092735703,0.891954022988506,0.95703125,0.980716253443526,0.968085106382979,0.449841045566938
E02003855,Poynton East,Cheshire East,North West,1067,3280,511,568,416,601,5376,1033,3618,451,573,487,671,5800,858,399,559,471,657,2944,0.237147595356551,0.88470066518847,0.975567190226876,0.967145790554415,0.979135618479881,0.507586206896552
E02003856,Handforth & Dean Row,Cheshire East,North West,2052,6664,534,565,418,636,8817,2115,7515,525,582,433,634,9689,1711,441,547,412,603,3714,0.227677977378576,0.84,0.939862542955326,0.951501154734411,0.951104100946372,0.383321292187016
E02003857,Lacey Green & Wilmslow Park,Cheshire East,North West,1344,4036,372,376,189,286,5259,1441,4661,362,427,207,288,5945,929,315,389,191,267,2091,0.199313452048917,0.870165745856354,0.911007025761124,0.922705314009662,0.927083333333333,0.351724137931035
E02003858,Wilmslow Town,Cheshire East,North West,1212,4078,405,438,264,613,5798,1285,4893,406,458,327,607,6691,986,333,432,300,575,2626,0.201512364602493,0.820197044334975,0.943231441048035,0.91743119266055,0.947281713344316,0.392467493648184
E02003859,"Mobberley, Plumley & High Legh",Cheshire East,North West,1864,6789,829,880,665,940,10103,2002,7388,793,885,656,940,10662,1712,697,831,633,908,4781,0.231727125067677,0.878940731399748,0.938983050847458,0.964939024390244,0.965957446808511,0.448414931532546
E02003860,Fulshaw Park & Lindow,Cheshire East,North West,1569,4057,360,443,290,511,5661,1611,4717,374,447,311,522,6371,939,328,430,294,499,2490,0.199067203731185,0.877005347593583,0.961968680089485,0.945337620578778,0.955938697318008,0.390833464134359
E02003861,Knutsford North,Cheshire East,North West,1257,3633,338,376,321,455,5123,1232,4040,332,354,323,476,5525,824,295,329,309,456,2213,0.203960396039604,0.88855421686747,0.929378531073446,0.956656346749226,0.957983193277311,0.400542986425339
E02003862,Prestbury & Adlington,Cheshire East,North West,740,2601,405,463,331,575,4375,745,3049,421,419,393,550,4832,614,383,392,379,523,2291,0.201377500819941,0.909738717339667,0.935560859188544,0.964376590330789,0.950909090909091,0.474130794701987
E02003863,South Knutsford & Bexton,Cheshire East,North West,1312,3636,427,429,370,541,5403,1304,4097,406,451,366,591,5911,859,369,437,352,574,2591,0.209665608982182,0.908866995073892,0.968957871396896,0.961748633879781,0.971235194585448,0.438335307054644
E02003864,Alderley Edge & Chelford,Cheshire East,North West,1285,4690,537,539,397,830,6993,1321,5367,560,601,435,772,7735,1044,497,564,407,746,3258,0.194522079373952,0.8875,0.938435940099834,0.935632183908046,0.966321243523316,0.42120232708468
E02003865,Bollington,Cheshire East,North West,1421,4694,476,544,343,437,6494,1438,5248,514,536,372,477,7147,1118,441,496,359,449,2863,0.213033536585366,0.857976653696498,0.925373134328358,0.96505376344086,0.941299790356394,0.400587659157689
E02003866,Macclesfield Tytherington,Cheshire East,North West,1030,3513,363,425,287,352,4940,1046,3969,391,427,312,406,5505,808,355,406,304,391,2264,0.203577727387251,0.907928388746803,0.950819672131147,0.974358974358974,0.963054187192118,0.411262488646685
E02003867,Macclesfield Upton Priory & Greenside,Cheshire East,North West,1551,4503,383,438,254,400,5978,1530,4892,427,412,307,412,6450,1313,380,382,300,396,2771,0.268397383483238,0.889929742388759,0.927184466019417,0.977198697068404,0.961165048543689,0.429612403100775
E02003868,Macclesfield East & Hurdsfield,Cheshire East,North West,1491,5171,461,416,280,470,6798,1475,5630,446,480,309,469,7334,1231,363,442,297,447,2780,0.218650088809947,0.81390134529148,0.920833333333333,0.961165048543689,0.953091684434968,0.37905644941369
E02003869,Macclesfield Bollinbrook,Cheshire East,North West,1194,4207,399,457,328,552,5943,1155,4557,420,464,381,535,6357,1079,379,437,361,508,2764,0.236778582400702,0.902380952380952,0.941810344827586,0.94750656167979,0.949532710280374,0.434796287557024
E02003870,Central Macclesfield,Cheshire East,North West,1647,6950,457,463,296,505,8671,1613,7626,496,472,300,477,9371,1662,396,427,290,450,3225,0.217938630999213,0.798387096774194,0.904661016949153,0.966666666666667,0.943396226415094,0.344146835983353
E02003871,Macclesfield Weston,Cheshire East,North West,1284,3961,420,386,298,412,5477,1336,4496,393,434,294,393,6010,1202,328,406,285,367,2588,0.267348754448399,0.834605597964377,0.935483870967742,0.969387755102041,0.933842239185751,0.430615640599002
E02003872,Gawsworth & Macclesfield Forest,Cheshire East,North West,1354,5381,719,778,573,790,8241,1379,5926,743,792,629,808,8898,1330,652,747,605,777,4111,0.224434694566318,0.877523553162853,0.943181818181818,0.961844197138315,0.961633663366337,0.462013935715891
E02003873,Macclesfield South & Lyme Green,Cheshire East,North West,1248,3783,275,290,177,268,4793,1197,4126,272,279,166,266,5109,998,227,260,157,245,1887,0.24188075618032,0.834558823529412,0.931899641577061,0.945783132530121,0.921052631578947,0.369348209042866
E02003794,"Elton, Mickle Trafford & Great Barrow",Cheshire West and Chester,North West,1589,5043,541,613,393,427,7017,1578,5456,541,628,430,429,7484,1210,408,603,417,406,3044,0.221774193548387,0.754158964879852,0.960191082802548,0.969767441860465,0.946386946386946,0.406734366648851
E02003795,"Capenhurst, Saughall & Moston",Cheshire West and Chester,North West,1044,3233,381,404,266,449,4733,1055,3828,397,422,307,459,5413,843,343,400,299,439,2324,0.220219435736677,0.863979848866499,0.947867298578199,0.973941368078176,0.956427015250545,0.429336781821541
E02003796,Upton East,Cheshire West and Chester,North West,1410,4049,415,418,363,610,5855,1413,4648,448,426,362,666,6550,1150,364,400,345,637,2896,0.247418244406196,0.8125,0.938967136150235,0.953038674033149,0.956456456456456,0.442137404580153
E02003797,Upton West & Heath,Cheshire West and Chester,North West,1845,6245,498,530,381,760,8414,1716,6724,523,530,368,673,8818,1541,428,497,353,637,3456,0.229179060083284,0.818355640535373,0.937735849056604,0.959239130434783,0.946508172362556,0.39192560671354
E02003798,Blacon North,Cheshire West and Chester,North West,1370,3721,282,283,212,205,4703,1456,4341,305,292,213,241,5392,1063,242,265,200,223,1993,0.244874452891039,0.79344262295082,0.907534246575342,0.938967136150235,0.925311203319502,0.369621661721068
E02003799,Blacon South,Cheshire West and Chester,North West,1503,4324,341,339,252,354,5610,1559,4885,365,344,259,392,6245,1208,301,316,246,365,2436,0.247287615148414,0.824657534246575,0.918604651162791,0.94980694980695,0.931122448979592,0.390072057646117
E02003800,"Kelsall, Tarvin & Ashton Hayes",Cheshire West and Chester,North West,1256,3706,452,530,363,537,5588,1264,4039,432,523,439,538,5971,957,377,506,429,524,2793,0.236939836593216,0.872685185185185,0.967495219885277,0.977220956719818,0.973977695167286,0.467760844079719
E02003801,Vicars Cross & Hoole East,Cheshire West and Chester,North West,1382,3995,388,367,266,441,5457,1416,4680,390,396,283,470,6219,1035,312,370,266,430,2413,0.221153846153846,0.8,0.934343434343434,0.939929328621908,0.914893617021277,0.388004502331565
E02003802,Chester Boughton West & Hoole,Cheshire West and Chester,North West,924,6414,410,382,252,452,7910,865,6765,429,385,263,419,8261,1150,306,334,243,392,2425,0.169992609016999,0.713286713286713,0.867532467532467,0.923954372623574,0.935560859188544,0.29354799661058
E02003803,Chester City & Garden Quarter,Cheshire West and Chester,North West,637,8073,331,303,230,358,9295,601,8514,342,340,246,400,9842,964,229,298,222,365,2078,0.113225276015974,0.669590643274854,0.876470588235294,0.902439024390244,0.9125,0.211135947978053
E02003804,Chester Boughton East,Cheshire West and Chester,North West,1090,4266,306,305,207,383,5467,1156,4798,347,335,229,387,6096,886,262,300,216,365,2029,0.184660275114631,0.755043227665706,0.895522388059702,0.943231441048035,0.943152454780362,0.332841207349081
E02003805,"Christleton, Guilden Sutton & Waverton",Cheshire West and Chester,North West,1056,3527,440,444,370,459,5240,1059,3803,426,436,384,512,5561,877,362,421,366,481,2507,0.230607415198528,0.849765258215962,0.965596330275229,0.953125,0.939453125,0.450818198165798
E02003806,Boughton Heath & Huntington,Cheshire West and Chester,North West,1649,4532,427,365,300,491,6115,1672,5055,452,386,313,524,6730,1007,370,368,293,499,2537,0.199208704253215,0.81858407079646,0.953367875647668,0.936102236421725,0.952290076335878,0.376968796433878
E02003807,Chester Handbridge Park,Cheshire West and Chester,North West,1211,4534,507,633,439,683,6796,1261,5353,515,630,547,657,7702,956,420,586,515,612,3089,0.178591444050065,0.815533980582524,0.93015873015873,0.941499085923217,0.931506849315068,0.401064658530252
E02003808,Lache,Cheshire West and Chester,North West,1360,4129,337,277,160,189,5092,1354,4533,312,292,164,201,5502,914,225,258,153,181,1731,0.201632472975954,0.721153846153846,0.883561643835616,0.932926829268293,0.900497512437811,0.314612868047983
E02003809,"Dodleston, Tattenhall & Duddon",Cheshire West and Chester,North West,1373,4521,536,590,403,588,6638,1277,4812,537,566,440,642,6997,1092,413,509,386,589,2989,0.226932668329177,0.769087523277467,0.899293286219081,0.877272727272727,0.917445482866044,0.427183078462198
E02003810,"Churton, Farndon & Malpas",Cheshire West and Chester,North West,1660,5051,656,634,487,606,7434,1703,5884,643,693,472,661,8353,1161,565,646,454,623,3449,0.197314751869477,0.878693623639191,0.932178932178932,0.961864406779661,0.942511346444781,0.412905542918712
E02003841,Neston & Parkgate,Cheshire West and Chester,North West,1254,4457,544,612,452,632,6697,1235,4651,597,638,471,660,7017,1151,490,609,459,621,3330,0.247473661578155,0.820770519262982,0.954545454545455,0.974522292993631,0.940909090909091,0.474561778537837
E02003842,"Hooton, Willaston & Ness",Cheshire West and Chester,North West,749,2890,446,491,314,467,4608,735,3234,441,519,379,530,5103,796,369,493,369,499,2526,0.246134817563389,0.836734693877551,0.94990366088632,0.973614775725594,0.941509433962264,0.495002939447384
E02003843,Little Sutton North & Overpool,Cheshire West and Chester,North West,1066,3626,378,329,252,374,4959,1045,4127,407,359,251,438,5582,859,312,338,235,403,2147,0.208141507148049,0.766584766584767,0.94150417827298,0.936254980079681,0.920091324200913,0.384629165173773
E02003844,Little Neston,Cheshire West and Chester,North West,918,3643,516,541,385,473,5558,974,3991,493,557,396,522,5959,964,400,539,383,504,2790,0.241543472813831,0.811359026369168,0.967684021543986,0.967171717171717,0.96551724137931,0.468199362309112
E02003845,Ellesmere Port Town & Rossmore,Cheshire West and Chester,North West,2100,6290,401,287,200,394,7572,2372,7477,401,305,209,355,8747,1249,282,276,190,306,2303,0.167045606526682,0.703241895261845,0.904918032786885,0.909090909090909,0.861971830985915,0.26329027095004
E02003846,Little Sutton East,Cheshire West and Chester,North West,1638,4123,258,249,228,304,5162,1637,4716,281,251,196,321,5765,847,204,227,181,290,1749,0.179601357082273,0.725978647686833,0.904382470119522,0.923469387755102,0.903426791277259,0.30338248048569
E02003847,Little Sutton West,Cheshire West and Chester,North West,1493,5970,567,635,335,466,7973,1532,6447,625,581,395,497,8545,1332,515,551,382,459,3239,0.206607724523034,0.824,0.948364888123924,0.967088607594937,0.92354124748491,0.379052077238151
E02003848,Ellesmere Port Pooltown Road,Cheshire West and Chester,North West,991,3082,251,224,167,290,4014,1055,3587,231,235,179,302,4534,664,187,216,165,279,1511,0.185112907722331,0.80952380952381,0.919148936170213,0.921787709497207,0.923841059602649,0.333259814733128
E02003849,Wolverham & Stanlow,Cheshire West and Chester,North West,1801,4822,312,306,208,240,5888,1906,5572,305,309,238,255,6679,1012,210,281,222,235,1960,0.1816223977028,0.688524590163934,0.909385113268608,0.932773109243698,0.92156862745098,0.29345710435694
E02003850,Great Sutton,Cheshire West and Chester,North West,854,2977,378,354,219,268,4196,869,3311,317,361,228,320,4537,667,272,352,218,297,1806,0.20144971307762,0.858044164037855,0.975069252077562,0.956140350877193,0.928125,0.398060392329733
E02003851,Whitby & Stanney Woods,Cheshire West and Chester,North West,912,3337,347,363,251,341,4639,927,3774,331,398,266,371,5140,746,292,379,250,344,2011,0.197668256491786,0.882175226586103,0.952261306532663,0.93984962406015,0.92722371967655,0.39124513618677
E02003852,Ellesmere Port South,Cheshire West and Chester,North West,1016,3812,440,395,315,421,5383,993,4157,465,433,327,463,5845,858,398,420,316,429,2421,0.206398845321145,0.855913978494624,0.969976905311778,0.966360856269113,0.926565874730022,0.414200171086399
E02003874,Frodsham,Cheshire West and Chester,North West,1566,5180,551,689,485,700,7605,1568,5725,591,662,503,714,8195,1373,514,627,479,693,3686,0.239825327510917,0.869712351945855,0.947129909365559,0.952286282306163,0.970588235294118,0.449786455155583
E02003875,"Comberbach, Acton Bridge & Whitley",Cheshire West and Chester,North West,866,3564,512,536,370,408,5390,856,3796,506,556,409,434,5701,802,425,531,398,422,2578,0.21127502634352,0.839920948616601,0.955035971223021,0.973105134474328,0.972350230414747,0.452201368181021
E02003876,Barnton,Cheshire West and Chester,North West,1082,3216,361,372,227,237,4413,1150,3575,348,407,252,234,4816,723,241,385,242,224,1815,0.202237762237762,0.692528735632184,0.945945945945946,0.96031746031746,0.957264957264957,0.37686877076412
E02003877,Helsby & Kingsley,Cheshire West and Chester,North West,1415,5336,648,729,448,715,7876,1425,5934,656,729,548,729,8596,1418,561,701,530,692,3902,0.238961914391641,0.855182926829268,0.96159122085048,0.967153284671533,0.949245541838135,0.453932061423918
E02003878,Lostock & Wincham,Cheshire West and Chester,North West,1504,5149,590,587,353,568,7247,1506,5590,619,630,393,566,7798,1113,511,600,384,551,3159,0.199105545617174,0.825525040387722,0.952380952380952,0.977099236641221,0.973498233215548,0.405103872787894
E02003879,Northwich Central & Winnington,Cheshire West and Chester,North West,1861,5656,284,317,189,363,6809,1868,6048,318,296,202,365,7229,1018,198,276,192,352,2036,0.168320105820106,0.622641509433962,0.932432432432432,0.95049504950495,0.964383561643836,0.281643380827224
E02003880,Weaverham,Cheshire West and Chester,North West,1151,3576,440,430,283,347,5076,1140,3907,413,445,321,386,5472,825,297,420,309,366,2217,0.211159457384182,0.719128329297821,0.943820224719101,0.962616822429906,0.948186528497409,0.40515350877193
E02003881,Greenbank,Cheshire West and Chester,North West,1069,3827,334,299,161,183,4804,1049,4089,361,333,182,187,5152,763,266,312,171,180,1692,0.186598190266569,0.736842105263158,0.936936936936937,0.93956043956044,0.962566844919786,0.328416149068323
E02003882,Rudheath West & Leftwich,Cheshire West and Chester,North West,1790,5839,515,461,266,421,7502,1880,6472,535,481,309,426,8223,1240,398,455,295,416,2804,0.19159456118665,0.74392523364486,0.945945945945946,0.954692556634304,0.976525821596244,0.340994770764928
E02003883,Hartford & Kingsmead,Cheshire West and Chester,North West,2006,6576,553,600,395,570,8694,1925,7159,597,620,437,595,9408,1288,484,590,419,567,3348,0.17991339572566,0.8107202680067,0.951612903225806,0.958810068649886,0.952941176470588,0.355867346938776
E02003884,Sandiway,Cheshire West and Chester,North West,1545,4494,643,674,456,675,6942,1455,4959,597,675,506,681,7418,949,501,649,483,653,3235,0.191369227666868,0.839195979899498,0.961481481481482,0.954545454545455,0.958883994126285,0.436101375033702
E02003885,Davenham & Moulton,Cheshire West and Chester,North West,1106,3437,413,397,261,374,4882,1115,3840,386,459,310,371,5366,748,318,438,297,361,2162,0.194791666666667,0.823834196891192,0.954248366013072,0.958064516129032,0.973045822102426,0.402907193440179
E02003886,Wharton,Cheshire West and Chester,North West,1371,4117,314,283,186,243,5143,1403,4580,296,288,201,287,5652,945,272,270,192,282,1961,0.206331877729258,0.918918918918919,0.9375,0.955223880597015,0.982578397212544,0.346956829440906
E02003887,Winsford North,Cheshire West and Chester,North West,1233,4091,360,369,234,205,5259,1297,4571,368,362,261,232,5794,979,326,342,252,226,2125,0.214176329030847,0.885869565217391,0.94475138121547,0.96551724137931,0.974137931034483,0.366758715913013
E02003888,Winsford Central,Cheshire West and Chester,North West,1169,4001,275,298,212,314,5100,1215,4502,289,309,213,331,5644,1046,252,291,205,307,2101,0.232341181697024,0.8719723183391,0.941747572815534,0.962441314553991,0.927492447129909,0.372253720765415
E02003889,Winsford Over,Cheshire West and Chester,North West,1473,3433,233,269,237,255,4427,1521,4038,276,256,258,286,5114,833,253,237,252,277,1852,0.206290242694403,0.916666666666667,0.92578125,0.976744186046512,0.968531468531468,0.362143136488072
E02003890,Winsford Glebe Green,Cheshire West and Chester,North West,1285,4041,336,306,265,255,5203,1380,4572,377,330,265,249,5793,1014,346,310,257,232,2159,0.221784776902887,0.917771883289125,0.939393939393939,0.969811320754717,0.931726907630522,0.372691179009149
E02003891,Tarporley & Eddisbury Hill,Cheshire West and Chester,North West,1056,3255,436,476,386,434,4987,1065,3743,474,530,390,492,5629,908,421,514,374,479,2696,0.242586160833556,0.888185654008439,0.969811320754717,0.958974358974359,0.973577235772358,0.478948303428673
E02003965,Wigton & Silloth,Allerdale,North West,1692,6372,784,786,606,847,9395,1695,6626,786,847,618,868,9745,1006,327,796,601,825,3555,0.151826139450649,0.416030534351145,0.939787485242031,0.972491909385113,0.950460829493088,0.364802462801437
E02003966,"Boltons, Warnell & Solway Coast",Allerdale,North West,962,4056,539,594,379,476,6044,976,4303,595,620,390,499,6407,580,312,600,373,478,2343,0.134789681617476,0.52436974789916,0.967741935483871,0.956410256410256,0.957915831663327,0.365693772436398
E02003967,Aspatria & Abbeytown,Allerdale,North West,1418,4915,581,584,367,513,6960,1386,4944,571,614,388,512,7029,670,261,580,371,499,2381,0.135517799352751,0.457092819614711,0.944625407166124,0.956185567010309,0.974609375,0.338739507753592
E02003968,"Maryport, Dearham & Crosby",Allerdale,North West,1428,5336,664,645,440,598,7683,1389,5452,587,628,465,546,7678,1243,522,596,453,527,3341,0.227989728539985,0.889267461669506,0.949044585987261,0.974193548387097,0.965201465201465,0.435139359208127
E02003969,"Flimby, Ellenborough & Broughton Moor",Allerdale,North West,1380,4018,370,353,258,335,5334,1367,4207,339,391,258,352,5547,1060,308,367,246,340,2321,0.251961017352032,0.908554572271387,0.938618925831202,0.953488372093023,0.965909090909091,0.418424373535244
E02003970,West Cockermouth & Great Broughton,Allerdale,North West,1216,4808,619,580,353,543,6903,1216,4893,610,601,384,545,7033,898,558,577,366,530,2929,0.183527488248518,0.914754098360656,0.960066555740433,0.953125,0.972477064220184,0.416465235319209
E02003971,East Cockermouth & Buttermere,Allerdale,North West,1170,4466,628,584,428,591,6697,1083,4680,618,633,416,613,6960,918,581,617,398,595,3109,0.196153846153846,0.940129449838188,0.974723538704581,0.956730769230769,0.970636215334421,0.446695402298851
E02003972,Workington North & Seaton,Allerdale,North West,1586,5479,505,546,421,542,7493,1514,5644,502,590,370,541,7647,1387,456,554,359,528,3284,0.245747696669029,0.908366533864542,0.938983050847458,0.97027027027027,0.975970425138632,0.429449457303518
E02003973,Workington West,Allerdale,North West,1716,5442,480,407,286,389,7004,1682,5664,495,450,288,380,7277,1412,426,421,282,364,2905,0.249293785310734,0.860606060606061,0.935555555555556,0.979166666666667,0.957894736842105,0.39920296825615
E02003974,Workington East,Allerdale,North West,1421,4618,450,485,352,479,6384,1484,4623,439,479,351,448,6340,1208,396,460,345,440,2849,0.261302184728531,0.902050113895216,0.960334029227557,0.982905982905983,0.982142857142857,0.449369085173502
E02003975,"Harrington, Stainburn & Great Clifton",Allerdale,North West,1221,4162,475,467,327,514,5945,1227,4334,462,493,354,509,6152,1020,416,472,341,483,2732,0.23534840793724,0.900432900432901,0.957403651115619,0.963276836158192,0.948919449901768,0.44408322496749
E02003976,Keswick & Derwent Valley,Allerdale,North West,842,3883,427,515,404,638,5867,796,4108,435,486,365,623,6017,396,291,463,347,614,2111,0.0963972736124635,0.668965517241379,0.952674897119342,0.950684931506849,0.985553772070626,0.350839288682068
E02003977,Askam & Dalton North,Barrow-in-Furness,North West,1022,3878,398,373,245,313,5207,946,3985,386,384,262,335,5352,825,352,363,251,319,2110,0.20702634880803,0.911917098445596,0.9453125,0.958015267175572,0.952238805970149,0.39424514200299
E02003978,Dalton South,Barrow-in-Furness,North West,901,3345,316,371,298,325,4655,879,3712,353,336,274,396,5071,805,316,319,262,388,2090,0.216864224137931,0.895184135977337,0.949404761904762,0.956204379562044,0.97979797979798,0.412147505422993
E02003979,Hawcoat & Furness Abbey,Barrow-in-Furness,North West,1052,4090,522,651,472,743,6478,1080,4379,539,657,523,759,6857,951,509,632,506,730,3328,0.217172870518383,0.944341372912801,0.961948249619482,0.967495219885277,0.961791831357049,0.485343444655097
E02003980,Orsmgill & Hindpool,Barrow-in-Furness,North West,1309,4029,375,309,239,226,5178,1391,4423,387,339,234,262,5645,875,347,321,215,246,2004,0.197829527470043,0.896640826873385,0.946902654867257,0.918803418803419,0.938931297709924,0.355004428697963
E02003981,Parkside,Barrow-in-Furness,North West,1146,4188,326,332,265,335,5446,1041,4448,333,342,249,336,5708,886,308,326,239,318,2077,0.199190647482014,0.924924924924925,0.953216374269006,0.959839357429719,0.946428571428571,0.363875262789068
E02003982,Roose,Barrow-in-Furness,North West,1461,4448,482,489,376,373,6168,1558,4978,453,522,406,435,6794,1017,417,502,391,425,2752,0.204298915226999,0.920529801324503,0.961685823754789,0.963054187192118,0.977011494252874,0.405063291139241
E02003983,Abbotsmead & Salthouse,Barrow-in-Furness,North West,1492,4731,345,373,241,319,6009,1498,5049,382,366,223,273,6293,1076,342,338,212,263,2231,0.213111507229154,0.895287958115183,0.923497267759563,0.95067264573991,0.963369963369963,0.354520896233911
E02003984,Barrow Central,Barrow-in-Furness,North West,1263,4191,323,292,206,318,5330,1330,4449,315,296,197,259,5516,821,272,273,182,229,1777,0.184535850752978,0.863492063492064,0.922297297297297,0.923857868020305,0.884169884169884,0.322153734590283
E02003985,Walney Island North,Barrow-in-Furness,North West,1118,3997,449,444,351,382,5623,1079,4104,408,482,363,400,5757,886,370,465,353,387,2461,0.21588693957115,0.906862745098039,0.964730290456431,0.972451790633609,0.9675,0.42747959006427
E02003986,Walney Island South & Barrow Island,Barrow-in-Furness,North West,1010,3781,393,431,278,298,5181,967,3946,372,407,308,306,5339,845,338,389,298,296,2166,0.214140902179422,0.908602150537634,0.955773955773956,0.967532467532468,0.967320261437908,0.405693950177936
E02003987,Longtown & Border,Carlisle,North West,888,3491,457,411,290,376,5025,830,3239,366,368,227,335,4535,528,312,351,216,324,1731,0.163013275702377,0.852459016393443,0.953804347826087,0.951541850220264,0.967164179104478,0.381697905181918
E02003988,Brampton & Irthing,Carlisle,North West,1055,3811,467,494,348,476,5596,922,3891,508,514,340,499,5752,605,409,486,321,482,2303,0.155487021331277,0.805118110236221,0.945525291828794,0.944117647058824,0.965931863727455,0.40038247566064
E02003989,Carlisle Belah,Carlisle,North West,1232,4021,469,467,407,496,5860,1234,4454,484,515,414,590,6457,954,448,499,398,565,2864,0.21418949259093,0.925619834710744,0.968932038834951,0.961352657004831,0.957627118644068,0.443549636053895
E02003990,"Kingmoor, Houghton & Whiteclosegate",Carlisle,North West,1886,5950,662,662,452,770,8496,1926,6398,670,702,465,776,9011,1291,615,671,445,752,3774,0.20178180681463,0.917910447761194,0.955840455840456,0.956989247311828,0.969072164948454,0.418821440461658
E02003991,Belle Vue & Burgh,Carlisle,North West,1182,4328,561,549,395,492,6325,1133,4433,573,569,439,521,6535,943,477,543,423,500,2886,0.212722761109858,0.832460732984293,0.954305799648506,0.963553530751708,0.959692898272553,0.441622035195103
E02003992,Central Carlisle,Carlisle,North West,1102,5648,439,350,244,423,7104,1009,5793,419,384,259,387,7242,944,336,341,241,352,2214,0.162955290868289,0.801909307875895,0.888020833333333,0.930501930501931,0.909560723514212,0.305716652858326
E02003993,"Wetheral, Corby & Geltsdale",Carlisle,North West,1341,4925,730,708,466,621,7450,1270,5078,724,749,497,627,7675,809,592,719,482,601,3203,0.159314690823159,0.81767955801105,0.959946595460614,0.969818913480885,0.958532695374801,0.417328990228013
E02003994,Longsowerby & Caldewgate,Carlisle,North West,1267,4531,329,318,272,519,5969,1245,4783,322,350,234,462,6151,1005,284,327,215,436,2267,0.21011917206774,0.881987577639752,0.934285714285714,0.918803418803419,0.943722943722944,0.368557958055601
E02003995,Raffles & Morton,Carlisle,North West,2013,5972,473,498,372,500,7815,2163,6442,491,500,362,555,8350,1292,433,470,343,538,3076,0.200558832660664,0.881873727087576,0.94,0.947513812154696,0.969369369369369,0.368383233532934
E02003996,Denton Holme & Harraby Green,Carlisle,North West,1564,6618,410,336,239,336,7939,1467,6763,417,379,220,307,8086,1241,351,354,199,277,2422,0.18349844743457,0.841726618705036,0.934036939313984,0.904545454545454,0.90228013029316,0.299530051941628
E02003997,Botcherby & Harraby,Carlisle,North West,2213,5742,482,399,276,407,7306,2269,6393,481,425,274,383,7956,1155,423,402,261,358,2599,0.180666353824496,0.879417879417879,0.945882352941176,0.952554744525547,0.934725848563969,0.326671694318753
E02003998,Currock & Upperby,Carlisle,North West,1542,4032,320,350,252,321,5275,1438,4123,324,321,240,338,5346,790,283,294,233,313,1913,0.191608052389037,0.873456790123457,0.91588785046729,0.970833333333333,0.92603550295858,0.357837635615413
E02003999,Garlands & Dalston,Carlisle,North West,2055,6451,745,725,511,746,9178,2075,7128,741,774,579,735,9957,1402,589,746,559,681,3977,0.19668911335578,0.794871794871795,0.963824289405685,0.96545768566494,0.926530612244898,0.399417495229487
E02004000,Parton & Distington,Copeland,North West,837,3141,347,315,208,351,4362,858,3174,324,350,227,320,4395,671,288,336,220,300,1815,0.211405166981727,0.888888888888889,0.96,0.969162995594714,0.9375,0.412969283276451
E02004001,Whitehaven Harbour & Corkickle,Copeland,North West,738,3326,338,319,232,341,4556,688,3459,322,334,230,337,4682,587,282,305,218,295,1687,0.169702226076901,0.875776397515528,0.913173652694611,0.947826086956522,0.875370919881306,0.360316104228962
E02004002,"Hensingham, Hillcrest & Aikbank",Copeland,North West,1701,6055,593,593,413,606,8260,1567,6114,593,629,439,602,8377,1169,519,580,417,544,3229,0.191200523388943,0.875210792580101,0.922098569157393,0.949886104783599,0.903654485049834,0.385460188611675
E02004003,"Cleator Moor, Frizington & Ennerdale",Copeland,North West,1885,7302,696,677,482,578,9735,1863,7493,750,728,493,590,10054,1388,585,683,475,558,3689,0.185239556919792,0.78,0.938186813186813,0.963488843813387,0.945762711864407,0.366918639347523
E02004004,"Mirehouse, Kells & Woodhouse",Copeland,North West,2134,5941,537,474,284,463,7699,2093,6231,556,517,309,504,8117,1082,452,471,293,460,2758,0.173647889584336,0.81294964028777,0.911025145067698,0.948220064724919,0.912698412698413,0.339780707157817
E02004005,Egremont & Moor Row,Copeland,North West,1342,4704,490,464,371,397,6426,1329,4839,495,467,373,431,6605,892,416,452,362,410,2532,0.184335606530275,0.84040404040404,0.967880085653105,0.970509383378016,0.951276102088167,0.38334595003785
E02004006,"Thornhill, Gosforth & Seascale",Copeland,North West,1286,4991,671,626,480,635,7403,1214,4936,683,651,471,628,7369,776,580,604,459,607,3026,0.157212317666126,0.849194729136164,0.927803379416283,0.974522292993631,0.96656050955414,0.410639164065681
E02004007,Millom & Duddon Valley,Copeland,North West,1558,5740,682,750,500,589,8261,1540,5952,688,729,518,636,8523,985,628,690,502,609,3414,0.165490591397849,0.912790697674419,0.946502057613169,0.969111969111969,0.957547169811321,0.400563181978177
E02004008,"Langwathby, Kirkoswald & Alston Moor",Eden,North West,886,3717,548,507,283,366,5421,920,3787,550,534,315,345,5531,433,468,514,301,334,2050,0.114338526538157,0.850909090909091,0.962546816479401,0.955555555555556,0.968115942028986,0.37063822093654
E02004009,"Hesket, Lazonby & Skelton",Eden,North West,930,3704,441,441,277,380,5243,881,3627,469,423,312,395,5226,408,334,409,303,388,1842,0.112489660876758,0.712153518123667,0.966903073286052,0.971153846153846,0.982278481012658,0.352468427095293
E02004010,Penrith Central & West,Eden,North West,1321,4667,362,367,258,540,6194,1221,4887,326,387,280,495,6375,568,271,359,272,479,1949,0.116226723961531,0.831288343558282,0.92764857881137,0.971428571428571,0.967676767676768,0.305725490196078
E02004011,Penrith Outer,Eden,North West,1555,5766,732,745,590,876,8709,1606,6433,724,791,590,871,9409,824,629,768,577,851,3649,0.128089538318048,0.86878453038674,0.970922882427307,0.977966101694915,0.977037887485649,0.387820172175577
E02004012,"Askham, Ullswater & Greystoke",Eden,North West,741,3141,464,422,326,413,4766,699,3260,403,439,314,416,4832,356,339,417,301,406,1819,0.10920245398773,0.841191066997519,0.949886104783599,0.95859872611465,0.975961538461539,0.376448675496689
E02004013,"Appleby, Shap & Kirkby Thore",Eden,North West,1503,5539,810,803,495,699,8346,1469,5827,766,782,544,703,8622,661,689,746,525,681,3302,0.113437446370345,0.899477806788512,0.953964194373401,0.965073529411765,0.968705547652916,0.382973787984226
E02004014,"Kirkby Stephen, Tebay & Brough",Eden,North West,1110,4320,630,586,431,561,6528,1084,4372,611,616,455,574,6628,480,539,585,441,555,2600,0.109789569990851,0.882160392798691,0.949675324675325,0.969230769230769,0.966898954703833,0.392275196137598
E02004015,"Windermere North, Ambleside & Langdales",South Lakeland,North West,722,3792,434,444,385,638,5693,657,4530,438,392,376,561,6297,777,355,368,361,535,2396,0.171523178807947,0.810502283105023,0.938775510204082,0.960106382978723,0.953654188948306,0.380498650150865
E02004016,Windermere South & Staveley,South Lakeland,North West,1270,4826,511,620,430,603,6990,1133,5619,509,539,446,544,7657,1113,405,505,430,512,2965,0.198077949813134,0.795677799607073,0.936920222634508,0.964125560538117,0.941176470588235,0.387227373645031
E02004017,Kendal North & Burneside,South Lakeland,North West,1488,5331,528,519,363,592,7333,1448,5780,528,567,372,588,7835,1043,468,540,355,572,2978,0.180449826989619,0.886363636363636,0.952380952380952,0.954301075268817,0.972789115646258,0.380089342693044
E02004018,Kendal Town & Greenside,South Lakeland,North West,1478,5323,453,458,278,457,6969,1418,5644,469,456,284,408,7261,995,405,422,265,395,2482,0.176293408929837,0.863539445628998,0.925438596491228,0.933098591549296,0.968137254901961,0.341826194739017
E02004019,Kendal East & Whinfell,South Lakeland,North West,1123,4485,598,685,422,593,6783,990,4612,571,652,466,642,6943,876,514,629,449,623,3091,0.189939288811795,0.900175131348511,0.964723926380368,0.963519313304721,0.970404984423676,0.445196600892986
E02004020,Kendal South,South Lakeland,North West,1480,5027,548,558,422,722,7277,1381,5349,528,620,413,654,7564,1058,473,598,401,637,3167,0.197793980183212,0.895833333333333,0.964516129032258,0.970944309927361,0.974006116207951,0.418693812797462
E02004021,Hawkshead & Cartmel Fell,South Lakeland,North West,649,2995,428,515,337,418,4693,598,3192,406,482,372,393,4845,874,359,458,361,385,2437,0.273809523809524,0.884236453201971,0.950207468879668,0.970430107526882,0.979643765903308,0.502992776057792
E02004022,"Coniston, Broughton & Kirkby",South Lakeland,North West,719,3114,500,486,337,349,4786,725,3288,465,485,315,362,4915,657,407,466,304,347,2181,0.199817518248175,0.875268817204301,0.960824742268041,0.965079365079365,0.958563535911602,0.443743641912513
E02004023,Sedbergh & Kirkby Lonsdale,South Lakeland,North West,1013,3270,522,493,353,546,5184,1081,3652,461,525,368,540,5546,851,436,497,358,528,2670,0.23302300109529,0.945770065075922,0.946666666666667,0.972826086956522,0.977777777777778,0.481428056256762
E02004024,"Burton-in-Kendal, Levens & Natland",South Lakeland,North West,1128,3965,608,640,425,646,6284,1106,4332,541,642,500,653,6668,961,483,611,485,635,3175,0.221837488457987,0.89279112754159,0.951713395638629,0.97,0.972434915773354,0.476154769046191
E02004025,"Arnside, Milnthorpe & Holme",South Lakeland,North West,1197,4177,652,749,516,721,6815,1123,4414,616,727,556,763,7076,1138,526,694,534,741,3633,0.257816039873131,0.853896103896104,0.954607977991747,0.960431654676259,0.971166448230668,0.513425664217072
E02004026,Ulverston,South Lakeland,North West,1278,4960,505,502,337,553,6857,1254,5186,464,517,347,469,6983,1176,386,477,333,449,2821,0.226764365599692,0.831896551724138,0.922630560928433,0.959654178674351,0.957356076759062,0.403981096949735
E02004027,Grange-over-Sands & Cartmel Peninsula,South Lakeland,North West,880,4085,702,842,639,1007,7275,845,4284,711,799,662,986,7442,1401,637,761,635,942,4376,0.32703081232493,0.89592123769339,0.95244055068836,0.959214501510574,0.955375253549696,0.588013974737974
E02004028,Swarthmoor & Low Furness,South Lakeland,North West,1147,4230,586,706,454,601,6577,1083,4462,575,676,513,658,6884,1045,507,646,495,644,3337,0.234199910354101,0.881739130434783,0.955621301775148,0.964912280701754,0.978723404255319,0.484747239976758
E02005176,Harle Syke & Lanehead,Burnley,North West,1792,5148,496,546,326,454,6970,1826,5808,489,534,407,407,7645,1144,423,496,387,386,2836,0.196969696969697,0.865030674846626,0.928838951310862,0.950859950859951,0.948402948402948,0.370961412688031
E02005177,Queensgate,Burnley,North West,1342,3425,293,277,196,411,4602,1463,4122,306,317,204,377,5326,598,235,285,186,356,1660,0.145075206210577,0.76797385620915,0.899053627760252,0.911764705882353,0.944297082228117,0.311678558017274
E02005178,Central Burnley & Daneshouse,Burnley,North West,3150,6338,276,196,125,230,7165,3423,8059,319,232,158,215,8983,594,165,180,118,163,1220,0.0737064151879886,0.517241379310345,0.775862068965517,0.746835443037975,0.758139534883721,0.135812089502393
E02005179,Padiham,Burnley,North West,1810,5453,477,467,349,406,7152,1927,5957,494,473,329,421,7674,1084,420,435,305,389,2633,0.181970790666443,0.850202429149798,0.919661733615222,0.927051671732523,0.923990498812351,0.343106593692989
E02005180,Habergham & Ightenhill,Burnley,North West,1178,3914,447,462,248,452,5523,1153,4288,474,492,316,438,6008,887,392,450,302,421,2452,0.206856343283582,0.827004219409283,0.914634146341463,0.955696202531646,0.961187214611872,0.408122503328895
E02005181,Whittlefield & Rose Grove,Burnley,North West,1303,3883,336,312,218,279,5028,1368,4335,331,329,236,261,5492,763,264,278,217,241,1763,0.1760092272203,0.797583081570997,0.844984802431611,0.919491525423729,0.923371647509579,0.321012381646031
E02005182,Bank Hall & Fulledge,Burnley,North West,1259,3696,281,276,216,297,4766,1329,4196,275,300,222,279,5272,570,200,273,196,252,1491,0.135843660629171,0.727272727272727,0.91,0.882882882882883,0.903225806451613,0.282814871016692
E02005183,Brunshaw & Brownside,Burnley,North West,1043,3447,356,442,273,369,4887,1017,3816,364,391,283,360,5214,745,316,375,271,345,2052,0.195230607966457,0.868131868131868,0.959079283887468,0.957597173144876,0.958333333333333,0.39355581127733
E02005184,"Cliviger, Worsthorne & Lane Bottom",Burnley,North West,727,2835,419,462,313,266,4295,668,3045,395,463,329,308,4540,615,351,442,319,296,2023,0.201970443349754,0.888607594936709,0.954643628509719,0.969604863221885,0.961038961038961,0.445594713656388
E02005185,Barclay Hills & Trinity,Burnley,North West,2110,5625,368,364,227,274,6858,2300,6495,405,365,230,276,7771,911,307,326,207,250,2001,0.140261739799846,0.758024691358025,0.893150684931507,0.9,0.905797101449275,0.257495817784069
E02005186,Hapton & Lowerhouse,Burnley,North West,965,3734,358,392,217,218,4919,1040,4038,353,396,221,265,5273,784,298,356,212,251,1901,0.194155522535909,0.844192634560907,0.898989898989899,0.959276018099547,0.947169811320755,0.360515835387825
E02006881,Rose Hill & Burnley Wood,Burnley,North West,2032,6042,517,602,393,490,8044,2173,6877,587,585,428,476,8953,1281,463,529,400,442,3115,0.186273084193689,0.788756388415673,0.904273504273504,0.934579439252336,0.928571428571429,0.347928068803753
E02005189,Clayton Brook,Chorley,North West,1102,3520,281,279,171,240,4491,1108,3603,291,274,202,252,4622,759,224,252,188,238,1661,0.210657785179018,0.769759450171821,0.91970802919708,0.930693069306931,0.944444444444444,0.359368238857637
E02005190,Brindle & Withnell,Chorley,North West,975,3768,440,419,256,279,5162,887,3904,406,465,314,359,5448,778,368,443,304,344,2237,0.199282786885246,0.906403940886699,0.952688172043011,0.968152866242038,0.958217270194986,0.4106093979442
E02005191,Clayton-le-Woods,Chorley,North West,1765,5634,568,621,356,396,7575,1786,6003,596,634,404,432,8069,1373,514,595,390,416,3288,0.22871897384641,0.86241610738255,0.938485804416404,0.965346534653465,0.962962962962963,0.407485438096418
E02005192,Whittle-le-Woods & Anglezarke,Chorley,North West,1689,5961,422,401,244,276,7304,1708,5914,439,420,275,321,7369,1237,395,395,264,304,2595,0.209164693946568,0.899772209567198,0.940476190476191,0.96,0.947040498442368,0.352150902429095
E02005193,Euxton,Chorley,North West,1430,4839,604,663,415,422,6943,1469,5298,579,656,466,481,7480,1217,514,630,446,460,3267,0.229709324273311,0.887737478411054,0.960365853658537,0.957081545064378,0.956340956340956,0.436764705882353
E02005194,Chorley North,Chorley,North West,1413,4720,475,478,373,477,6523,1364,5252,481,458,371,478,7040,1109,404,423,354,453,2743,0.211157654226961,0.83991683991684,0.923580786026201,0.954177897574124,0.947698744769875,0.389630681818182
E02005195,Croston & Mawdesley,Chorley,North West,1065,5366,479,493,291,378,7007,1059,5102,439,500,323,408,6772,967,394,465,303,381,2510,0.18953351626813,0.89749430523918,0.93,0.938080495356037,0.933823529411765,0.370643827525103
E02005196,Chorley West,Chorley,North West,2278,6259,549,663,439,585,8495,2366,6561,573,665,456,621,8876,1514,519,637,442,593,3705,0.230757506477671,0.905759162303665,0.957894736842105,0.969298245614035,0.954911433172303,0.417417755745831
E02005197,Chorley East,Chorley,North West,1474,4709,326,347,235,265,5882,1452,4912,343,339,245,278,6117,971,282,312,231,258,2054,0.197679153094463,0.822157434402332,0.920353982300885,0.942857142857143,0.928057553956835,0.335785515775707
E02005198,Chorley Town & South,Chorley,North West,1929,6236,427,494,340,421,7918,1873,6345,394,510,371,446,8066,1285,341,470,352,421,2869,0.202521670606777,0.865482233502538,0.92156862745098,0.948787061994609,0.943946188340807,0.355690552938259
E02005199,Eccleston & Charnock Richard,Chorley,North West,1211,4449,526,615,420,435,6445,1199,4650,507,608,458,500,6723,1077,446,580,447,475,3025,0.231612903225806,0.879684418145957,0.953947368421053,0.975982532751092,0.95,0.449947939907779
E02005200,Chorley South West,Chorley,North West,2168,6076,384,308,195,308,7271,1998,6031,380,362,203,288,7264,1223,328,329,190,263,2333,0.202785607693583,0.863157894736842,0.908839779005525,0.935960591133005,0.913194444444444,0.321172907488987
E02005201,Coppull,Chorley,North West,1546,5143,515,430,359,377,6824,1487,5259,462,466,377,434,6998,1201,383,444,364,413,2805,0.228370412625975,0.829004329004329,0.952789699570815,0.96551724137931,0.951612903225806,0.400828808230923
E02005202,Adlington & Rivington,Chorley,North West,1778,6113,647,703,493,597,8553,1710,6235,607,689,512,616,8659,1365,462,647,490,576,3540,0.218925421010425,0.761120263591433,0.939042089985486,0.95703125,0.935064935064935,0.408823189744774
E02005203,"Elswick, Singleton & Weeton",Fylde,North West,1396,4520,583,582,413,458,6556,1495,5913,621,640,483,512,8169,1488,553,591,468,490,3590,0.251648909183156,0.890499194847021,0.9234375,0.968944099378882,0.95703125,0.439466274941853
E02005204,Kirkham & Wesham,Fylde,North West,2179,7387,675,718,514,545,9839,2240,8007,688,795,523,613,10626,1762,604,753,496,594,4209,0.220057449731485,0.877906976744186,0.947169811320755,0.948374760994264,0.969004893964111,0.396103896103896
E02005205,Clifton & Newton-with-Scales,Fylde,North West,1136,4255,414,485,311,324,5789,1014,4237,398,465,344,328,5772,786,340,443,330,317,2216,0.185508614585792,0.85427135678392,0.952688172043011,0.959302325581395,0.966463414634146,0.383922383922384
E02005206,St Annes North & Airport,Fylde,North West,1328,4129,511,519,360,501,6020,1199,4304,537,505,380,507,6233,1034,480,476,361,477,2828,0.240241635687732,0.893854748603352,0.942574257425743,0.95,0.940828402366864,0.453714102358415
E02005207,Heyhouses & Park,Fylde,North West,1284,4504,664,754,498,789,7209,1206,4781,652,746,582,819,7580,1157,598,708,554,780,3797,0.241999581677473,0.91717791411043,0.949061662198391,0.951890034364261,0.952380952380952,0.500923482849604
E02005208,St Annes Town,Fylde,North West,1324,5785,672,758,538,1108,8861,1249,6389,681,757,594,1092,9513,1335,588,697,556,1026,4202,0.208952887775865,0.863436123348018,0.920739762219287,0.936026936026936,0.93956043956044,0.441711342373594
E02005209,Warton & Freckleton,Fylde,North West,1335,4891,588,645,425,532,7081,1328,5162,635,641,517,588,7543,1037,556,613,497,561,3264,0.200891127469973,0.875590551181102,0.956318252730109,0.961315280464217,0.954081632653061,0.432719077290203
E02005210,Ansdell & Fairhaven,Fylde,North West,1339,5290,815,902,713,1278,8998,1313,5512,811,891,738,1271,9223,1293,729,837,701,1220,4780,0.234579100145138,0.898890258939581,0.939393939393939,0.949864498644986,0.959874114870181,0.518269543532473
E02005211,Lytham,Fylde,North West,1252,5164,607,732,515,836,7854,1067,5112,594,692,623,837,7858,1137,521,648,580,806,3692,0.222417840375587,0.877104377104377,0.936416184971098,0.930979133226324,0.962962962962963,0.469839653855943
E02005212,Great Harwood,Hyndburn,North West,2079,6601,618,645,473,574,8911,2056,6951,599,647,462,628,9287,1166,512,591,439,584,3292,0.167745648108186,0.854757929883139,0.913446676970634,0.95021645021645,0.929936305732484,0.354473995908259
E02005213,Clayton-le-Moors & Huncoat,Hyndburn,North West,2255,7011,599,611,352,512,9085,2331,7575,653,663,392,502,9785,1335,590,608,373,477,3383,0.176237623762376,0.903522205206738,0.917043740573152,0.951530612244898,0.950199203187251,0.34573326520184
E02005214,Rishton,Hyndburn,North West,1181,3932,349,378,279,305,5243,1188,4404,369,385,301,310,5769,791,321,362,289,294,2057,0.17960944595822,0.869918699186992,0.94025974025974,0.960132890365449,0.948387096774194,0.356560929103831
E02005215,Accrington North East,Hyndburn,North West,2509,7507,609,634,439,674,9863,2491,8142,612,621,446,580,10401,1286,520,559,415,537,3317,0.157946450503562,0.849673202614379,0.900161030595813,0.930493273542601,0.925862068965517,0.318911643111239
E02005216,Church,Hyndburn,North West,1220,3308,232,313,164,176,4193,1162,3604,264,285,202,200,4555,561,217,259,185,183,1405,0.155660377358491,0.821969696969697,0.908771929824561,0.915841584158416,0.915,0.308452250274424
E02005217,Accrington West,Hyndburn,North West,3871,7608,367,329,240,328,8872,4022,8960,389,335,263,351,10298,853,255,275,220,281,1884,0.0952008928571428,0.655526992287918,0.82089552238806,0.836501901140684,0.8005698005698,0.182948145270926
E02005218,Oswaldtwistle,Hyndburn,North West,1426,4427,351,442,270,381,5871,1394,4747,349,418,308,406,6228,846,294,390,295,379,2204,0.178217821782178,0.842406876790831,0.933014354066986,0.957792207792208,0.933497536945813,0.3538856775851
E02005219,Accrington South East,Hyndburn,North West,1461,5213,477,513,343,391,6937,1461,5655,493,514,351,398,7411,954,431,486,328,371,2570,0.168700265251989,0.874239350912779,0.945525291828794,0.934472934472934,0.9321608040201,0.346781810821752
E02005220,Broadfield & Knuzden,Hyndburn,North West,868,3580,422,463,353,380,5198,885,3644,428,457,336,390,5255,732,376,432,324,371,2235,0.200878155872667,0.878504672897196,0.945295404814004,0.964285714285714,0.951282051282051,0.425309229305423
E02005221,"Carnforth, Silverdale & Warton",Lancaster,North West,1559,5540,732,750,563,742,8327,1531,5846,774,808,566,764,8758,1667,657,776,540,726,4366,0.285152240848443,0.848837209302326,0.96039603960396,0.954063604240283,0.950261780104712,0.498515642840831
E02005222,Kellet & Lune Valley,Lancaster,North West,1004,3481,469,531,367,468,5316,873,3701,479,552,398,501,5631,997,419,523,382,474,2795,0.269386652256147,0.874739039665971,0.947463768115942,0.959798994974874,0.946107784431138,0.496359438820813
E02005223,Hest Bank & Bolton-le-Sands,Lancaster,North West,1051,3806,550,624,433,676,6089,1033,4187,593,651,480,664,6575,1319,510,622,466,649,3566,0.315022689276332,0.860033726812816,0.955453149001536,0.970833333333333,0.977409638554217,0.542357414448669
E02005224,Bare,Lancaster,North West,665,2496,389,470,430,789,4574,603,2593,397,459,447,790,4686,752,355,437,419,756,2719,0.29001156961049,0.894206549118388,0.952069716775599,0.937360178970917,0.956962025316456,0.580239009816475
E02005225,Halton & Caton,Lancaster,North West,1020,3147,385,430,280,404,4646,1009,3477,400,439,305,429,5050,990,367,417,300,412,2486,0.284728213977567,0.9175,0.949886104783599,0.983606557377049,0.96037296037296,0.492277227722772
E02005226,Morecambe Town,Lancaster,North West,1661,4790,417,357,265,388,6217,1610,5250,418,381,276,421,6746,1193,298,323,250,380,2444,0.227238095238095,0.712918660287081,0.847769028871391,0.905797101449275,0.902612826603325,0.362288763711829
E02005228,Morecambe South West,Lancaster,North West,1249,3547,320,294,230,361,4752,1172,3804,328,325,187,293,4937,1043,271,306,175,280,2075,0.274185068349106,0.826219512195122,0.941538461538462,0.935828877005348,0.955631399317406,0.420295726149484
E02005229,Morecambe West End,Lancaster,North West,1193,3815,262,266,139,193,4675,1186,4244,281,234,165,188,5112,873,205,209,149,174,1610,0.205702167766258,0.729537366548043,0.893162393162393,0.903030303030303,0.925531914893617,0.314945226917058
E02005230,Morecambe Westgate,Lancaster,North West,1310,3750,452,480,318,408,5408,1355,4255,451,493,379,450,6028,1045,371,456,364,423,2659,0.245593419506463,0.822616407982262,0.924949290060852,0.96042216358839,0.94,0.441108161911082
E02005231,Skerton & Vale,Lancaster,North West,1623,5356,379,366,192,252,6545,1716,5798,411,374,201,285,7069,1417,333,334,193,262,2539,0.244394618834081,0.81021897810219,0.893048128342246,0.960199004975124,0.919298245614035,0.359173857688499
E02005233,Lancaster East,Lancaster,North West,1415,5214,323,270,161,224,6192,1622,5940,356,306,188,213,7003,1426,311,276,175,192,2380,0.24006734006734,0.873595505617977,0.901960784313725,0.930851063829787,0.901408450704225,0.339854348136513
E02005234,Lancaster Central,Lancaster,North West,941,7376,263,172,129,231,8171,933,7144,243,230,151,226,7994,1032,196,211,139,209,1787,0.144456886898096,0.806584362139918,0.917391304347826,0.920529801324503,0.924778761061947,0.223542656992745
E02005235,Moorlands & Greaves,Lancaster,North West,672,4822,130,145,89,173,5359,571,4074,139,130,88,140,4571,711,113,124,82,130,1160,0.174521354933726,0.81294964028777,0.953846153846154,0.931818181818182,0.928571428571429,0.253773791292934
E02005236,Heysham & Overton,Lancaster,North West,2826,8083,767,835,593,680,10958,2719,8575,826,885,699,767,11752,2315,708,831,654,727,5235,0.26997084548105,0.857142857142857,0.938983050847458,0.935622317596567,0.947848761408084,0.445456092579986
E02005237,"Marsh, Haverbreaks & Scotforth West",Lancaster,North West,1931,7102,484,499,299,508,8892,1928,7356,493,492,325,479,9145,1720,433,457,305,449,3364,0.233822729744426,0.878296146044625,0.928861788617886,0.938461538461539,0.937369519832985,0.367851284855112
E02005238,Scotforth East & Bowerham,Lancaster,North West,1098,3657,265,290,211,335,4758,1070,3844,321,283,186,349,4983,957,283,272,179,336,2027,0.248959417273673,0.881619937694704,0.96113074204947,0.96236559139785,0.962750716332378,0.406783062412201
E02005239,"University, Galgate & Dolphinholme",Lancaster,North West,1085,9335,424,446,278,351,10834,1176,16243,430,452,290,406,17821,1220,385,429,278,387,2699,0.075109277842763,0.895348837209302,0.949115044247788,0.958620689655172,0.95320197044335,0.151450535884631
E02006871,Scale Hall & Torrisholme,Lancaster,North West,2273,7039,699,694,545,772,9749,2294,7712,741,712,569,772,10506,2156,661,677,554,747,4795,0.279564315352697,0.892037786774629,0.950842696629213,0.973637961335677,0.967616580310881,0.4564058633162
E02005240,Barnoldswick North,Pendle,North West,1014,3250,339,278,211,272,4350,1140,3610,298,332,243,332,4815,480,210,297,219,310,1516,0.132963988919668,0.704697986577181,0.894578313253012,0.901234567901234,0.933734939759036,0.31484942886812
E02005241,Barnoldswick South,Pendle,North West,914,3383,348,375,227,283,4616,960,3624,366,391,221,266,4868,468,259,354,204,252,1537,0.129139072847682,0.707650273224044,0.90537084398977,0.923076923076923,0.947368421052632,0.315735414954807
E02005242,Earby & Salterforth,Pendle,North West,1129,3611,409,417,255,347,5039,1079,3834,400,448,280,323,5285,483,254,410,264,310,1721,0.125978090766823,0.635,0.915178571428571,0.942857142857143,0.959752321981424,0.325638599810785
E02005243,Colne Horsfield,Pendle,North West,878,2969,297,300,167,322,4055,928,3254,306,346,190,285,4381,439,227,311,175,264,1416,0.134910878918254,0.741830065359477,0.898843930635838,0.921052631578947,0.926315789473684,0.323213878110021
E02005244,Colne Vivary Bridge,Pendle,North West,1369,3540,320,293,179,270,4602,1308,3837,285,318,171,300,4911,501,229,279,157,277,1443,0.130570758405004,0.803508771929825,0.877358490566038,0.91812865497076,0.923333333333333,0.293830177153329
E02005245,"East Colne, Foulridge & Trawden",Pendle,North West,1026,4179,491,460,325,373,5828,1121,4329,444,476,360,360,5969,672,363,445,331,336,2147,0.155232155232155,0.817567567567568,0.934873949579832,0.919444444444444,0.933333333333333,0.359691740660077
E02005246,Colne Waterside,Pendle,North West,985,3293,290,269,161,210,4223,1074,3668,282,262,171,237,4620,452,196,232,160,218,1258,0.123227917121047,0.695035460992908,0.885496183206107,0.935672514619883,0.919831223628692,0.272294372294372
E02005247,"Barrowford, Higham & Pendleside",Pendle,North West,1501,5587,700,769,490,624,8170,1571,5868,706,799,562,646,8581,1025,622,754,534,618,3553,0.174676209952284,0.881019830028329,0.943679599499374,0.950177935943061,0.956656346749226,0.414054306024939
E02005248,Nelson Bradley,Pendle,North West,1844,4264,254,225,150,190,5083,2131,5259,324,235,153,210,6181,513,231,191,137,188,1260,0.0975470621791215,0.712962962962963,0.812765957446809,0.895424836601307,0.895238095238095,0.203850509626274
E02005249,Nelson East,Pendle,North West,2632,6438,372,346,234,289,7679,2879,7412,435,357,237,290,8731,679,306,287,205,259,1736,0.0916082029141932,0.703448275862069,0.803921568627451,0.864978902953587,0.893103448275862,0.198831748940557
E02005250,Nelson West,Pendle,North West,2390,5253,264,208,143,254,6122,2782,6486,324,244,138,256,7448,572,214,186,105,205,1282,0.0881899475794018,0.660493827160494,0.762295081967213,0.760869565217391,0.80078125,0.172126745435016
E02005251,Marsden,Pendle,North West,1617,4085,403,410,272,418,5588,1769,4546,346,405,269,397,5963,673,291,367,255,363,1949,0.148042234931808,0.841040462427746,0.906172839506173,0.947955390334572,0.914357682619647,0.326848901559618
E02005252,Brierfield & Reedley,Pendle,North West,2187,5564,498,463,342,404,7271,2557,6830,488,491,376,442,8627,865,357,434,336,396,2388,0.126647144948755,0.73155737704918,0.883910386965377,0.893617021276596,0.895927601809955,0.276805378462965
E02005253,Grimsargh & Goosnargh,Preston,North West,1239,3745,370,430,274,361,5180,1289,4383,395,453,308,399,5938,925,357,438,297,389,2406,0.211042664841433,0.90379746835443,0.966887417218543,0.964285714285714,0.974937343358396,0.40518693162681
E02005254,Broughton & Wychnor,Preston,North West,1529,4227,415,441,312,387,5782,1942,5594,491,501,362,448,7396,1438,449,481,351,435,3154,0.257061136932428,0.914460285132383,0.960079840319361,0.969613259668508,0.970982142857143,0.42644672796106
E02005255,Fulwood,Preston,North West,1702,5092,481,536,416,627,7152,1855,5973,510,543,442,649,8117,1618,461,518,419,628,3644,0.270885652101122,0.903921568627451,0.953959484346225,0.947963800904977,0.967642526964561,0.448934335345571
E02005256,Longsands,Preston,North West,1200,4258,317,268,196,374,5413,1227,4658,336,306,237,419,5956,1258,304,283,233,400,2478,0.27007299270073,0.904761904761905,0.92483660130719,0.983122362869198,0.954653937947494,0.416051040967092
E02005257,Ingol,Preston,North West,1266,3555,348,311,200,342,4756,1188,3667,307,321,210,319,4824,781,258,302,190,299,1830,0.212980638123807,0.840390879478827,0.940809968847352,0.904761904761905,0.93730407523511,0.379353233830846
E02005258,Cadley & College,Preston,North West,1512,4568,457,456,358,527,6366,1620,5394,440,478,378,618,7308,1401,386,439,358,590,3174,0.259733036707453,0.877272727272727,0.918410041841004,0.947089947089947,0.954692556634304,0.43431855500821
E02005259,Brookfield & Holme Slack,Preston,North West,2448,6082,459,399,291,493,7724,2550,7066,489,443,298,504,8800,1338,397,407,279,469,2890,0.189357486555335,0.811860940695297,0.918735891647855,0.936241610738255,0.930555555555556,0.328409090909091
E02005260,Haslam Park,Preston,North West,1245,3797,387,360,320,490,5354,1179,4383,365,399,314,476,5937,995,325,379,305,455,2459,0.227013461099703,0.89041095890411,0.949874686716792,0.971337579617834,0.955882352941176,0.414182246926057
E02005261,Ribbleton,Preston,North West,2819,6222,416,291,176,297,7402,2828,7376,452,365,209,307,8709,1083,353,324,188,257,2205,0.146827548806941,0.780973451327434,0.887671232876712,0.899521531100479,0.8371335504886,0.253186358939029
E02005262,Lea & Marina,Preston,North West,1231,4420,277,245,149,192,5283,1340,4857,320,284,187,220,5868,1046,288,261,171,210,1976,0.215359275272802,0.9,0.919014084507042,0.914438502673797,0.954545454545455,0.336741649625085
E02005263,Moor Park,Preston,North West,1549,5003,193,137,120,140,5593,1597,5832,228,154,111,176,6501,797,163,133,93,148,1334,0.136659807956104,0.714912280701754,0.863636363636364,0.837837837837838,0.840909090909091,0.205199200123058
E02005264,Plungington & University,Preston,North West,2006,9505,336,287,200,244,10572,2047,10528,398,289,202,233,11650,1532,316,260,186,216,2510,0.145516717325228,0.793969849246231,0.899653979238754,0.920792079207921,0.927038626609442,0.215450643776824
E02005265,Ashton-on-Ribble & Larches,Preston,North West,2259,6643,499,416,327,520,8405,2280,7602,536,459,341,495,9433,1610,466,411,312,462,3261,0.211786372007366,0.869402985074627,0.895424836601307,0.914956011730205,0.933333333333333,0.345701261528676
E02005266,St Matthew's,Preston,North West,2239,5700,259,183,134,179,6455,2420,7343,280,208,115,171,8117,768,198,170,105,148,1389,0.104589404875392,0.707142857142857,0.817307692307692,0.91304347826087,0.865497076023392,0.171122335838364
E02005267,St George's,Preston,North West,1173,5532,178,133,82,119,6044,1240,6618,171,127,72,119,7107,615,122,105,63,102,1007,0.0929283771532185,0.713450292397661,0.826771653543307,0.875,0.857142857142857,0.141691290277192
E02005268,Frenchwood & Fishwick,Preston,North West,2493,5785,330,245,195,285,6840,2547,7109,370,266,203,285,8233,938,269,229,168,250,1854,0.131945421296948,0.727027027027027,0.860902255639098,0.827586206896552,0.87719298245614,0.225191303291631
E02005269,Preston Town Centre,Preston,North West,1382,8610,323,239,137,213,9522,1646,9896,351,263,143,230,10883,1036,257,216,121,194,1824,0.104688763136621,0.732193732193732,0.821292775665399,0.846153846153846,0.843478260869565,0.167600845355141
E02005270,"Waddington, Gisburn & Slaidburn",Ribble Valley,North West,1069,4332,517,570,359,438,6216,1174,4773,568,553,425,492,6811,595,515,516,413,477,2516,0.124659543264194,0.90669014084507,0.933092224231465,0.971764705882353,0.969512195121951,0.369402437233886
E02005271,Clitheroe North,Ribble Valley,North West,1385,4706,446,476,329,582,6539,1339,5018,428,495,361,574,6876,741,388,467,346,559,2501,0.147668393782383,0.906542056074766,0.943434343434343,0.958448753462604,0.973867595818815,0.363728912158232
E02005272,Clitheroe South,Ribble Valley,North West,1663,5256,478,484,295,553,7066,1667,5628,453,550,331,536,7498,933,418,527,328,516,2722,0.165778251599147,0.922737306843267,0.958181818181818,0.990936555891239,0.962686567164179,0.363030141371032
E02005273,"Longridge North, Ribchester & Chipping",Ribble Valley,North West,925,3534,365,412,268,388,4967,848,3613,422,379,315,395,5124,643,379,362,307,380,2071,0.177968447273734,0.898104265402844,0.955145118733509,0.974603174603175,0.962025316455696,0.404176424668228
E02005274,"Read, Sabden & Chatburn",Ribble Valley,North West,1267,4469,430,591,346,429,6265,1261,4886,464,561,387,465,6763,764,410,523,375,443,2515,0.1563651248465,0.883620689655172,0.932263814616756,0.968992248062015,0.952688172043011,0.371876386219134
E02005275,Longridge South,Ribble Valley,North West,1148,3359,348,328,231,393,4659,1005,3587,378,376,272,364,4977,675,350,363,264,345,1997,0.188179537217731,0.925925925925926,0.965425531914894,0.970588235294118,0.947802197802198,0.401245730359654
E02005276,Whalley & Brockhall,Ribble Valley,North West,1572,5603,575,522,370,476,7546,1483,5846,537,553,416,538,7890,1099,495,530,394,512,3030,0.187991789257612,0.921787709497207,0.958408679927667,0.947115384615385,0.951672862453531,0.384030418250951
E02005277,Wilpshire & Mellor,Ribble Valley,North West,1284,4879,567,686,522,663,7317,1282,5336,617,643,554,710,7860,1229,549,613,540,676,3607,0.230322338830585,0.889789303079417,0.953343701399689,0.974729241877256,0.952112676056338,0.458905852417303
E02005278,"Crawshawbooth, Reedsholme & Water",Rossendale,North West,1460,5044,533,489,223,270,6559,1415,5253,528,486,262,310,6839,1007,426,449,250,296,2428,0.191699980963259,0.806818181818182,0.923868312757202,0.954198473282443,0.954838709677419,0.355022664132183
E02005279,Haslingden,Rossendale,North West,2253,6504,470,464,311,480,8229,2189,6895,475,499,320,431,8620,1063,374,455,300,399,2591,0.15416968817984,0.787368421052632,0.911823647294589,0.9375,0.925754060324826,0.300580046403712
E02005280,Bacup,Rossendale,North West,2354,6836,583,501,313,413,8646,2446,7266,604,550,343,370,9133,1285,433,513,320,339,2890,0.176851087255712,0.716887417218543,0.932727272727273,0.932944606413994,0.916216216216216,0.316434906383445
E02005281,Rawtenstall,Rossendale,North West,1840,5599,459,403,288,391,7140,1843,5919,448,424,303,392,7486,987,324,398,279,365,2353,0.166751140395337,0.723214285714286,0.938679245283019,0.920792079207921,0.931122448979592,0.31432006411969
E02005284,Helmshore,Rossendale,North West,1113,3556,408,439,260,370,5033,1043,3686,395,445,314,411,5251,744,321,422,300,393,2180,0.201844818231145,0.812658227848101,0.948314606741573,0.955414012738854,0.956204379562044,0.415159017330032
E02005285,Townsend Fold & Edenfield,Rossendale,North West,1090,3837,411,432,240,416,5336,1054,3976,374,465,314,361,5490,864,325,439,296,349,2273,0.217303822937626,0.868983957219251,0.944086021505376,0.942675159235669,0.966759002770083,0.414025500910747
E02005286,Whitworth,Rossendale,North West,1452,4906,456,446,295,330,6433,1385,5107,448,454,318,386,6713,1163,343,413,310,365,2594,0.227726649696495,0.765625,0.909691629955947,0.974842767295597,0.94559585492228,0.386414419782512
E02006884,Waterfoot & Stacksteads,Rossendale,North West,2460,7785,704,688,431,476,10084,2394,8058,695,708,474,537,10472,1358,514,645,449,505,3471,0.168528170761976,0.739568345323741,0.911016949152542,0.947257383966245,0.940409683426443,0.331455309396486
E02005287,Penwortham North,South Ribble,North West,1010,3122,329,335,204,361,4351,941,3414,318,344,247,366,4689,660,285,327,237,359,1868,0.193321616871705,0.89622641509434,0.950581395348837,0.959514170040486,0.980874316939891,0.398379185327362
E02005288,Gregson Lane & Coupe Green,South Ribble,North West,920,3568,410,440,365,430,5213,883,3584,423,405,348,359,5119,607,343,387,333,346,2016,0.169363839285714,0.810874704491726,0.955555555555556,0.956896551724138,0.963788300835655,0.39382691932018
E02005289,Penwortham South,South Ribble,North West,855,3490,423,441,317,405,5076,922,3670,410,472,327,426,5305,731,371,458,321,409,2290,0.199182561307902,0.904878048780488,0.970338983050847,0.981651376146789,0.960093896713615,0.431668237511781
E02005290,Walton-le-Dale,South Ribble,North West,1304,4679,365,379,214,296,5933,1142,4629,379,394,256,319,5977,795,316,376,241,310,2038,0.171743357096565,0.83377308707124,0.954314720812183,0.94140625,0.971786833855799,0.340973732641794
E02005291,Lower Penwortham North,South Ribble,North West,1033,3506,312,321,226,241,4606,1035,3757,307,349,231,296,4940,706,264,328,218,283,1799,0.187915890338036,0.859934853420196,0.939828080229226,0.943722943722944,0.956081081081081,0.36417004048583
E02005292,Lower Penwortham South,South Ribble,North West,1201,3417,323,333,192,369,4634,1145,3589,321,355,209,313,4787,555,270,337,196,301,1659,0.154639175257732,0.841121495327103,0.949295774647887,0.937799043062201,0.961661341853035,0.346563609776478
E02005293,Bamber Bridge West,South Ribble,North West,948,3196,304,348,278,379,4505,941,3289,310,336,240,414,4589,520,229,307,232,391,1679,0.158102766798419,0.738709677419355,0.913690476190476,0.966666666666667,0.944444444444444,0.36587491828285
E02005294,Bamber Bridge East,South Ribble,North West,1381,4302,303,297,212,317,5431,1472,4728,306,321,233,301,5889,740,222,307,224,291,1784,0.156514382402707,0.725490196078431,0.956386292834891,0.96137339055794,0.966777408637874,0.302937680421124
E02005295,Lostock Hall,South Ribble,North West,1325,4605,410,367,297,373,6052,1290,4811,437,405,307,400,6360,842,349,384,293,382,2250,0.175015589274579,0.79862700228833,0.948148148148148,0.954397394136808,0.955,0.35377358490566
E02005296,New Longton & Hutton,South Ribble,North West,960,3290,403,493,344,489,5019,1029,3636,393,504,348,476,5357,678,338,477,336,451,2280,0.186468646864686,0.860050890585242,0.946428571428571,0.96551724137931,0.947478991596639,0.42561134963599
E02005297,Longton & Walmer Bridge,South Ribble,North West,1302,4716,590,651,451,632,7040,1255,5030,549,642,492,658,7371,877,461,616,484,641,3079,0.174353876739563,0.839708561020036,0.959501557632399,0.983739837398374,0.974164133738602,0.417718084384751
E02005298,Farington,South Ribble,North West,1365,4696,489,473,259,367,6284,1453,5014,462,470,300,367,6613,1049,386,454,287,351,2527,0.20921420023933,0.835497835497836,0.965957446808511,0.956666666666667,0.956403269754768,0.382126115227582
E02005299,Leyland North,South Ribble,North West,1603,5049,298,284,209,251,6091,1484,5258,347,327,232,274,6438,1183,279,307,224,262,2255,0.224990490680867,0.804034582132565,0.938837920489297,0.96551724137931,0.956204379562044,0.350264057160609
E02005300,Moss Side,South Ribble,North West,951,3173,348,316,184,144,4165,901,3263,364,329,194,185,4335,793,311,311,185,175,1775,0.243027888446215,0.854395604395604,0.945288753799392,0.95360824742268,0.945945945945946,0.409457900807382
E02005301,Leyland South West,South Ribble,North West,1152,3835,367,350,286,399,5237,1043,3963,373,357,287,397,5377,959,316,337,271,375,2258,0.241988392631845,0.847184986595174,0.943977591036415,0.944250871080139,0.944584382871536,0.419936767714339
E02005302,Leyland South East & Buckshaw Village,South Ribble,North West,1510,4403,423,466,321,392,6005,1530,4930,428,484,337,410,6589,1127,379,459,315,393,2673,0.228600405679513,0.885514018691589,0.948347107438017,0.934718100890208,0.958536585365854,0.40567612687813
E02005303,Seven Stars,South Ribble,North West,1354,3766,374,324,220,288,4972,1324,4010,347,337,224,306,5224,954,287,310,216,290,2057,0.237905236907731,0.827089337175793,0.919881305637982,0.964285714285714,0.947712418300654,0.393759571209801
E02005304,Hesketh Bank & Tarleton,West Lancashire,North West,1437,5040,581,664,421,531,7237,1445,5438,570,695,521,549,7773,1000,504,661,503,533,3201,0.183891136447223,0.884210526315789,0.951079136690647,0.965451055662188,0.970856102003643,0.411810111925897
E02005305,Rufford & Banks,West Lancashire,North West,1136,4312,584,634,426,495,6451,1130,4749,674,656,471,527,7077,1109,562,617,447,509,3244,0.23352284691514,0.833827893175074,0.940548780487805,0.949044585987261,0.96584440227704,0.458386321887806
E02005306,"Scarisbrick, Halsall & Haskayne",West Lancashire,North West,1027,4214,573,608,381,485,6261,1031,4501,599,611,404,541,6656,1197,541,566,389,518,3211,0.265940902021773,0.903171953255426,0.926350245499182,0.962871287128713,0.957486136783734,0.482421875
E02005307,Burscough,West Lancashire,North West,1713,5498,515,595,401,584,7593,1686,6020,531,614,440,538,8143,1355,479,586,425,522,3367,0.225083056478405,0.902071563088512,0.954397394136808,0.965909090909091,0.970260223048327,0.413483973965369
E02005308,"Parbold, Appley Bridge & Wrightington",West Lancashire,North West,1056,3777,446,531,411,490,5655,992,4022,429,529,434,498,5912,906,394,504,410,449,2663,0.22526106414719,0.918414918414918,0.952741020793951,0.944700460829493,0.901606425702811,0.450439783491204
E02005309,Ormskirk North & West,West Lancashire,North West,1351,4953,466,501,432,618,6970,1391,5321,509,550,419,632,7431,1618,486,534,405,601,3644,0.304078180793084,0.954813359528487,0.970909090909091,0.966587112171838,0.950949367088608,0.490378145606244
E02005310,Ormskirk Town & East,West Lancashire,North West,970,6577,389,412,339,599,8316,913,5478,366,453,357,552,7206,1359,331,428,346,532,2996,0.248083242059146,0.904371584699454,0.944812362030905,0.969187675070028,0.963768115942029,0.415764640577297
E02005311,Bickerstaffe & Newburgh,West Lancashire,North West,751,4260,388,411,330,421,5810,708,3928,423,422,327,420,5520,984,383,411,319,403,2500,0.25050916496945,0.905437352245863,0.9739336492891,0.975535168195719,0.959523809523809,0.452898550724638
E02005312,Skelmersdale Ashurst,West Lancashire,North West,957,3711,413,363,181,286,4954,974,4080,416,402,222,280,5400,1247,357,367,205,261,2437,0.305637254901961,0.858173076923077,0.912935323383085,0.923423423423423,0.932142857142857,0.451296296296296
E02005313,Skelmersdale Central,West Lancashire,North West,2167,5523,330,320,203,248,6624,2105,6165,387,326,237,271,7386,1448,309,296,217,246,2516,0.234874290348743,0.798449612403101,0.907975460122699,0.915611814345992,0.907749077490775,0.340644462496615
E02005314,Skelmersdale West,West Lancashire,North West,1151,4034,328,320,256,316,5254,1134,4208,340,317,265,336,5466,1103,290,293,251,313,2250,0.262119771863118,0.852941176470588,0.924290220820189,0.947169811320755,0.931547619047619,0.411635565312843
E02005315,Aughton,West Lancashire,North West,1327,4277,510,606,506,790,6689,1290,4815,506,603,518,808,7250,1462,478,581,498,795,3814,0.303634475597092,0.944664031620553,0.963515754560531,0.961389961389961,0.983910891089109,0.526068965517241
E02005316,Skelmersdale East,West Lancashire,North West,1635,4069,272,262,169,232,5004,1537,4466,270,260,206,213,5415,958,221,232,196,199,1806,0.214509628302732,0.818518518518519,0.892307692307692,0.951456310679612,0.934272300469484,0.333518005540166
E02005317,Skelmersdale South East,West Lancashire,North West,1808,4482,293,286,179,203,5443,1811,5009,299,292,197,160,5957,988,254,260,180,150,1832,0.197244959073667,0.849498327759197,0.89041095890411,0.913705583756345,0.9375,0.307537351015612
E02005318,Upholland,West Lancashire,North West,1271,4509,464,417,358,540,6288,1232,4764,465,469,340,523,6561,1420,417,449,324,495,3105,0.298068849706129,0.896774193548387,0.957356076759062,0.952941176470588,0.946462715105163,0.473251028806584
E02005319,Fleetwood Town,Wyre,North West,1342,5007,478,439,343,411,6678,1483,5734,507,440,328,436,7445,1631,438,400,292,398,3159,0.284443669340774,0.863905325443787,0.909090909090909,0.890243902439024,0.912844036697248,0.42431161853593
E02005320,Fleetwood Warren,Wyre,North West,1136,3444,369,322,264,433,4832,1108,3505,332,325,268,437,4867,1144,306,307,253,406,2416,0.326390870185449,0.921686746987952,0.944615384615385,0.944029850746269,0.929061784897025,0.496404355866037
E02005321,Fleetwood Rossall & Chatsworth,Wyre,North West,1109,3353,406,494,397,512,5162,1115,3512,455,440,383,497,5287,1092,414,408,365,479,2758,0.310933940774488,0.90989010989011,0.927272727272727,0.953002610966058,0.963782696177062,0.521656894268962
E02005322,"Preesall, Stalmine & Hambleton",Wyre,North West,1386,5293,868,1008,757,999,8925,1363,5543,867,1078,778,980,9246,1291,655,1013,746,942,4647,0.232906368392567,0.755478662053057,0.939703153988868,0.958868894601542,0.961224489795918,0.50259571706684
E02005323,Fleetwood South East,Wyre,North West,1572,4424,455,445,297,316,5937,1564,4819,446,470,305,349,6389,1514,413,431,293,333,2984,0.314173064951235,0.926008968609865,0.917021276595745,0.960655737704918,0.954154727793696,0.467052746908749
E02005324,"Bonds, Bilsborrow & Wyresdale",Wyre,North West,1039,4134,458,447,327,466,5832,1056,4188,426,453,312,467,5846,761,361,428,300,446,2296,0.18170964660936,0.847417840375587,0.944812362030905,0.961538461538461,0.955032119914347,0.392747177557304
E02005325,Garstang & Catterall,Wyre,North West,1349,4892,723,850,631,889,7985,1345,5125,756,874,704,961,8420,1170,595,832,686,939,4222,0.228292682926829,0.787037037037037,0.951945080091533,0.974431818181818,0.977107180020812,0.501425178147268
E02005326,Cleveleys West,Wyre,North West,1141,4629,646,693,536,879,7383,1077,4923,626,717,526,807,7599,1533,579,666,496,743,4017,0.31139549055454,0.924920127795527,0.928870292887029,0.94296577946768,0.920693928128872,0.528622187129886
E02005327,"Pilling, Great Eccleston & Inskip",Wyre,North West,1026,3678,483,497,368,412,5438,1019,3922,471,516,376,410,5695,783,380,493,360,401,2417,0.199643039265681,0.806794055201699,0.955426356589147,0.957446808510638,0.978048780487805,0.424407374890255
E02005328,Cleveleys East,Wyre,North West,953,4233,620,654,502,652,6661,988,4326,602,671,513,678,6790,1534,564,635,493,651,3877,0.35460009246417,0.93687707641196,0.946348733233979,0.961013645224171,0.960176991150442,0.570986745213549
E02005329,Thornton West,Wyre,North West,1763,5793,485,541,422,574,7815,1770,5912,475,531,387,606,7911,1933,435,501,368,577,3814,0.326962110960758,0.91578947368421,0.943502824858757,0.950904392764858,0.952145214521452,0.482113512830236
E02005330,Thornton East & Carleton West,Wyre,North West,1433,5146,640,757,518,658,7719,1247,5023,641,756,565,676,7661,1834,605,724,555,651,4369,0.365120445948636,0.94383775351014,0.957671957671958,0.982300884955752,0.96301775147929,0.570291084714789
E02005331,Poulton North & Carleton East,Wyre,North West,1157,4480,548,592,426,731,6777,1252,4800,552,617,446,755,7170,1791,505,583,421,724,4024,0.373125,0.914855072463768,0.944894651539708,0.943946188340807,0.958940397350993,0.561227336122734
E02005332,Poulton South,Wyre,North West,1263,4785,633,611,495,754,7278,1261,5178,602,648,508,727,7663,1937,566,610,491,694,4298,0.374082657396678,0.940199335548173,0.941358024691358,0.966535433070866,0.954607977991747,0.560876941145765
E02000984,Dunscar & Egerton,Bolton,North West,1316,4542,476,528,316,332,6194,1338,4928,467,564,385,355,6699,1261,436,544,373,340,2954,0.25588474025974,0.933618843683084,0.964539007092199,0.968831168831169,0.957746478873239,0.440961337513062
E02000985,Bromley Cross & Bradshaw,Bolton,North West,1150,4078,482,572,417,556,6105,1201,4496,467,585,433,595,6576,1162,444,553,416,576,3151,0.258451957295374,0.950749464668094,0.945299145299145,0.960739030023095,0.968067226890756,0.479166666666667
E02000986,Eagley & Sharples,Bolton,North West,1513,5284,414,426,355,514,6993,1535,5419,420,463,358,536,7196,1346,383,431,341,512,3013,0.248385310942978,0.911904761904762,0.930885529157667,0.952513966480447,0.955223880597015,0.418704836020011
E02000987,Horwich North,Bolton,North West,1134,4558,371,424,293,425,6071,1170,5086,384,422,336,401,6629,1283,349,395,318,374,2719,0.252261108926465,0.908854166666667,0.936018957345972,0.946428571428571,0.932668329177057,0.410167446070297
E02000988,Astley Bridge & Waters Meeting,Bolton,North West,1917,5606,431,333,257,354,6981,2078,6319,411,361,260,391,7742,1355,334,321,234,365,2609,0.214432663396107,0.812652068126521,0.889196675900277,0.9,0.933503836317136,0.336993025058125
E02000989,Harwood,Bolton,North West,1268,4391,550,676,567,675,6859,1287,4885,527,676,567,772,7427,1189,487,651,547,742,3616,0.243398157625384,0.924098671726755,0.96301775147929,0.964726631393298,0.961139896373057,0.486872222970244
E02000990,Horwich South & Middlebrook,Bolton,North West,1432,4899,463,468,296,339,6465,1489,5561,460,531,342,343,7237,1481,416,504,331,327,3059,0.266319007372775,0.904347826086956,0.949152542372881,0.967836257309941,0.9533527696793,0.422688959513611
E02000991,Smithills,Bolton,North West,1487,4781,391,378,256,357,6163,1690,5351,398,386,290,354,6779,1268,349,366,273,334,2590,0.236965053261073,0.876884422110553,0.948186528497409,0.941379310344828,0.943502824858757,0.382062251069479
E02000992,Blackrod & Butterwick Fields,Bolton,North West,1081,3549,336,396,288,396,4965,1123,3923,350,391,331,410,5405,920,319,374,318,398,2329,0.234514402243181,0.911428571428571,0.956521739130435,0.960725075528701,0.970731707317073,0.430897317298797
E02000993,Hall I' th' Wood,Bolton,North West,2148,5195,304,244,131,229,6103,2354,5871,314,277,151,189,6802,1202,254,258,136,167,2017,0.204735138817919,0.808917197452229,0.931407942238267,0.900662251655629,0.883597883597884,0.296530432225816
E02000994,Halliwell & Brownlow Fold,Bolton,North West,2149,5298,347,280,188,205,6318,2523,6407,349,285,184,210,7435,997,257,236,166,176,1832,0.15561105041361,0.736389684813754,0.828070175438597,0.902173913043478,0.838095238095238,0.24640215198386
E02000995,Doffcocker & Moss Bank,Bolton,North West,1826,4720,425,429,310,489,6373,1823,5288,421,492,312,531,7044,1266,365,455,291,508,2885,0.239409984871407,0.866983372921615,0.92479674796748,0.932692307692308,0.95668549905838,0.409568427030097
E02000996,Breightmet North,Bolton,North West,2240,5043,328,326,194,372,6263,2268,5682,332,343,229,357,6943,945,257,312,219,334,2067,0.166314677930306,0.774096385542169,0.909620991253644,0.956331877729258,0.935574229691877,0.297709923664122
E02000997,Horwich East,Bolton,North West,1086,3680,363,376,267,343,5029,1186,4142,396,366,297,400,5601,1100,353,336,284,367,2440,0.265572187349107,0.891414141414142,0.918032786885246,0.956228956228956,0.9175,0.435636493483307
E02000998,Gilnow & Victory,Bolton,North West,2414,6093,342,263,208,246,7152,2893,7557,388,312,195,263,8715,1148,280,262,172,229,2091,0.151912134444886,0.721649484536083,0.83974358974359,0.882051282051282,0.870722433460076,0.239931153184165
E02000999,Central Bolton,Bolton,North West,1696,5421,291,273,191,286,6462,1869,6384,349,271,187,245,7436,999,244,227,167,214,1851,0.156484962406015,0.699140401146132,0.837638376383764,0.893048128342246,0.873469387755102,0.248924152770307
E02001000,Tonge,Bolton,North West,1796,5793,473,439,304,501,7510,1922,6726,471,451,330,485,8463,1200,372,415,309,445,2741,0.178412132024978,0.789808917197452,0.920177383592018,0.936363636363636,0.917525773195876,0.323880420654614
E02001001,Heaton & Deane,Bolton,North West,2116,5565,383,285,198,353,6784,2221,6139,373,311,236,346,7405,1286,314,282,222,322,2426,0.209480371395993,0.841823056300268,0.906752411575563,0.940677966101695,0.930635838150289,0.32761647535449
E02001002,Breightmet South & Darcy Lever,Bolton,North West,2148,5775,531,572,295,382,7555,2133,6276,532,609,363,378,8158,1177,427,566,351,344,2865,0.187539834289356,0.802631578947369,0.929392446633826,0.966942148760331,0.91005291005291,0.351189016915911
E02001003,Lostock & Ladybridge,Bolton,North West,1340,4126,462,512,387,528,6015,1411,4565,456,558,404,541,6524,1335,420,517,382,509,3163,0.292442497261774,0.921052631578947,0.92652329749104,0.945544554455445,0.940850277264325,0.484825260576334
E02001004,Rumworth North,Bolton,North West,2479,5314,293,229,173,200,6209,2631,6818,316,237,164,230,7765,1078,239,188,140,190,1835,0.158110882956879,0.756329113924051,0.793248945147679,0.853658536585366,0.826086956521739,0.236316806181584
E02001005,Burnden & Great Lever,Bolton,North West,2346,5704,314,221,171,258,6668,2752,6954,373,278,160,290,8055,1067,265,233,142,253,1960,0.153436870865689,0.710455764075067,0.838129496402878,0.8875,0.872413793103448,0.24332712600869
E02001006,Rumworth South,Bolton,North West,2312,5172,267,224,172,202,6037,2532,6318,277,233,160,208,7196,1153,233,193,134,182,1895,0.182494460272238,0.84115523465704,0.828326180257511,0.8375,0.875,0.263340744858255
E02001007,Little Lever,Bolton,North West,1710,5751,707,852,459,454,8223,1757,6261,663,848,577,480,8829,1490,557,800,554,460,3861,0.23798115317042,0.840120663650075,0.943396226415094,0.960138648180243,0.958333333333333,0.437308868501529
E02001008,Lever Edge,Bolton,North West,2669,5249,268,202,167,258,6144,2985,6414,305,240,192,358,7509,1079,239,193,167,317,1995,0.168225756158404,0.783606557377049,0.804166666666667,0.869791666666667,0.885474860335196,0.265681182580903
E02001009,Daubhill & Fernhill Gate,Bolton,North West,1769,4379,311,352,256,324,5622,1981,5135,338,329,271,320,6393,1103,285,297,247,295,2227,0.214800389483934,0.843195266272189,0.90273556231003,0.911439114391144,0.921875,0.348349757547317
E02001010,Farnworth North,Bolton,North West,1525,4022,245,158,100,149,4674,1727,4632,278,218,140,247,5515,954,233,194,114,219,1714,0.205958549222798,0.838129496402878,0.889908256880734,0.814285714285714,0.88663967611336,0.31078875793291
E02001011,Westhoughton East,Bolton,North West,1676,6061,539,589,368,462,8019,1625,6125,622,632,430,484,8293,1295,552,598,410,469,3324,0.211428571428571,0.887459807073955,0.94620253164557,0.953488372093023,0.96900826446281,0.400819968648258
E02001012,Harper Green,Bolton,North West,2176,5134,327,319,251,229,6260,2359,5887,341,313,237,269,7047,1436,289,281,213,238,2457,0.243927297435026,0.847507331378299,0.897763578274761,0.89873417721519,0.884758364312268,0.348659003831418
E02001013,Over Hulton,Bolton,North West,1091,3649,315,367,356,369,5056,1116,3865,345,332,345,411,5298,964,304,318,330,386,2302,0.249417852522639,0.881159420289855,0.957831325301205,0.956521739130435,0.939172749391727,0.434503586258966
E02001014,Westhoughton West,Bolton,North West,1455,5040,436,445,298,355,6574,1565,5621,470,453,316,373,7233,1172,390,408,299,350,2619,0.208503824942181,0.829787234042553,0.900662251655629,0.94620253164557,0.938337801608579,0.362090418913314
E02001015,Farnworth South,Bolton,North West,1507,5115,432,425,366,478,6816,1555,5536,402,446,311,362,7057,1515,353,397,286,336,2887,0.273663294797688,0.878109452736318,0.890134529147982,0.919614147909968,0.92817679558011,0.409097350148788
E02001016,Highfield & New Bury,Bolton,North West,2148,5301,315,343,202,234,6395,2332,6054,318,347,193,231,7143,1581,246,310,166,205,2508,0.261149653121903,0.773584905660377,0.893371757925072,0.860103626943005,0.887445887445887,0.351112977740445
E02001017,Kearsley & Stoneclough,Bolton,North West,2140,6859,497,555,380,424,8715,2157,7132,531,577,402,424,9066,1887,471,540,380,389,3667,0.264582164890634,0.887005649717514,0.935875216637782,0.945273631840796,0.917452830188679,0.404478270461063
E02001018,Westhoughton Daisy Hill,Bolton,North West,1427,4894,412,381,186,218,6091,1415,5268,463,416,219,222,6588,1161,397,398,203,198,2357,0.220387243735763,0.857451403887689,0.956730769230769,0.926940639269406,0.891891891891892,0.357771706132362
E02001019,Ramsbottom,Bury,North West,1714,5602,480,478,321,374,7255,1584,5912,497,521,369,446,7745,1433,435,494,340,420,3122,0.242388362652233,0.875251509054326,0.948176583493282,0.921409214092141,0.941704035874439,0.403098773402195
E02001020,Summerseat,Bury,North West,953,3024,451,552,348,482,4857,971,3362,399,570,405,511,5247,906,366,553,392,487,2704,0.26948245092207,0.917293233082707,0.970175438596491,0.967901234567901,0.953033268101761,0.515342100247761
E02001021,Nuttall & Tottington,Bury,North West,1254,4600,435,460,314,421,6230,1152,4917,453,466,334,422,6592,1369,411,441,316,403,2940,0.278421801911735,0.907284768211921,0.946351931330472,0.946107784431138,0.954976303317536,0.445995145631068
E02001022,Walmersley & Limefield,Bury,North West,1399,4693,438,492,350,521,6494,1476,5120,451,505,356,502,6934,1371,374,472,343,480,3040,0.2677734375,0.829268292682927,0.934653465346535,0.963483146067416,0.956175298804781,0.438419382751659
E02001023,Higher Woodhill,Bury,North West,1088,3349,373,422,256,223,4623,1188,3715,359,424,274,266,5038,970,315,397,261,250,2193,0.261103633916555,0.877437325905292,0.936320754716981,0.952554744525547,0.93984962406015,0.435291782453355
E02001024,Walshaw & Woolfold,Bury,North West,1516,5010,479,495,312,373,6669,1431,5265,462,517,348,388,6980,1422,393,484,330,368,2997,0.27008547008547,0.850649350649351,0.936170212765957,0.948275862068965,0.948453608247423,0.429369627507163
E02001025,Fairfield & Jericho,Bury,North West,1910,4907,346,330,206,335,6124,1849,5485,369,367,231,330,6782,1358,300,327,206,294,2485,0.247584320875114,0.813008130081301,0.891008174386921,0.891774891774892,0.890909090909091,0.36641108817458
E02001026,Fernhill & Pimhole,Bury,North West,2619,6996,347,307,172,284,8106,2975,8343,393,339,216,245,9536,1430,274,271,176,192,2343,0.171401174637421,0.697201017811705,0.799410029498525,0.814814814814815,0.783673469387755,0.245700503355705
E02001027,Whitehead Park,Bury,North West,1558,4822,283,290,183,276,5854,1561,5011,297,313,187,307,6115,1224,253,290,175,284,2226,0.244262622231092,0.851851851851852,0.926517571884984,0.935828877005348,0.925081433224756,0.364022894521668
E02001028,Elton Vale,Bury,North West,1112,3806,533,640,526,615,6120,1125,4251,527,631,539,666,6614,1215,468,612,519,627,3441,0.285815102328864,0.888045540796964,0.969889064976228,0.962894248608534,0.941441441441441,0.520260054429997
E02001029,Buckley Wells & Fishpool,Bury,North West,1650,4953,309,281,156,251,5950,1840,5571,333,311,182,265,6662,1131,270,255,160,227,2043,0.203015616585891,0.810810810810811,0.819935691318328,0.879120879120879,0.856603773584906,0.306664665265686
E02001030,Ainsworth & Bradley Fold,Bury,North West,1027,3716,330,338,211,232,4827,1000,4125,383,364,232,245,5349,1089,340,342,225,234,2230,0.264,0.887728459530026,0.93956043956044,0.969827586206897,0.955102040816327,0.416900355206581
E02001031,Redvales & Hollins,Bury,North West,1285,4171,320,350,248,253,5342,1421,4595,340,350,265,317,5867,1132,292,308,243,291,2266,0.246354733405876,0.858823529411765,0.88,0.916981132075472,0.917981072555205,0.386228055224135
E02001032,Black Lane,Bury,North West,1466,4640,410,448,324,415,6237,1476,4994,416,450,350,351,6561,1239,345,407,335,338,2664,0.248097717260713,0.829326923076923,0.904444444444444,0.957142857142857,0.962962962962963,0.406035665294925
E02001033,Bank Top & Radcliffe Ees,Bury,North West,1275,3948,232,236,153,188,4757,1301,4277,246,269,141,193,5126,941,198,248,130,179,1696,0.220014028524667,0.804878048780488,0.921933085501859,0.921985815602837,0.927461139896373,0.330862270776434
E02001034,Radcliffe,Bury,North West,1756,5497,324,348,238,308,6715,1877,5904,370,367,251,368,7260,1288,295,325,223,333,2464,0.218157181571816,0.797297297297297,0.885558583106267,0.888446215139442,0.904891304347826,0.339393939393939
E02001035,Unsworth,Bury,North West,1237,3986,381,419,404,494,5684,1264,4604,417,462,382,528,6393,1315,386,435,365,501,3002,0.285621198957428,0.925659472422062,0.941558441558442,0.955497382198953,0.948863636363636,0.469576098858126
E02001036,Outwood Gate,Bury,North West,1724,4849,375,340,201,238,6003,1694,5048,345,392,213,244,6242,1191,300,357,198,227,2273,0.235935023771791,0.869565217391304,0.910714285714286,0.929577464788732,0.930327868852459,0.364146107016982
E02001037,Whitefield West & Park Lane,Bury,North West,1208,3985,463,463,336,538,5785,1266,4429,477,506,377,556,6345,1261,434,482,353,518,3048,0.284714382479115,0.909853249475891,0.952569169960474,0.936339522546419,0.931654676258993,0.480378250591017
E02001038,Whitefield East,Bury,North West,1026,3732,265,263,209,314,4783,1009,3900,283,284,193,301,4961,993,217,252,178,282,1922,0.254615384615385,0.76678445229682,0.887323943661972,0.922279792746114,0.93687707641196,0.387421890747833
E02001039,Besses,Bury,North West,1930,5416,295,294,239,310,6554,2045,6012,309,305,221,326,7173,1423,264,280,208,299,2474,0.236693280106454,0.854368932038835,0.918032786885246,0.941176470588235,0.91717791411043,0.344904502997351
E02001040,Kirkhams & Holyrood,Bury,North West,1129,3791,354,332,238,315,5030,1156,4256,338,337,271,332,5534,1162,309,315,261,314,2361,0.273026315789474,0.914201183431953,0.934718100890208,0.96309963099631,0.945783132530121,0.42663534513914
E02001041,Prestwich East,Bury,North West,1367,5075,342,309,198,411,6335,1441,5654,358,340,237,398,6987,1353,306,314,212,365,2550,0.239299610894942,0.854748603351955,0.923529411764706,0.894514767932489,0.917085427135678,0.364963503649635
E02001042,Prestwich Central,Bury,North West,1198,4006,322,343,222,321,5214,1339,4539,356,344,238,295,5772,1292,300,318,225,270,2405,0.284644194756554,0.842696629213483,0.924418604651163,0.945378151260504,0.915254237288136,0.416666666666667
E02001043,Prestwich Clough & Rainsough,Bury,North West,1071,3413,248,256,145,340,4402,1103,3905,263,229,184,309,4890,1037,213,212,170,287,1919,0.265556978233035,0.809885931558936,0.925764192139738,0.923913043478261,0.928802588996764,0.392433537832311
E02001044,Sedgley Park,Bury,North West,3416,5090,347,284,197,234,6152,3402,6010,377,309,201,280,7177,1390,321,272,185,245,2413,0.231281198003328,0.851458885941645,0.880258899676375,0.920398009950249,0.875,0.336212902326878
E02001045,Boothroyden & Higher Blackley,Manchester,North West,2007,4905,357,366,238,326,6192,2179,6033,404,402,240,298,7377,1348,351,346,215,270,2530,0.22343775899221,0.868811881188119,0.860696517412935,0.895833333333333,0.906040268456376,0.342957841941169
E02001046,Blackley,Manchester,North West,2666,6559,351,310,232,296,7748,3078,8423,382,357,241,296,9699,1770,318,303,209,247,2847,0.210138905378131,0.832460732984293,0.848739495798319,0.867219917012448,0.83445945945946,0.29353541602227
E02001047,Charlestown,Manchester,North West,2352,6239,405,368,268,322,7602,2479,7482,440,423,278,395,9018,1639,358,384,249,356,2986,0.219059075113606,0.813636363636364,0.907801418439716,0.89568345323741,0.90126582278481,0.331115546684409
E02001048,Crumpsall North & Heaton Park,Manchester,North West,2271,5606,328,315,199,309,6757,2582,6670,338,338,214,325,7885,1436,277,299,196,292,2500,0.215292353823088,0.819526627218935,0.884615384615385,0.91588785046729,0.898461538461539,0.317057704502219
E02001049,New Moston,Manchester,North West,2059,6020,443,426,304,435,7628,2332,6988,503,466,315,481,8753,1603,389,417,287,430,3126,0.229393245563824,0.773359840954274,0.894849785407725,0.911111111111111,0.893970893970894,0.357134696675426
E02001050,Hapurhey North,Manchester,North West,2223,5471,273,256,156,184,6340,2684,6639,294,250,156,188,7527,993,216,209,138,160,1716,0.149570718481699,0.73469387755102,0.836,0.884615384615385,0.851063829787234,0.227979274611399
E02001051,Moston West,Manchester,North West,2338,5541,336,286,177,319,6659,2809,7050,367,265,206,257,8145,1246,284,230,182,235,2177,0.176737588652482,0.773841961852861,0.867924528301887,0.883495145631068,0.914396887159533,0.267280540208717
E02001052,Crumpsall South,Manchester,North West,4110,8801,401,270,201,418,10091,4796,12515,482,319,211,383,13910,1981,334,244,165,306,3030,0.158290051937675,0.692946058091286,0.764890282131661,0.781990521327014,0.798955613577023,0.217828900071891
E02001053,Hapurhey South & Monsall,Manchester,North West,3152,6928,338,284,200,232,7982,3645,8996,399,321,192,251,10159,1355,296,265,161,208,2285,0.150622498888395,0.741854636591479,0.825545171339564,0.838541666666667,0.828685258964143,0.224923712963874
E02001055,Newton Heath,Manchester,North West,2329,5575,383,363,227,314,6862,2531,6561,395,371,257,281,7865,1070,303,331,231,250,2185,0.163084895595184,0.767088607594937,0.892183288409704,0.898832684824903,0.889679715302491,0.277813095994914
E02001056,Clayton Vale,Manchester,North West,2373,4964,294,263,211,212,5944,2683,6606,353,288,189,224,7660,1075,281,248,164,195,1963,0.16273085074175,0.796033994334278,0.861111111111111,0.867724867724868,0.870535714285714,0.256266318537859
E02001057,New Islington & Miles Platting,Manchester,North West,1711,8858,310,214,130,196,9708,1968,11382,313,261,121,176,12253,1639,228,214,105,145,2331,0.143999297135829,0.728434504792332,0.81992337164751,0.867768595041322,0.823863636363636,0.190239125112217
E02001059,"Beswick, Eastlands & Openshaw Park",Manchester,North West,3209,7775,316,266,191,210,8758,3505,9465,387,276,209,230,10567,1233,294,202,172,189,2090,0.13026941362916,0.75968992248062,0.731884057971015,0.822966507177033,0.821739130434783,0.197785558815179
E02001061,Openshaw & Gorton North,Manchester,North West,2649,6131,373,331,222,260,7317,3016,8156,425,350,214,276,9421,1267,306,286,185,231,2275,0.155345757724375,0.72,0.817142857142857,0.864485981308411,0.836956521739131,0.241481795987687
E02001062,Ardwick,Manchester,North West,2327,8090,193,156,120,145,8704,2731,11855,245,183,133,192,12608,1122,144,133,102,144,1645,0.0946436102910165,0.587755102040816,0.726775956284153,0.766917293233083,0.75,0.130472715736041
E02001063,Hulme & University,Manchester,North West,1621,12643,119,97,62,104,13025,1991,13989,141,81,72,95,14378,1011,78,56,54,60,1259,0.072271070126528,0.553191489361702,0.691358024691358,0.75,0.631578947368421,0.0875643343997774
E02001064,Belle Vue & West Gorton,Manchester,North West,2915,6483,280,228,161,259,7411,3117,8446,358,250,199,312,9565,1225,242,200,154,232,2053,0.145039071749941,0.675977653631285,0.8,0.773869346733668,0.743589743589744,0.214636696288552
E02001065,Abbey Hey,Manchester,North West,2675,5951,342,244,208,251,6996,2677,6862,371,277,204,244,7958,1046,292,230,181,219,1968,0.152433692800933,0.787061994609164,0.830324909747293,0.887254901960784,0.897540983606558,0.247298316159839
E02001066,Victoria Park,Manchester,North West,1940,10509,188,158,107,195,11157,2225,12565,272,198,113,198,13346,1158,162,138,73,128,1659,0.0921607640270593,0.595588235294118,0.696969696969697,0.646017699115044,0.646464646464647,0.124306908436985
E02001067,Gorton South,Manchester,North West,3292,6945,261,234,154,238,7832,3581,8622,333,259,178,208,9600,1235,228,203,140,170,1976,0.143238227789376,0.684684684684685,0.783783783783784,0.786516853932584,0.817307692307692,0.205833333333333
E02001068,Moss Side West,Manchester,North West,3221,6607,218,144,160,279,7408,3646,9317,286,192,169,301,10265,875,128,113,102,183,1401,0.0939143501126972,0.447552447552448,0.588541666666667,0.603550295857988,0.60797342192691,0.136483195323916
E02001069,Rusholme West & Moss Side East,Manchester,North West,2747,9289,205,158,130,177,9959,3110,12881,247,186,139,199,13652,1178,153,123,97,129,1680,0.0914525269777191,0.619433198380567,0.661290322580645,0.697841726618705,0.648241206030151,0.123058892469968
E02001070,Rusholme East,Manchester,North West,1632,10615,201,160,144,198,11318,1875,14791,283,203,131,193,15601,1357,192,158,95,152,1954,0.0917449800554391,0.678445229681979,0.778325123152709,0.725190839694657,0.787564766839378,0.125248381514006
E02001071,Levenshulme North,Manchester,North West,4266,9159,331,240,195,253,10178,5259,13259,424,321,189,278,14471,1440,245,239,132,193,2249,0.108605475526058,0.577830188679245,0.744548286604361,0.698412698412698,0.694244604316547,0.155414276829521
E02001072,Whalley Range North,Manchester,North West,1726,6661,198,152,117,184,7312,1867,8193,313,178,130,214,9028,1167,204,121,96,165,1753,0.142438667154888,0.651757188498403,0.679775280898876,0.738461538461539,0.771028037383178,0.1941736818786
E02001073,Chorlton North,Manchester,North West,1460,7005,345,285,170,281,8086,1693,7908,405,295,188,344,9140,1769,330,249,157,299,2804,0.223697521497218,0.814814814814815,0.84406779661017,0.835106382978723,0.869186046511628,0.306783369803064
E02001074,Fallowfield West & Whalley Range South,Manchester,North West,2665,7959,353,242,210,402,9166,2864,9671,413,298,222,426,11030,1756,295,243,182,352,2828,0.181573777272257,0.714285714285714,0.815436241610738,0.81981981981982,0.826291079812207,0.256391659111514
E02001075,Levenshulme Central,Manchester,North West,2179,5996,196,156,113,131,6592,2329,7691,258,170,124,134,8377,1163,172,130,99,104,1668,0.151215706670134,0.666666666666667,0.764705882352941,0.798387096774194,0.776119402985075,0.199116628864749
E02001076,Fallowfield Central,Manchester,North West,1018,10524,127,76,81,122,10930,1095,11127,182,134,75,133,11651,1013,112,105,56,101,1387,0.0910398130673137,0.615384615384615,0.783582089552239,0.746666666666667,0.759398496240602,0.119045575487083
E02001077,Chorlton South,Manchester,North West,1232,5087,311,218,125,228,5969,1399,6075,367,265,179,217,7103,1334,292,234,165,187,2212,0.219588477366255,0.795640326975477,0.883018867924528,0.921787709497207,0.861751152073733,0.311417710826411
E02001078,Levenshulme South & Burnage North,Manchester,North West,2321,6662,405,349,260,403,8079,2509,8076,463,375,290,408,9612,1522,357,311,252,348,2790,0.188459633481922,0.771058315334773,0.829333333333333,0.868965517241379,0.852941176470588,0.290262172284644
E02001079,Withington North & Old Moat,Manchester,North West,1757,6292,224,191,179,237,7123,1983,7525,291,228,173,239,8456,1355,210,189,141,182,2077,0.180066445182724,0.721649484536083,0.828947368421053,0.815028901734104,0.761506276150628,0.245624408703879
E02001080,Ladybarn,Manchester,North West,1034,7889,193,205,136,207,8630,1090,8069,252,203,165,218,8907,1165,173,153,145,180,1816,0.144379724872971,0.686507936507937,0.753694581280788,0.878787878787879,0.825688073394496,0.203884585157741
E02001081,Beech Road & Chorlton Meadows,Manchester,North West,1233,4327,234,183,125,230,5099,1197,4829,273,237,145,189,5673,1216,224,203,129,166,1938,0.251811969351833,0.82051282051282,0.856540084388186,0.889655172413793,0.878306878306878,0.341618191433104
E02001082,Withington West,Manchester,North West,818,5298,211,126,118,163,5916,864,5815,230,204,112,174,6535,1118,184,180,96,136,1714,0.192261392949269,0.8,0.882352941176471,0.857142857142857,0.781609195402299,0.262280030604438
E02001083,West Didsbury,Manchester,North West,1091,6644,157,132,79,101,7113,1216,7208,178,159,100,148,7793,1379,109,118,88,110,1804,0.191315205327414,0.612359550561798,0.742138364779874,0.88,0.743243243243243,0.231489798537149
E02001084,Withington East,Manchester,North West,1390,6078,314,199,158,240,6989,1534,6799,331,288,163,275,7856,1408,267,262,143,212,2292,0.207089277834976,0.806646525679758,0.909722222222222,0.877300613496933,0.770909090909091,0.291751527494908
E02001085,Burnage South,Manchester,North West,2321,5157,275,232,191,196,6051,2385,6610,317,256,192,217,7592,1197,243,216,170,181,2007,0.181089258698941,0.766561514195584,0.84375,0.885416666666667,0.834101382488479,0.264357218124341
E02001086,Merseybank & Barlow Moor,Manchester,North West,1249,4519,209,194,150,274,5346,1379,5779,253,229,180,288,6729,1198,191,188,152,243,1972,0.207302301436235,0.754940711462451,0.820960698689956,0.844444444444445,0.84375,0.293059890028236
E02001087,Didsbury Village,Manchester,North West,1649,6394,441,373,243,357,7808,1737,7477,470,430,315,404,9096,1702,402,377,279,374,3134,0.227631402969105,0.85531914893617,0.876744186046512,0.885714285714286,0.925742574257426,0.344547053649956
E02001088,Northern Moor,Manchester,North West,2182,5657,375,305,207,333,6877,2222,6439,418,336,185,315,7693,1400,348,300,166,294,2508,0.217425066004038,0.832535885167464,0.892857142857143,0.897297297297297,0.933333333333333,0.326010659040686
E02001089,East Didsbury,Manchester,North West,1537,5168,344,301,192,343,6348,1728,6340,391,345,222,373,7671,1383,332,315,202,335,2567,0.21813880126183,0.849104859335038,0.91304347826087,0.90990990990991,0.898123324396783,0.33463694433581
E02001090,Northenden,Manchester,North West,1055,4246,330,338,204,323,5441,1178,4874,401,336,224,325,6160,1341,340,297,205,298,2481,0.275133360689372,0.84788029925187,0.883928571428571,0.915178571428571,0.916923076923077,0.40275974025974
E02001091,Baguley West & Brooklands,Manchester,North West,1467,5083,399,393,259,364,6498,1594,5742,456,423,312,363,7296,1406,393,390,293,336,2818,0.24486241727621,0.861842105263158,0.921985815602837,0.939102564102564,0.925619834710744,0.386239035087719
E02001092,Baguley East & Wythenshawe Park,Manchester,North West,1946,5472,335,272,175,298,6552,2095,6495,353,339,198,270,7655,1475,294,295,178,227,2469,0.227097767513472,0.8328611898017,0.870206489675516,0.898989898989899,0.840740740740741,0.322534291312867
E02001093,Benchill North & Sharston,Manchester,North West,2358,5816,331,311,201,362,7021,2715,7130,378,352,239,312,8411,1486,301,308,216,280,2591,0.208415147265077,0.796296296296296,0.875,0.903765690376569,0.897435897435897,0.308048983474022
E02001094,Benchill South & Wythenshawe Central,Manchester,North West,2721,5927,329,296,154,188,6894,3027,7227,376,314,195,191,8303,1436,302,273,164,162,2337,0.198699321986993,0.803191489361702,0.869426751592357,0.841025641025641,0.848167539267016,0.281464530892448
E02001095,Newall Green,Manchester,North West,1909,5245,351,365,167,235,6363,2138,6684,405,374,210,225,7898,1705,341,337,190,196,2769,0.255086774386595,0.841975308641975,0.901069518716578,0.904761904761905,0.871111111111111,0.35059508736389
E02001096,Wythenshawe East & Peel Hall,Manchester,North West,1599,4726,409,325,185,293,5938,1720,5663,456,386,201,281,6987,1371,391,369,184,256,2571,0.242097828006357,0.857456140350877,0.955958549222798,0.915422885572139,0.911032028469751,0.367969085444397
E02001097,Woodhouse Park & Airport,Manchester,North West,1820,5185,383,273,184,237,6262,2046,6439,382,324,185,257,7587,1439,316,295,166,225,2441,0.223481907128436,0.827225130890052,0.910493827160494,0.897297297297297,0.875486381322957,0.321734545933834
E02006902,City Centre North & Collyhurst,Manchester,North West,557,6556,112,61,37,32,6798,646,6946,109,72,43,47,7217,747,78,57,36,41,959,0.107543910164123,0.715596330275229,0.791666666666667,0.837209302325582,0.872340425531915,0.132880698351115
E02006912,Piccadilly & Ancoats,Manchester,North West,366,17303,122,68,67,131,17691,238,14262,121,108,62,126,14679,1077,95,94,51,111,1428,0.0755153554901136,0.785123966942149,0.87037037037037,0.82258064516129,0.880952380952381,0.0972818311874106
E02006913,Cheetham Hill,Manchester,North West,1324,5656,133,104,91,96,6080,1682,7175,160,137,95,120,7687,1051,103,101,73,89,1417,0.146480836236934,0.64375,0.737226277372263,0.768421052631579,0.741666666666667,0.184337192662937
E02006914,University North & Whitworth Street,Manchester,North West,398,10270,46,20,17,62,10415,435,9317,52,30,24,28,9451,570,33,14,19,21,657,0.061178490930557,0.634615384615385,0.466666666666667,0.791666666666667,0.75,0.0695164532853666
E02006915,Strangeways,Manchester,North West,2379,6603,173,157,79,94,7106,2790,8248,274,171,118,119,8930,1314,172,109,82,78,1755,0.159311348205626,0.627737226277372,0.637426900584795,0.694915254237288,0.65546218487395,0.196528555431131
E02006916,Hulme Park & St George's,Manchester,North West,587,5762,89,60,41,57,6009,745,6187,111,81,45,63,6487,754,67,57,33,44,955,0.121868433812833,0.603603603603604,0.703703703703704,0.733333333333333,0.698412698412698,0.147217511946971
E02006917,Castlefield & Deansgate,Manchester,North West,338,6815,119,27,24,24,7009,226,5184,69,47,30,15,5345,637,58,39,27,13,774,0.122878086419753,0.840579710144928,0.829787234042553,0.9,0.866666666666667,0.144808231992516
E02001098,Shaw & Crompton,Oldham,North West,975,3200,386,534,391,365,4876,987,3559,390,512,401,417,5279,1032,355,481,376,391,2635,0.289969092441697,0.91025641025641,0.939453125,0.937655860349127,0.937649880095923,0.499147565826861
E02001099,Wood End,Oldham,North West,1057,3692,317,344,225,281,4859,1026,3828,325,317,238,263,4971,983,277,297,220,234,2011,0.256792058516196,0.852307692307692,0.936908517350158,0.92436974789916,0.889733840304183,0.404546368939851
E02001100,Clough & Shaw Side,Oldham,North West,951,3472,371,419,277,466,5005,990,3774,380,415,337,398,5304,1012,335,388,317,356,2408,0.268150503444621,0.881578947368421,0.934939759036144,0.940652818991098,0.894472361809045,0.453996983408748
E02001101,Royton North,Oldham,North West,934,3216,390,461,261,268,4596,961,3593,401,455,319,295,5063,1059,374,429,307,285,2454,0.294739771778458,0.932668329177057,0.942857142857143,0.962382445141066,0.966101694915254,0.484692869840016
E02001102,Royton East & Cowlishaw,Oldham,North West,1056,3883,302,313,215,243,4956,1177,3997,313,340,204,219,5073,1113,282,317,196,207,2115,0.2784588441331,0.900958466453674,0.932352941176471,0.96078431372549,0.945205479452055,0.416913069189829
E02001103,"Diggle, Delph & Denshaw",Oldham,North West,784,3237,393,420,254,355,4659,815,3419,395,413,306,396,4929,850,361,392,287,375,2265,0.248610704884469,0.913924050632911,0.949152542372881,0.937908496732026,0.946969696969697,0.459525258673159
E02001104,Moorside & Sholver,Oldham,North West,1616,4565,318,314,183,173,5553,1666,4965,308,336,188,220,6017,1097,232,310,175,209,2023,0.220946626384693,0.753246753246753,0.922619047619048,0.930851063829787,0.95,0.336214060162872
E02001105,Royton South West,Oldham,North West,955,3567,368,429,308,392,5064,988,3643,349,431,329,359,5111,1007,303,409,313,339,2371,0.276420532528136,0.868194842406877,0.948955916473318,0.951367781155015,0.944289693593315,0.463901389160634
E02001106,Royton South East,Oldham,North West,950,3514,326,337,268,373,4818,993,3896,304,367,295,388,5250,1094,253,343,273,360,2323,0.280800821355236,0.832236842105263,0.934604904632153,0.925423728813559,0.927835051546392,0.44247619047619
E02001107,Chadderton North,Oldham,North West,1525,3901,279,294,231,259,4964,1740,4473,291,288,224,290,5566,816,239,273,205,270,1803,0.18242790073776,0.821305841924399,0.947916666666667,0.915178571428571,0.931034482758621,0.323931009701761
E02001108,Derker,Oldham,North West,1630,3566,179,184,139,175,4243,1652,3916,191,193,124,191,4615,809,128,167,113,173,1390,0.20658835546476,0.670157068062827,0.865284974093264,0.911290322580645,0.905759162303665,0.301191765980498
E02001109,Waterhead,Oldham,North West,1555,4892,386,315,219,298,6110,1607,5242,392,364,209,277,6484,1126,281,323,191,240,2161,0.214803510110645,0.716836734693878,0.887362637362637,0.913875598086124,0.866425992779783,0.333281924737816
E02001110,"New Delph, Dobcross & Austerlands",Oldham,North West,1006,3848,417,506,300,386,5457,1019,3967,431,489,337,382,5606,1010,373,465,324,368,2540,0.254600453743383,0.865429234338747,0.950920245398773,0.961424332344214,0.963350785340314,0.453085979307884
E02001111,Oldham Town North,Oldham,North West,2060,4719,238,188,170,260,5575,2372,6141,294,224,154,227,7040,1053,211,186,130,190,1770,0.171470444553004,0.717687074829932,0.830357142857143,0.844155844155844,0.837004405286344,0.251420454545455
E02001112,Middleton Junction,Oldham,North West,961,3494,420,369,214,258,4755,993,3745,446,442,242,260,5135,914,389,413,231,250,2197,0.244058744993324,0.87219730941704,0.934389140271493,0.954545454545455,0.961538461538461,0.427848101265823
E02001113,Busk,Oldham,North West,2814,6031,223,132,127,166,6679,2837,6856,230,159,124,196,7565,736,148,126,106,144,1260,0.107351225204201,0.643478260869565,0.792452830188679,0.854838709677419,0.73469387755102,0.166556510244547
E02001114,Chadderton Central,Oldham,North West,1964,5333,368,431,275,425,6832,2022,5767,399,399,345,407,7317,1126,326,370,325,385,2532,0.195248829547425,0.817042606516291,0.927318295739348,0.942028985507246,0.945945945945946,0.346043460434604
E02001115,Lees & Hey,Oldham,North West,1060,3615,330,333,250,260,4788,1107,3838,337,311,254,280,5020,991,248,297,234,266,2036,0.258207399687337,0.735905044510386,0.954983922829582,0.921259842519685,0.95,0.405577689243028
E02001116,Salem,Oldham,North West,2465,4583,240,181,84,201,5289,2629,5296,265,204,116,169,6050,840,180,168,97,142,1427,0.158610271903323,0.679245283018868,0.823529411764706,0.836206896551724,0.840236686390533,0.235867768595041
E02001117,Greenfield & Uppermill,Oldham,North West,1034,3600,405,426,283,383,5097,1023,3751,414,465,328,398,5356,959,369,441,312,378,2459,0.255665155958411,0.891304347826087,0.948387096774194,0.951219512195122,0.949748743718593,0.459111277072442
E02001118,Springhead & Grasscroft,Oldham,North West,979,3662,350,369,294,376,5051,985,3903,387,397,299,429,5415,1021,335,378,284,406,2424,0.2615936459134,0.865633074935401,0.952141057934509,0.949832775919733,0.946386946386946,0.447645429362881
E02001119,Alexandra Park,Oldham,North West,3640,7504,306,163,178,282,8433,3896,8621,396,203,150,317,9687,1184,241,162,111,254,1952,0.137339055793991,0.608585858585859,0.798029556650246,0.74,0.801261829652997,0.201507174563848
E02001121,Oldham Town South,Oldham,North West,2883,5451,188,148,107,142,6036,2671,5864,232,149,105,157,6507,660,152,109,87,116,1124,0.112551159618008,0.655172413793103,0.731543624161074,0.828571428571429,0.738853503184713,0.172737052405102
E02001123,Alt,Oldham,North West,1781,4233,272,277,179,199,5160,1937,4692,284,266,183,223,5648,1101,211,232,162,206,1912,0.234654731457801,0.742957746478873,0.87218045112782,0.885245901639344,0.923766816143498,0.338526912181303
E02001124,Chadderton South East,Oldham,North West,1577,4066,260,225,184,245,4980,1648,4425,274,242,188,210,5339,852,210,225,168,191,1646,0.192542372881356,0.766423357664234,0.929752066115702,0.893617021276596,0.909523809523809,0.3082974339764
E02001125,Chadderton South West,Oldham,North West,1564,5201,395,394,211,374,6575,1647,5350,398,394,249,394,6785,1217,332,360,234,376,2519,0.227476635514019,0.834170854271357,0.913705583756345,0.939759036144578,0.954314720812183,0.371260132645542
E02001126,Hathershaw,Oldham,North West,2573,5623,281,231,177,225,6537,2662,6292,317,254,176,237,7276,1006,250,208,158,209,1831,0.159885568976478,0.788643533123028,0.818897637795276,0.897727272727273,0.881856540084388,0.251649257833975
E02001127,Lime Side & Garden Suburb,Oldham,North West,2002,4738,327,263,182,203,5713,2067,5386,348,291,198,202,6425,874,278,254,187,184,1777,0.162272558484961,0.798850574712644,0.872852233676976,0.944444444444444,0.910891089108911,0.276575875486381
E02001128,Failsworth East,Oldham,North West,1486,4835,387,346,282,363,6213,1523,5103,391,389,296,323,6502,990,317,341,284,300,2232,0.194003527336861,0.81074168797954,0.876606683804627,0.959459459459459,0.928792569659443,0.343278991079668
E02001129,Failsworth West,Oldham,North West,1154,3992,315,249,219,302,5077,1363,4409,299,308,180,290,5486,779,246,259,157,253,1694,0.176684055341347,0.822742474916388,0.840909090909091,0.872222222222222,0.872413793103448,0.308786000729129
E02001130,Holt Lane End & Bardsley,Oldham,North West,803,3412,331,291,263,301,4598,886,3792,336,314,248,355,5045,774,285,266,227,322,1874,0.204113924050633,0.848214285714286,0.847133757961784,0.915322580645161,0.907042253521127,0.371456888007929
E02001131,Failsworth South,Oldham,North West,969,3112,258,266,289,358,4283,1082,3568,267,275,264,333,4707,702,217,247,243,304,1713,0.196748878923767,0.812734082397004,0.898181818181818,0.920454545454545,0.912912912912913,0.363926067558955
E02006860,Werneth,Oldham,North West,4580,9698,439,243,204,352,10936,4995,11512,543,334,205,398,12992,1383,346,258,154,314,2455,0.120135510771369,0.637200736648251,0.772455089820359,0.751219512195122,0.788944723618091,0.188962438423645
E02001132,Littleborough North & Calderbook,Rochdale,North West,1201,3990,369,368,242,318,5287,1170,4307,384,387,275,332,5685,1179,343,363,261,306,2452,0.273740422567913,0.893229166666667,0.937984496124031,0.949090909090909,0.921686746987952,0.431310466138962
E02001133,Littleborough West & Wardle,Rochdale,North West,1311,3873,407,421,248,243,5192,1348,4275,416,437,293,231,5652,1285,380,401,277,219,2562,0.300584795321637,0.913461538461539,0.917620137299771,0.945392491467577,0.948051948051948,0.453290870488323
E02001134,Littleborough South & Smithy Bridge,Rochdale,North West,1082,3834,381,435,285,323,5258,1100,4110,393,440,334,320,5597,1174,352,418,303,291,2538,0.285644768856448,0.895674300254453,0.95,0.907185628742515,0.909375,0.453457209219225
E02001135,Hurstead & Smallbridge,Rochdale,North West,2226,4907,291,314,208,257,5977,2355,5618,275,315,239,240,6687,1108,210,264,215,205,2002,0.197223211107156,0.763636363636364,0.838095238095238,0.899581589958159,0.854166666666667,0.299386870046359
E02001136,"Healey, Syke & Shawclough",Rochdale,North West,1731,5795,519,480,311,441,7546,1867,6210,557,520,361,445,8093,1663,465,478,336,413,3355,0.267793880837359,0.834829443447038,0.919230769230769,0.930747922437673,0.928089887640449,0.414555788953417
E02001137,Hooley Bridge & Norden West,Rochdale,North West,1042,3817,438,362,213,253,5083,1018,4034,430,393,247,268,5372,1183,378,366,232,243,2402,0.293257312840853,0.87906976744186,0.931297709923664,0.939271255060729,0.906716417910448,0.447133283693224
E02001138,Norden East & Bagslate Moor,Rochdale,North West,1413,4982,566,552,449,595,7144,1482,5425,559,589,442,589,7604,1689,492,554,411,550,3696,0.311336405529954,0.880143112701252,0.940577249575552,0.929864253393665,0.933786078098472,0.486059968437664
E02001139,Wardleworth & Newbold Brow,Rochdale,North West,2841,6206,342,194,173,203,7118,3046,7302,386,235,158,232,8313,1132,272,189,120,171,1884,0.15502602026842,0.704663212435233,0.804255319148936,0.759493670886076,0.737068965517241,0.226632984482136
E02001140,Spotland Bridge,Rochdale,North West,2064,5078,348,262,214,344,6246,2098,5384,334,310,204,343,6575,1180,273,284,188,304,2229,0.219167904903418,0.817365269461078,0.916129032258065,0.92156862745098,0.886297376093295,0.339011406844107
E02001141,Central Rochdale & Mandale Park,Rochdale,North West,3108,8313,416,300,220,314,9563,3418,9499,466,366,221,319,10871,1531,310,277,185,253,2556,0.161174860511633,0.665236051502146,0.756830601092896,0.83710407239819,0.793103448275862,0.235120964032748
E02001142,Springfield Park,Rochdale,North West,1021,3233,384,403,291,466,4777,1015,3611,405,426,355,487,5284,1079,366,400,327,444,2616,0.29880919412905,0.903703703703704,0.938967136150235,0.92112676056338,0.91170431211499,0.495079485238456
E02001143,Kingsway,Rochdale,North West,3179,7392,385,350,219,291,8637,3287,8191,424,344,238,311,9508,1580,322,287,201,258,2648,0.19289464045904,0.759433962264151,0.834302325581395,0.84453781512605,0.829581993569132,0.278502313840976
E02001144,Milnrow West,Rochdale,North West,1176,4117,356,346,239,254,5312,1175,4228,348,378,249,285,5488,1213,320,349,236,253,2371,0.286896877956481,0.919540229885057,0.923280423280423,0.947791164658635,0.887719298245614,0.432033527696793
E02001145,Milnrow East & Newhey,Rochdale,North West,1333,4343,412,450,305,300,5810,1284,4633,421,465,337,304,6160,1398,385,438,309,289,2819,0.301748327217785,0.914489311163896,0.941935483870968,0.916913946587537,0.950657894736842,0.45762987012987
E02001146,Deeplish,Rochdale,North West,2738,6303,280,193,163,311,7250,2844,7338,381,228,173,285,8405,1051,250,177,135,209,1822,0.143227037339875,0.656167979002625,0.776315789473684,0.780346820809249,0.733333333333333,0.216775728732897
E02001147,Balderstone & Kirkholt,Rochdale,North West,2484,6255,421,336,247,304,7563,2635,6856,417,379,240,307,8199,1515,320,323,212,272,2642,0.220974329054842,0.767386091127098,0.852242744063325,0.883333333333333,0.88599348534202,0.322234418831565
E02001148,Castleton & Trub,Rochdale,North West,2172,6377,584,593,400,506,8460,2183,6847,555,613,416,518,8949,1644,466,556,376,448,3490,0.240105155542573,0.83963963963964,0.907014681892333,0.903846153846154,0.864864864864865,0.389987708123813
E02001149,Heywood Town,Rochdale,North West,2232,6560,529,465,307,427,8288,2272,7178,540,532,313,420,8983,1638,485,496,292,388,3299,0.228197269434383,0.898148148148148,0.932330827067669,0.932907348242811,0.923809523809524,0.367249248580652
E02001150,Heywood Heap Bridge & Darnhill,Rochdale,North West,2013,5549,468,432,261,326,7036,2165,6079,468,445,244,332,7568,1459,415,425,230,301,2830,0.24000658002961,0.886752136752137,0.955056179775281,0.942622950819672,0.906626506024096,0.373942917547569
E02001151,Heywood Hopwood & Siddal Moor,Rochdale,North West,2030,6268,502,554,344,463,8131,2057,6707,523,550,379,452,8611,1753,458,517,356,417,3501,0.261368719248546,0.875717017208413,0.94,0.939313984168865,0.922566371681416,0.406572988038555
E02001152,North Middleton & Stakehill,Rochdale,North West,1853,6074,500,415,276,367,7632,2180,6892,546,452,286,341,8517,1325,406,398,259,298,2686,0.192251886244922,0.743589743589744,0.880530973451327,0.905594405594406,0.873900293255132,0.315369261477046
E02001153,Langley & Wood Side,Rochdale,North West,2898,7052,482,436,248,406,8624,3264,8314,539,477,275,352,9957,1374,368,386,234,302,2664,0.165263411113784,0.682745825602969,0.809224318658281,0.850909090909091,0.857954545454545,0.267550467008135
E02001154,Middleton East,Rochdale,North West,1979,6801,459,408,248,360,8276,2106,7081,539,446,257,390,8713,1377,432,401,224,339,2773,0.194464058748764,0.801484230055659,0.899103139013453,0.8715953307393,0.869230769230769,0.31826007115804
E02001155,Middleton Town & Rhodes,Rochdale,North West,1291,4766,418,329,245,380,6138,1342,4898,400,372,243,348,6261,1006,309,330,228,313,2186,0.205389955083708,0.7725,0.887096774193548,0.938271604938272,0.899425287356322,0.349145503913113
E02001156,Alkrington,Rochdale,North West,1761,5733,540,541,350,721,7885,1863,6354,583,577,408,686,8608,1432,474,532,381,613,3432,0.225369845766446,0.81303602058319,0.922010398613518,0.933823529411765,0.893586005830904,0.398698884758364
E02001157,Little Hulton North,Salford,North West,2324,4945,302,292,175,335,6049,2467,5742,314,296,191,302,6845,1118,243,256,167,277,2061,0.194705677464298,0.773885350318471,0.864864864864865,0.87434554973822,0.917218543046358,0.30109569028488
E02001158,Walkden North West,Salford,North West,1480,3637,316,274,166,286,4679,1412,4168,271,295,168,260,5162,1006,223,269,151,247,1896,0.241362763915547,0.822878228782288,0.911864406779661,0.898809523809524,0.95,0.367299496319256
E02001159,Walkden North East,Salford,North West,1600,4321,218,284,146,193,5162,1681,4936,244,259,169,193,5801,1233,204,231,160,175,2003,0.249797406807131,0.836065573770492,0.891891891891892,0.946745562130177,0.906735751295337,0.345285295638683
E02001160,Little Hulton South,Salford,North West,1923,4219,315,273,184,223,5214,2083,4984,286,302,187,249,6008,1121,236,264,173,232,2026,0.22491974317817,0.825174825174825,0.874172185430464,0.925133689839572,0.931726907630522,0.337217043941411
E02001161,Clifton,Salford,North West,1013,3823,284,254,232,322,4915,975,4019,320,297,229,344,5209,998,274,265,218,326,2081,0.248320477730779,0.85625,0.892255892255892,0.951965065502183,0.947674418604651,0.399500863889422
E02001162,Swinton Newtown,Salford,North West,1029,3767,287,363,272,378,5067,1050,3888,275,388,243,373,5167,941,227,361,230,356,2115,0.242026748971193,0.825454545454545,0.930412371134021,0.946502057613169,0.954423592493298,0.409328430423844
E02001163,Walkden South,Salford,North West,1683,5789,519,548,411,538,7805,1806,6403,483,555,423,513,8377,1760,407,525,409,492,3593,0.274871154146494,0.842650103519669,0.945945945945946,0.966903073286052,0.95906432748538,0.428912498507819
E02001164,Clifton Green & Pendlebury East,Salford,North West,1730,5274,256,208,167,133,6038,1719,6968,252,249,157,168,7794,1171,208,223,143,153,1898,0.168053960964409,0.825396825396825,0.895582329317269,0.910828025477707,0.910714285714286,0.243520656915576
E02001165,Swinton West,Salford,North West,1217,3763,255,279,198,256,4751,1266,4280,261,266,211,270,5288,1141,215,241,199,252,2048,0.266588785046729,0.823754789272031,0.906015037593985,0.943127962085308,0.933333333333333,0.387291981845688
E02001166,Broughton Park,Salford,North West,2523,3699,323,254,170,340,4786,2765,4917,314,283,190,313,6017,775,228,229,166,276,1674,0.157616432784218,0.726114649681529,0.809187279151944,0.873684210526316,0.881789137380192,0.278211733421971
E02001167,Kersal Dale,Salford,North West,1653,4539,274,274,169,278,5534,1880,5501,293,296,170,252,6512,1050,237,257,158,221,1923,0.190874386475186,0.808873720136519,0.868243243243243,0.929411764705882,0.876984126984127,0.295300982800983
E02001168,Swinton Worsley Road,Salford,North West,2004,5949,454,453,273,449,7578,2115,6828,497,477,284,432,8518,1692,397,437,265,407,3198,0.24780316344464,0.798792756539235,0.916142557651992,0.933098591549296,0.94212962962963,0.375440244188777
E02001169,Ellenbrook & Boothstown,Salford,North West,1962,6267,639,619,383,500,8408,2015,7103,634,689,447,513,9386,1941,570,656,428,491,4086,0.273264817682669,0.899053627760252,0.952104499274311,0.957494407158837,0.957115009746589,0.435329213722565
E02001170,Worsley,Salford,North West,1855,5616,482,610,416,702,7826,1895,6252,469,618,462,713,8514,1606,416,575,438,683,3718,0.256877799104287,0.886993603411514,0.93042071197411,0.948051948051948,0.957924263674614,0.436692506459948
E02001171,Swinton South East & Pendlebury West,Salford,North West,1106,3592,311,339,235,330,4807,1101,4077,321,354,245,346,5343,1231,289,331,232,333,2416,0.301937699288693,0.900311526479751,0.935028248587571,0.946938775510204,0.96242774566474,0.452180422983343
E02001172,Higher Broughton,Salford,North West,4751,9450,446,330,274,443,10943,5393,11677,459,372,256,391,13155,1782,321,297,227,340,2967,0.152607690331421,0.699346405228758,0.798387096774194,0.88671875,0.869565217391304,0.225541619156214
E02001173,Cromwell Road & Broad Street,Salford,North West,1628,5609,244,223,168,199,6443,1918,7138,254,237,161,172,7962,1146,195,210,138,154,1843,0.160549173437938,0.767716535433071,0.886075949367089,0.857142857142857,0.895348837209302,0.231474503893494
E02001174,Lightoaks,Salford,North West,869,3733,276,254,158,286,4707,914,4098,301,281,184,274,5138,1139,265,259,175,254,2092,0.277940458760371,0.880398671096346,0.921708185053381,0.951086956521739,0.927007299270073,0.40716231996886
E02001175,Winton & Westwood,Salford,North West,1590,4667,307,270,188,250,5682,1608,5323,293,269,196,268,6349,1206,243,242,176,235,2102,0.226563967687394,0.829351535836178,0.899628252788104,0.897959183673469,0.876865671641791,0.331075759962199
E02001176,Eccles,Salford,North West,1913,7402,555,576,367,654,9554,1970,8263,568,578,421,683,10513,1992,441,513,376,609,3931,0.241074670216628,0.776408450704225,0.887543252595156,0.893111638954869,0.891654465592972,0.373918006277942
E02001177,Weaste & Seedley,Salford,North West,2506,8816,552,453,355,562,10738,2637,10142,538,497,344,532,12053,2257,455,435,314,487,3948,0.22253993295208,0.845724907063197,0.875251509054326,0.912790697674419,0.915413533834587,0.327553306230814
E02001178,Salford Central & University,Salford,North West,1278,13289,208,162,97,102,13858,1657,15882,207,182,88,119,16478,2101,149,137,76,102,2565,0.132288124921295,0.719806763285024,0.752747252747253,0.863636363636364,0.857142857142857,0.155662094914431
E02001179,Langworthy Buile Hill,Salford,North West,1173,4694,254,247,157,240,5592,1293,5617,262,249,171,214,6513,1074,203,225,150,188,1840,0.191205269716931,0.774809160305344,0.903614457831325,0.87719298245614,0.878504672897196,0.282511899278366
E02001180,Pendleton,Salford,North West,1184,4718,218,163,123,139,5361,1193,5477,216,189,108,151,6141,783,165,162,96,131,1337,0.142961475260179,0.763888888888889,0.857142857142857,0.888888888888889,0.867549668874172,0.217716984204527
E02001181,Peel Green,Salford,North West,1384,3946,237,230,132,189,4734,1388,4356,244,212,147,196,5155,953,186,188,127,170,1624,0.218778696051423,0.762295081967213,0.886792452830189,0.863945578231293,0.86734693877551,0.315033947623666
E02001182,Barton upon Irwell,Salford,North West,1472,4230,282,202,154,226,5094,1561,5061,246,237,148,229,5921,1081,189,210,138,206,1824,0.213594151353487,0.768292682926829,0.886075949367089,0.932432432432432,0.899563318777293,0.308056071609525
E02001183,Patricroft,Salford,North West,1438,4568,239,195,149,202,5353,1483,5182,254,212,163,192,6003,1125,203,186,145,176,1835,0.217097645696642,0.799212598425197,0.877358490566038,0.889570552147239,0.916666666666667,0.30568049308679
E02001184,Ordsall & Salford Quays,Salford,North West,1708,12867,320,255,168,172,13782,2101,13772,318,329,186,179,14784,2158,235,263,153,159,2968,0.156694742956724,0.738993710691824,0.799392097264438,0.82258064516129,0.888268156424581,0.200757575757576
E02001185,Higher Irlam,Salford,North West,2155,5906,491,499,438,455,7789,2061,6544,475,477,446,545,8487,1805,409,426,403,498,3541,0.275825183374083,0.861052631578948,0.893081761006289,0.903587443946188,0.913761467889908,0.417226346176505
E02001186,Lower Irlam & Cadishead,Salford,North West,2269,6590,379,437,355,404,8165,2282,7223,391,446,343,416,8819,1855,327,406,312,374,3274,0.256818496469611,0.836317135549872,0.910313901345291,0.909620991253644,0.899038461538462,0.371243905204672
E02001187,Reddish Vale View,Stockport,North West,1445,4421,352,341,244,279,5637,1381,4932,370,360,283,301,6246,1186,335,339,268,281,2409,0.240470397404704,0.905405405405405,0.941666666666667,0.946996466431095,0.933554817275748,0.385686839577329
E02001188,North Reddish,Stockport,North West,1961,5623,302,285,197,223,6630,1904,5890,306,316,179,212,6903,1203,261,293,167,190,2114,0.204244482173175,0.852941176470588,0.927215189873418,0.932960893854749,0.89622641509434,0.306243662175866
E02001189,Central Reddish,Stockport,North West,1492,5332,427,420,284,353,6816,1549,5799,439,424,302,386,7350,1443,396,396,290,359,2884,0.248836006207967,0.902050113895216,0.933962264150943,0.960264900662252,0.930051813471503,0.392380952380952
E02001190,Brinnington,Stockport,North West,2008,4478,257,216,130,302,5383,2115,5403,283,220,140,258,6304,1232,245,204,129,242,2052,0.228021469553952,0.865724381625442,0.927272727272727,0.921428571428571,0.937984496124031,0.325507614213198
E02001191,Woodley,Stockport,North West,881,3356,417,388,280,367,4808,917,3670,396,440,273,383,5162,855,318,418,266,367,2224,0.232970027247956,0.803030303030303,0.95,0.974358974358974,0.95822454308094,0.430840759395583
E02001192,Heaton Chapel & Shaw Road,Stockport,North West,1223,4502,290,272,235,482,5781,1142,4829,343,263,209,391,6035,1044,309,226,197,362,2138,0.216193828950093,0.900874635568513,0.859315589353612,0.942583732057416,0.925831202046036,0.354266777133389
E02001193,South Reddish & Heaton Norris,Stockport,North West,1180,4232,263,247,174,247,5163,1212,4645,251,254,165,242,5557,1041,220,237,153,224,1875,0.224111948331539,0.876494023904382,0.933070866141732,0.927272727272727,0.925619834710744,0.33741227280907
E02001194,Heaton Moor,Stockport,North West,1304,3868,338,316,233,304,5059,1310,4293,364,345,233,399,5634,978,315,326,221,366,2206,0.227812718378756,0.865384615384615,0.944927536231884,0.948497854077253,0.917293233082707,0.39155129570465
E02001195,Bredbury,Stockport,North West,1336,4471,429,383,279,401,5963,1380,4893,415,435,331,402,6476,1050,330,402,320,383,2485,0.214592274678112,0.795180722891566,0.924137931034483,0.966767371601209,0.95273631840796,0.38372452130945
E02001196,Romiley & Compstall,Stockport,North West,1434,4394,450,536,390,592,6362,1318,4767,477,556,427,621,6848,1154,381,516,407,595,3053,0.242080973358506,0.79874213836478,0.928057553956835,0.953161592505855,0.958132045088567,0.445823598130841
E02001197,Norris Bank,Stockport,North West,1369,3941,338,288,167,270,5004,1350,4323,367,305,207,270,5472,1043,323,277,196,253,2092,0.241267638214203,0.880108991825613,0.908196721311475,0.946859903381642,0.937037037037037,0.382309941520468
E02001198,Bredbury Green,Stockport,North West,1454,4284,367,494,389,579,6113,1374,4612,383,448,395,638,6476,1069,303,421,375,615,2783,0.231786643538595,0.7911227154047,0.939732142857143,0.949367088607595,0.963949843260188,0.429740580605312
E02001199,Heaton Mersey,Stockport,North West,1478,4992,444,392,247,382,6457,1546,5477,445,469,279,394,7064,1276,404,431,265,373,2749,0.232974255979551,0.907865168539326,0.918976545842217,0.949820788530466,0.946700507614213,0.389156285390713
E02001200,"Central Stockport, Portwood & Shaw Heath",Stockport,North West,1446,5108,324,316,155,232,6135,1502,5519,348,303,169,233,6572,1127,278,259,150,214,2028,0.204203660083348,0.798850574712644,0.854785478547855,0.887573964497041,0.918454935622318,0.308581862446744
E02001201,Woodbank Park,Stockport,North West,1219,3627,270,252,169,254,4572,1163,3802,274,258,180,262,4776,832,230,240,174,255,1731,0.218832193582325,0.839416058394161,0.930232558139535,0.966666666666667,0.973282442748092,0.362437185929648
E02001202,Edgeley,Stockport,North West,1221,4391,217,194,130,159,5091,1271,4667,243,232,139,157,5438,805,167,207,125,144,1448,0.172487679451468,0.68724279835391,0.892241379310345,0.899280575539568,0.917197452229299,0.266274365575579
E02001203,Marple Bridge & Mellor,Stockport,North West,1013,3252,412,479,336,406,4885,1048,3634,423,453,359,436,5305,853,399,437,351,418,2458,0.2347275729224,0.943262411347518,0.964679911699779,0.977715877437326,0.958715596330275,0.463336475023563
E02001204,Cheadle Heath,Stockport,North West,1965,5941,421,330,185,381,7258,1803,6147,444,377,221,353,7542,1204,323,344,205,332,2408,0.195867903042134,0.727477477477478,0.912466843501326,0.927601809954751,0.940509915014164,0.319278705913551
E02001205,Heaviley,Stockport,North West,1480,5529,372,334,211,261,6707,1496,5777,374,357,242,302,7052,1227,306,330,232,271,2366,0.212393976112169,0.818181818181818,0.92436974789916,0.958677685950413,0.897350993377484,0.335507657402155
E02001206,Marple & Rose Hill,Stockport,North West,1324,4078,452,429,332,635,5926,1327,4517,431,482,324,622,6376,1041,385,467,317,602,2812,0.230462696479965,0.893271461716937,0.968879668049792,0.978395061728395,0.967845659163987,0.441028858218319
E02001207,Offerton East & Bosden Farm,Stockport,North West,1241,4212,446,429,269,380,5736,1205,4432,483,468,286,387,6056,1093,428,439,274,377,2611,0.246615523465704,0.886128364389234,0.938034188034188,0.958041958041958,0.974160206718346,0.431142668428005
E02001208,Cheadle East,Stockport,North West,1468,4867,365,284,230,358,6104,1379,5056,373,328,242,411,6410,1232,318,306,227,388,2471,0.243670886075949,0.85254691689008,0.932926829268293,0.93801652892562,0.944038929440389,0.385491419656786
E02001209,Davenport,Stockport,North West,1621,5195,331,283,207,302,6318,1526,5414,344,309,176,270,6513,1082,266,282,167,260,2057,0.199852234946435,0.773255813953488,0.912621359223301,0.948863636363636,0.962962962962963,0.31582987870413
E02001210,Offerton West,Stockport,North West,1712,4307,336,343,289,418,5693,1640,4859,368,321,295,375,6218,1125,302,290,285,362,2364,0.231529121218358,0.820652173913043,0.903426791277259,0.966101694915254,0.965333333333333,0.380186555162432
E02001211,Gatley North,Stockport,North West,1283,3787,325,322,215,476,5125,1393,4293,346,349,260,402,5650,1207,305,322,248,369,2451,0.281155369205684,0.88150289017341,0.922636103151862,0.953846153846154,0.917910447761194,0.433805309734513
E02001212,Adswood,Stockport,North West,1903,4394,238,186,153,195,5166,1840,4881,257,223,135,214,5710,929,209,191,126,195,1650,0.190329850440484,0.813229571984436,0.856502242152466,0.933333333333333,0.911214953271028,0.288966725043783
E02001213,Woodsmoor & Mile End,Stockport,North West,1971,6415,505,446,319,481,8166,1858,6715,502,453,346,488,8504,1525,418,421,324,464,3152,0.227103499627699,0.832669322709163,0.929359823399558,0.936416184971098,0.950819672131147,0.370649106302916
E02001214,Gatley South & Cheadle West,Stockport,North West,1451,4402,448,432,363,558,6203,1488,4979,430,494,381,609,6893,1487,383,463,361,566,3260,0.298654348262703,0.890697674418605,0.937246963562753,0.94750656167979,0.929392446633826,0.472943565936457
E02001215,Marple & Hawk Green,Stockport,North West,1063,3214,396,483,321,478,4892,1037,3606,411,511,356,491,5375,847,379,485,337,483,2531,0.234886300610094,0.922141119221411,0.949119373776908,0.946629213483146,0.983706720977597,0.470883720930233
E02001216,Cheadle Hulme Orrishmere,Stockport,North West,1453,4264,487,453,324,500,6028,1521,4805,460,477,355,515,6612,1100,418,445,338,498,2799,0.228928199791883,0.908695652173913,0.932914046121593,0.952112676056338,0.966990291262136,0.423321234119782
E02001217,Hazel Grove North,Stockport,North West,1314,4181,294,382,266,474,5597,1275,4469,306,390,266,487,5918,972,256,374,253,457,2312,0.217498321772209,0.836601307189543,0.958974358974359,0.951127819548872,0.938398357289528,0.390672524501521
E02001218,Bramhall North West,Stockport,North West,1178,3420,368,370,256,397,4811,1111,3773,391,412,303,462,5341,914,349,374,278,430,2345,0.242247548369997,0.892583120204604,0.907766990291262,0.917491749174918,0.930735930735931,0.439056356487549
E02001219,Hazel Grove West,Stockport,North West,939,3034,368,387,304,392,4485,873,3188,363,390,316,420,4677,730,330,369,305,398,2132,0.228983688833124,0.909090909090909,0.946153846153846,0.965189873417722,0.947619047619048,0.455847765661749
E02001220,Cheadle Hulme West,Stockport,North West,1168,3346,342,324,243,282,4537,1149,3675,327,335,248,300,4885,839,300,309,235,282,1965,0.228299319727891,0.91743119266055,0.922388059701493,0.94758064516129,0.94,0.402251791197544
E02001221,Hazel Grove East & South,Stockport,North West,1047,3327,346,429,306,441,4849,992,3689,350,396,345,485,5265,864,319,378,329,466,2356,0.234209812957441,0.911428571428571,0.954545454545455,0.953623188405797,0.960824742268041,0.447483380816714
E02001222,Heald Green West,Stockport,North West,1216,3639,414,407,296,475,5231,1294,4031,414,439,314,501,5699,1116,381,409,300,473,2679,0.276854378566113,0.920289855072464,0.931662870159453,0.955414012738854,0.944111776447106,0.470082470608879
E02001223,Bramhall North East,Stockport,North West,1191,3802,383,423,321,535,5464,1177,4297,454,426,366,575,6118,1027,419,403,345,543,2737,0.239003956248546,0.922907488986784,0.946009389671362,0.942622950819672,0.944347826086956,0.447368421052632
E02001224,High Lane,Stockport,North West,770,3043,400,519,440,622,5024,739,3385,416,539,462,645,5447,895,374,524,442,596,2831,0.264401772525849,0.899038461538462,0.972170686456401,0.956709956709957,0.924031007751938,0.519735634294107
E02001225,Cheadle Hulme South East,Stockport,North West,1426,4271,377,462,321,526,5957,1480,4705,416,466,332,514,6433,1052,375,427,309,491,2654,0.223591923485654,0.901442307692308,0.916309012875536,0.930722891566265,0.955252918287938,0.412560236281673
E02001226,Heald Green East,Stockport,North West,1509,4247,355,354,262,367,5585,1526,4620,380,372,266,421,6059,1256,345,337,247,403,2588,0.271861471861472,0.907894736842105,0.905913978494624,0.928571428571429,0.957244655581948,0.427133190295428
E02001227,Bramhall West,Stockport,North West,1073,3130,304,439,339,563,4775,1086,3269,335,376,346,531,4857,748,317,358,332,512,2267,0.228816151728357,0.946268656716418,0.952127659574468,0.959537572254335,0.964218455743879,0.46674902203006
E02001228,Bramhall South & Woodford,Stockport,North West,1009,3141,334,378,308,527,4688,1101,3805,376,361,324,560,5426,872,354,345,311,535,2417,0.229172141918528,0.941489361702128,0.955678670360111,0.959876543209877,0.955357142857143,0.445447843715444
E02001229,Mossley,Tameside,North West,1969,6513,521,546,316,318,8214,1954,6961,570,567,346,346,8790,1658,468,536,330,330,3322,0.238184168941244,0.821052631578947,0.945326278659612,0.953757225433526,0.953757225433526,0.377929465301479
E02001230,Ashton North,Tameside,North West,1045,3522,349,432,336,293,4932,1107,3873,365,444,342,316,5340,1098,325,419,321,284,2447,0.283501161890008,0.89041095890411,0.943693693693694,0.93859649122807,0.89873417721519,0.458239700374532
E02001231,Carrbrook & Micklehurst,Tameside,North West,1605,4491,367,402,193,156,5609,1527,4915,377,426,208,200,6126,964,327,394,193,183,2061,0.196134282807731,0.86737400530504,0.924882629107981,0.927884615384615,0.915,0.33643486777669
E02001232,Hurst Cross,Tameside,North West,1885,5254,347,385,251,365,6602,1925,5819,358,403,275,311,7166,1475,300,363,247,267,2652,0.2534799793779,0.837988826815642,0.900744416873449,0.898181818181818,0.858520900321543,0.370080937761652
E02001233,Ashton Waterloo,Tameside,North West,1637,4725,442,430,290,363,6250,1752,5205,468,469,316,372,6830,1199,408,423,277,330,2637,0.230355427473583,0.871794871794872,0.901918976545842,0.876582278481013,0.887096774193548,0.386090775988287
E02001234,Smallshaw,Tameside,North West,1823,4828,336,334,212,290,6000,1969,5481,330,362,235,310,6718,1251,279,331,208,266,2335,0.22824302134647,0.845454545454546,0.914364640883978,0.885106382978723,0.858064516129032,0.347573682643644
E02001235,Ashton East,Tameside,North West,1431,4624,304,286,205,271,5690,1519,5166,328,289,225,256,6264,1362,271,255,204,224,2316,0.263646922183508,0.826219512195122,0.882352941176471,0.906666666666667,0.875,0.369731800766284
E02001236,Stalybridge North,Tameside,North West,1320,3682,242,248,176,287,4635,1456,4191,271,263,175,262,5162,729,214,240,160,239,1582,0.17394416607015,0.789667896678967,0.91254752851711,0.914285714285714,0.912213740458015,0.306470360325455
E02001237,Stalybridge East & Swineshaw,Tameside,North West,1482,4531,350,321,156,275,5633,1489,4900,317,346,196,257,6016,842,261,311,189,241,1844,0.171836734693878,0.823343848580442,0.898843930635838,0.964285714285714,0.937743190661479,0.306515957446809
E02001238,Droylsden East,Tameside,North West,1485,4863,429,438,294,384,6408,1474,5257,449,460,309,403,6878,1105,358,420,282,353,2518,0.210195929237208,0.797327394209354,0.91304347826087,0.912621359223301,0.875930521091811,0.366094794998546
E02001239,Droylsden Central,Tameside,North West,1974,5993,406,394,296,376,7465,2048,6611,430,391,310,380,8122,1284,337,358,278,333,2590,0.194221751626078,0.783720930232558,0.915601023017903,0.896774193548387,0.876315789473684,0.31888697365181
E02001240,Droylsden West,Tameside,North West,1181,3846,305,307,230,278,4966,1252,4432,314,322,208,258,5534,871,260,300,194,236,1861,0.196525270758123,0.828025477707007,0.93167701863354,0.932692307692308,0.914728682170543,0.336284784965667
E02001241,Ashton Central,Tameside,North West,2628,7090,433,314,197,197,8231,2951,8317,448,364,207,219,9555,1410,344,291,166,174,2385,0.169532283275219,0.767857142857143,0.79945054945055,0.801932367149759,0.794520547945206,0.249607535321821
E02001242,Audenshaw,Tameside,North West,1269,4214,340,309,241,365,5469,1355,4561,378,338,271,352,5900,980,324,307,246,311,2168,0.214865161148871,0.857142857142857,0.908284023668639,0.907749077490775,0.883522727272727,0.367457627118644
E02001243,Stalybridge South,Tameside,North West,1306,4951,499,534,325,394,6703,1295,5355,506,557,396,421,7235,1011,458,528,365,392,2754,0.188795518207283,0.905138339920949,0.947935368043088,0.921717171717172,0.931116389548693,0.380649619903248
E02001244,Dukinfield East & Hough Hill,Tameside,North West,929,3192,347,418,257,254,4468,955,3456,358,398,296,274,4782,744,322,371,278,257,1972,0.215277777777778,0.899441340782123,0.9321608040201,0.939189189189189,0.937956204379562,0.412379757423672
E02001245,Dukinfield West,Tameside,North West,1647,5310,406,352,217,298,6583,1580,5707,400,373,233,289,7002,1030,337,334,210,246,2157,0.180480112142982,0.8425,0.89544235924933,0.901287553648069,0.85121107266436,0.308054841473865
E02001246,Newtonmoor,Tameside,North West,1467,4467,379,380,261,401,5888,1474,4888,381,410,247,403,6329,905,312,373,219,365,2174,0.185147299509002,0.818897637795276,0.909756097560976,0.88663967611336,0.905707196029777,0.343498182967293
E02001247,Guide Bridge,Tameside,North West,1391,4391,325,311,223,301,5551,1458,5015,373,335,229,312,6264,974,293,285,202,275,2029,0.194217347956132,0.785522788203753,0.850746268656716,0.882096069868996,0.881410256410256,0.323914431673052
E02001248,Hyde North,Tameside,North West,2662,7308,475,415,274,263,8735,2723,7989,496,482,283,294,9544,1181,407,417,246,231,2482,0.147828263862811,0.820564516129032,0.865145228215768,0.869257950530035,0.785714285714286,0.260058675607712
E02001249,Denton North,Tameside,North West,1235,3963,291,279,227,291,5051,1232,4390,308,282,229,292,5501,827,227,258,202,250,1764,0.188382687927107,0.737012987012987,0.914893617021277,0.882096069868996,0.856164383561644,0.320668969278313
E02001250,Godley,Tameside,North West,1119,4054,384,429,275,273,5415,1064,4291,392,414,304,290,5691,765,339,379,278,247,2008,0.178280121183873,0.864795918367347,0.915458937198068,0.914473684210526,0.851724137931035,0.352837814092427
E02001251,"Mottram, Hollingworth & Broadbottom",Tameside,North West,946,3577,429,409,266,306,4987,945,3868,445,436,284,332,5365,636,384,411,270,307,2008,0.164426059979317,0.862921348314607,0.942660550458715,0.950704225352113,0.924698795180723,0.374277726001864
E02001252,Dane Bank,Tameside,North West,1224,4410,364,416,337,552,6079,1215,4817,413,441,325,556,6552,1137,339,399,302,485,2662,0.236039028440938,0.820823244552058,0.904761904761905,0.929230769230769,0.872302158273381,0.406288156288156
E02001253,Denton West,Tameside,North West,880,3057,250,283,195,259,4044,910,3403,287,270,232,261,4453,722,220,244,202,234,1622,0.212165736115192,0.766550522648084,0.903703703703704,0.870689655172414,0.896551724137931,0.364248821019537
E02001254,Denton East,Tameside,North West,1028,3474,304,329,252,251,4610,1029,3784,291,359,244,275,4953,694,223,326,218,244,1705,0.183403805496829,0.766323024054983,0.908077994428969,0.89344262295082,0.887272727272727,0.344235816676762
E02001255,Hattersley,Tameside,North West,1823,4094,283,274,180,245,5076,2042,5024,287,285,163,253,6012,663,221,243,149,218,1494,0.131966560509554,0.770034843205575,0.852631578947369,0.914110429447853,0.861660079051383,0.248502994011976
E02001256,Hyde South,Tameside,North West,2428,6732,366,349,269,440,8156,2380,7288,394,385,308,469,8844,883,313,333,260,395,2184,0.12115806805708,0.794416243654822,0.864935064935065,0.844155844155844,0.842217484008529,0.246947082767978
E02001257,Denton South,Tameside,North West,1688,5322,504,527,444,545,7342,1732,5957,512,540,436,594,8039,1170,405,478,394,515,2962,0.196407587711936,0.791015625,0.885185185185185,0.903669724770642,0.867003367003367,0.36845378778455
E02001258,Cheetham Fold & Gee Cross,Tameside,North West,1254,4228,476,457,339,440,5940,1318,4631,431,484,345,500,6391,833,365,442,306,445,2391,0.179874757071907,0.846867749419954,0.913223140495868,0.886956521739131,0.89,0.374119856047567
E02001259,Old Trafford,Trafford,North West,2638,7796,260,181,144,312,8693,2658,9336,343,231,153,323,10386,1263,221,178,107,217,1986,0.135282776349614,0.644314868804665,0.770562770562771,0.699346405228758,0.671826625386997,0.191218948584633
E02001260,Trafford Park West & Kingsway Park,Trafford,North West,1505,4616,370,455,306,345,6092,1483,5125,394,432,336,376,6663,1279,351,417,322,351,2720,0.249560975609756,0.890862944162437,0.965277777777778,0.958333333333333,0.933510638297872,0.408224523487918
E02001261,Gorse Hill,Trafford,North West,2010,5713,274,210,149,225,6571,1971,6352,309,252,167,233,7313,1096,235,222,148,210,1911,0.172544080604534,0.760517799352751,0.880952380952381,0.88622754491018,0.901287553648069,0.261315465609189
E02001262,Firswood,Trafford,North West,1832,5702,295,243,204,371,6815,1970,6633,365,294,199,400,7891,1172,282,240,161,317,2172,0.176692296095281,0.772602739726028,0.816326530612245,0.809045226130653,0.7925,0.275250285134964
E02001263,Davyhulme,Trafford,North West,1556,4861,467,527,353,541,6749,1564,5362,483,522,428,613,7408,1384,431,487,402,590,3294,0.258112644535621,0.892339544513458,0.932950191570881,0.939252336448598,0.962479608482871,0.444654427645788
E02001264,Trafford Park East & Sevenways,Trafford,North West,1971,5385,319,269,250,309,6532,1941,5966,364,305,236,322,7193,1248,302,275,221,290,2336,0.20918538384177,0.82967032967033,0.901639344262295,0.936440677966102,0.900621118012422,0.324760183511748
E02001265,Flixton & Moorside,Trafford,North West,1603,4989,435,425,297,400,6546,1592,5561,461,469,291,413,7195,1275,408,438,277,381,2779,0.229275310196008,0.885032537960955,0.933901918976546,0.951890034364261,0.922518159806295,0.386240444753301
E02001266,Lostock & Stretford Meadows,Trafford,North West,1393,4449,333,308,201,324,5615,1362,4730,330,349,224,313,5946,998,264,308,211,297,2078,0.210993657505285,0.8,0.882521489971347,0.941964285714286,0.94888178913738,0.349478641103263
E02001267,Urmston East,Trafford,North West,1293,4743,359,342,237,581,6262,1231,4832,364,378,266,496,6336,1111,308,345,243,455,2462,0.229925496688742,0.846153846153846,0.912698412698413,0.913533834586466,0.917338709677419,0.388573232323232
E02001268,Urmston West,Trafford,North West,1210,4080,448,424,327,488,5767,1235,4535,435,467,343,491,6271,1172,398,441,331,463,2805,0.258434399117971,0.914942528735632,0.944325481798715,0.965014577259475,0.942973523421589,0.447297081805135
E02001269,Stretford East,Trafford,North West,1699,5385,415,311,197,377,6685,1680,6006,406,363,219,365,7359,1152,343,326,186,323,2330,0.191808191808192,0.844827586206897,0.898071625344353,0.849315068493151,0.884931506849315,0.316619105856774
E02001270,Sale North,Trafford,North West,1844,5412,326,326,246,388,6698,1826,5748,351,346,260,447,7152,1153,304,322,244,432,2455,0.200591510090466,0.866096866096866,0.930635838150289,0.938461538461539,0.966442953020134,0.34326062639821
E02001271,Ashton upon Mersey North,Trafford,North West,1335,4018,358,294,218,348,5236,1421,4474,360,321,207,331,5693,1020,322,295,197,309,2143,0.227983907018328,0.894444444444445,0.919003115264798,0.951690821256039,0.933534743202417,0.376427191287546
E02001272,Sale East,Trafford,North West,1847,4915,436,380,304,495,6530,1663,5182,407,416,319,478,6802,1175,376,399,306,457,2713,0.226746429949826,0.923832923832924,0.959134615384615,0.959247648902821,0.956066945606695,0.398853278447515
E02001273,Sale Central,Trafford,North West,2024,6542,419,403,299,517,8180,1976,6508,434,421,307,554,8224,1191,375,384,292,533,2775,0.18300553165335,0.864055299539171,0.912114014251781,0.95114006514658,0.962093862815884,0.337427042801556
E02001274,Ashton upon Mersey South,Trafford,North West,1448,4556,494,537,405,625,6617,1507,5117,506,531,418,629,7201,1222,463,497,401,597,3180,0.238811803791284,0.91501976284585,0.935969868173258,0.95933014354067,0.94912559618442,0.441605332592695
E02001275,Partington,Trafford,North West,2284,5036,366,297,222,370,6291,2120,5728,403,371,226,340,7068,1518,352,337,212,311,2730,0.265013966480447,0.873449131513648,0.908355795148248,0.938053097345133,0.914705882352941,0.386247877758913
E02001276,Sale Moor,Trafford,North West,1918,4878,418,357,233,374,6260,1939,5467,387,404,250,359,6867,1233,350,377,236,341,2537,0.22553502835193,0.904392764857881,0.933168316831683,0.944,0.949860724233983,0.369448085044415
E02001277,Broadheath & Firsway,Trafford,North West,2454,6209,301,315,235,207,7267,2337,6636,342,309,261,221,7769,1558,294,273,238,202,2565,0.234779987944545,0.859649122807018,0.883495145631068,0.911877394636015,0.914027149321267,0.330158321534303
E02001278,West Timperley,Trafford,North West,1943,5214,433,454,227,443,6771,1952,5690,430,439,293,420,7272,1356,397,417,280,390,2840,0.238312829525483,0.923255813953488,0.949886104783599,0.955631399317406,0.928571428571429,0.390539053905391
E02001279,Timperley North,Trafford,North West,1799,5102,438,385,305,463,6693,1778,5534,451,455,318,440,7198,1538,414,435,306,409,3102,0.277918323093603,0.917960088691796,0.956043956043956,0.962264150943396,0.929545454545454,0.430953042511809
E02001280,Timperley East,Trafford,North West,1866,4964,403,448,284,469,6568,1810,5479,405,453,357,496,7190,1615,353,423,335,468,3194,0.294761817849973,0.871604938271605,0.933774834437086,0.938375350140056,0.943548387096774,0.4442280945758
E02001281,Timperley South,Trafford,North West,1515,4304,414,463,359,562,6102,1574,4910,416,457,388,581,6752,1462,385,436,370,561,3214,0.29775967413442,0.925480769230769,0.954048140043764,0.95360824742268,0.965576592082616,0.476007109004739
E02001282,Altrincham East,Trafford,North West,2345,6491,401,343,266,363,7864,2312,7056,414,371,269,359,8469,1825,361,344,252,354,3136,0.258645124716553,0.871980676328503,0.92722371967655,0.936802973977695,0.986072423398329,0.370291651906955
E02001283,"Altrincham West, Dunham & Warburton",Trafford,North West,1910,5887,428,498,385,655,7853,1966,6438,454,473,413,661,8439,1649,392,436,387,619,3483,0.256135445790618,0.863436123348018,0.921775898520085,0.937046004842615,0.936459909228442,0.412726626377533
E02001284,Hale,Trafford,North West,2084,5120,335,343,213,356,6367,1917,5565,394,354,251,357,6921,1707,354,332,237,342,2972,0.306738544474394,0.898477157360406,0.937853107344633,0.944223107569721,0.957983193277311,0.42941771420315
E02001285,Bowdon,Trafford,North West,1574,4593,427,459,366,630,6475,1490,5074,466,478,378,620,7016,1358,420,437,351,592,3158,0.267638943634214,0.901287553648069,0.914225941422594,0.928571428571429,0.954838709677419,0.450114025085519
E02001286,Hale Barns,Trafford,North West,1772,4539,452,481,400,711,6583,1852,5148,498,485,421,696,7248,1841,443,441,387,667,3779,0.357614607614608,0.889558232931727,0.909278350515464,0.919239904988124,0.958333333333333,0.521385209713024
E02001287,Standish North,Wigan,North West,1107,3700,318,333,250,287,4888,1109,4105,292,359,289,299,5344,1077,275,340,274,283,2249,0.262362971985384,0.941780821917808,0.947075208913649,0.948096885813149,0.946488294314381,0.420845808383234
E02001288,Standish South,Wigan,North West,1317,4719,502,553,352,479,6605,1351,5197,505,557,372,503,7134,1376,445,522,356,478,3177,0.264768135462767,0.881188118811881,0.937163375224416,0.956989247311828,0.950298210735587,0.445332211942809
E02001289,Shevington,Wigan,North West,1635,5867,674,801,507,619,8468,1630,6222,693,766,557,666,8904,1539,548,736,540,646,4009,0.247348119575699,0.790764790764791,0.960835509138381,0.969479353680431,0.96996996996997,0.450247079964061
E02001290,Aspull & Red Rock,Wigan,North West,989,3793,373,405,280,324,5175,974,3893,344,385,298,408,5328,808,284,361,287,393,2133,0.207552016439764,0.825581395348837,0.937662337662338,0.963087248322148,0.963235294117647,0.400337837837838
E02001291,Beech Hill,Wigan,North West,1590,4730,382,393,301,332,6138,1480,5039,401,396,311,351,6498,1045,288,376,300,335,2344,0.207382417146259,0.718204488778055,0.949494949494949,0.964630225080386,0.954415954415954,0.360726377346876
E02001292,Wigan Marylebone & Bottling Wood,Wigan,North West,1241,5031,458,487,325,517,6818,1263,5418,472,460,379,535,7264,1114,368,435,367,508,2792,0.205610926541159,0.779661016949153,0.945652173913043,0.968337730870712,0.949532710280374,0.384361233480176
E02001293,New Springs,Wigan,North West,1031,3753,354,416,286,263,5072,1072,3971,329,418,309,319,5346,811,269,397,296,302,2075,0.204230672374717,0.817629179331307,0.949760765550239,0.957928802588997,0.946708463949843,0.388140665918444
E02001294,Wigan Central,Wigan,North West,1301,5326,343,315,244,364,6592,1276,5742,336,342,226,396,7042,1113,243,326,206,375,2263,0.193834900731452,0.723214285714286,0.953216374269006,0.911504424778761,0.946969696969697,0.321357568872479
E02001295,Wigan East,Wigan,North West,1455,5025,401,310,231,315,6282,1309,5082,383,328,219,289,6301,843,265,300,211,253,1872,0.165879574970484,0.691906005221932,0.914634146341463,0.963470319634703,0.875432525951557,0.297095699095382
E02001296,Laithwaite & Marsh Green,Wigan,North West,2639,5972,347,338,218,259,7134,2451,5942,343,321,224,254,7084,983,230,301,203,229,1946,0.165432514304948,0.670553935860058,0.937694704049844,0.90625,0.901574803149606,0.274703557312253
E02001297,Pemberton North,Wigan,North West,1187,4283,392,373,213,260,5521,1202,4339,381,373,235,261,5589,870,274,350,221,242,1957,0.200507029269417,0.719160104986877,0.938337801608579,0.940425531914894,0.9272030651341,0.350152084451601
E02001298,Ince-in-Makerfield,Wigan,North West,1951,5474,359,343,233,305,6714,1885,5678,338,359,241,257,6873,989,212,341,223,226,1991,0.174181049665375,0.627218934911243,0.949860724233983,0.925311203319502,0.879377431906615,0.289684271788157
E02001299,Hindley West,Wigan,North West,1617,5758,422,442,360,397,7379,1490,5953,405,435,373,408,7574,1374,320,412,345,373,2824,0.230807995968419,0.790123456790123,0.947126436781609,0.924932975871314,0.91421568627451,0.372854502244521
E02001300,Pemberton South,Wigan,North West,1523,5120,455,432,359,416,6782,1484,5252,432,444,376,423,6927,1153,326,416,363,399,2657,0.21953541507997,0.75462962962963,0.936936936936937,0.965425531914894,0.943262411347518,0.383571531687599
E02001301,Wigan South,Wigan,North West,1867,5916,397,356,237,367,7273,1849,5979,387,407,262,368,7403,1287,272,376,248,352,2535,0.215253386853989,0.702842377260982,0.923832923832924,0.946564885496183,0.956521739130435,0.342428745103337
E02001302,Hindley East,Wigan,North West,1610,4777,430,466,327,389,6389,1591,5134,399,477,362,400,6772,1230,306,443,342,362,2683,0.239579275418777,0.766917293233083,0.928721174004193,0.94475138121547,0.905,0.39619019492026
E02001303,Atherton North,Wigan,North West,2022,5735,400,339,218,264,6956,2073,5980,371,373,246,265,7235,1030,290,335,230,246,2131,0.172240802675585,0.78167115902965,0.898123324396783,0.934959349593496,0.928301886792453,0.294540428472702
E02001304,Orrell & Longshaw,Wigan,North West,2308,7670,714,851,620,761,10616,2234,7812,665,819,620,869,10785,1957,590,782,604,832,4765,0.250512032770097,0.887218045112782,0.954822954822955,0.974193548387097,0.957422324510932,0.441817338896616
E02001305,Hindley Green,Wigan,North West,1394,4966,520,593,435,339,6853,1403,5155,516,579,446,434,7130,1205,408,547,430,414,3004,0.233753637245393,0.790697674418605,0.944732297063903,0.964125560538117,0.953917050691244,0.421318373071529
E02001306,Worsley Mesnes & Hawkley,Wigan,North West,1137,4406,461,609,354,315,6145,1177,4550,446,587,395,354,6332,1178,377,561,382,343,2841,0.258901098901099,0.845291479820628,0.955706984667802,0.967088607594937,0.968926553672316,0.448673404927353
E02001307,Winstanley,Wigan,North West,2253,7130,751,804,435,422,9542,2151,7402,675,808,510,430,9825,1833,578,782,491,411,4095,0.247635774115104,0.856296296296296,0.967821782178218,0.962745098039216,0.955813953488372,0.416793893129771
E02001308,Atherton South East & Tyldesley West,Wigan,North West,1021,3703,361,361,315,367,5107,938,3730,381,352,308,342,5113,684,302,334,296,326,1942,0.183378016085791,0.792650918635171,0.948863636363636,0.961038961038961,0.953216374269006,0.379816154899276
E02001309,Atherton South West,Wigan,North West,1510,5272,436,392,327,379,6806,1455,5336,445,442,333,422,6978,1058,344,409,317,391,2519,0.198275862068966,0.773033707865169,0.925339366515837,0.951951951951952,0.92654028436019,0.360991688162797
E02001310,Platt Bridge & Spring View,Wigan,North West,2107,5945,453,394,261,263,7316,2072,6174,406,428,291,278,7577,1294,307,397,274,256,2528,0.209588597343699,0.75615763546798,0.927570093457944,0.941580756013746,0.920863309352518,0.333641282829616
E02001311,Tyldesley North,Wigan,North West,1511,5249,472,498,315,302,6836,1496,5356,491,474,295,337,6953,999,380,437,279,324,2419,0.186519790888723,0.773930753564155,0.921940928270042,0.945762711864407,0.961424332344214,0.347907378110168
E02001312,Abram & Bickershaw,Wigan,North West,1680,5496,403,417,221,219,6756,1709,5866,399,392,266,209,7132,1171,308,362,253,196,2290,0.199624957381521,0.771929824561403,0.923469387755102,0.951127819548872,0.937799043062201,0.32108805384184
E02001313,Leigh North,Wigan,North West,1796,5064,365,406,282,323,6440,1772,5264,400,406,295,295,6660,916,273,368,276,278,2111,0.174012158054711,0.6825,0.906403940886699,0.935593220338983,0.942372881355932,0.316966966966967
E02001314,Tyldesley South,Wigan,North West,1761,5352,439,416,208,205,6620,1643,5397,455,420,257,231,6760,1126,373,391,252,223,2365,0.208634426533259,0.81978021978022,0.930952380952381,0.980544747081712,0.965367965367965,0.349852071005917
E02001315,"Astley, Blackmoor & Mosley Common",Wigan,North West,1578,5009,435,521,373,354,6692,1648,5656,448,529,402,404,7439,1210,373,495,389,382,2849,0.213932107496464,0.832589285714286,0.935727788279773,0.967661691542289,0.945544554455445,0.382981583546176
E02001316,Leigh Central,Wigan,North West,1179,4650,245,269,153,198,5515,1454,5128,271,269,195,194,6057,745,170,239,178,165,1497,0.145280811232449,0.627306273062731,0.888475836431227,0.912820512820513,0.850515463917526,0.247152055473006
E02001317,Leigh East & Higher Folds,Wigan,North West,1593,5426,465,482,315,390,7078,1565,5793,449,490,383,413,7528,1079,343,451,346,371,2590,0.186259278439496,0.763919821826281,0.920408163265306,0.903394255874674,0.898305084745763,0.344048884165781
E02001318,Ashton-in-Makerfield North,Wigan,North West,1384,4667,523,492,368,438,6488,1326,4905,477,523,396,431,6732,989,407,486,369,402,2653,0.201630988786952,0.853249475890985,0.92925430210325,0.931818181818182,0.932714617169374,0.394087938205585
E02001319,Leigh West,Wigan,North West,1478,5070,392,382,255,235,6334,1621,5538,388,408,269,297,6900,1025,257,380,242,260,2164,0.18508486818346,0.662371134020619,0.931372549019608,0.899628252788104,0.875420875420875,0.313623188405797
E02001320,Leigh South East,Wigan,North West,1308,4890,391,405,308,353,6347,1271,4910,369,415,365,373,6432,894,265,388,348,336,2231,0.182077393075356,0.718157181571816,0.934939759036144,0.953424657534246,0.900804289544236,0.346859452736318
E02001321,Ashton-in-Makerfield East,Wigan,North West,1530,5055,467,454,364,368,6708,1448,5263,466,487,381,401,6998,1119,396,468,366,359,2708,0.212616378491355,0.849785407725322,0.960985626283368,0.960629921259842,0.895261845386534,0.386967705058588
E02001322,Ashton-in-Makerfield West,Wigan,North West,1134,4340,466,505,401,472,6184,1092,4399,444,501,434,502,6280,914,383,468,423,473,2661,0.207774494203228,0.862612612612613,0.934131736526946,0.974654377880184,0.942231075697211,0.423726114649682
E02001323,Leigh South,Wigan,North West,1539,4813,433,479,364,341,6430,1369,4963,411,462,386,399,6621,897,321,437,361,377,2393,0.180737457183155,0.781021897810219,0.945887445887446,0.935233160621762,0.944862155388471,0.361425766500529
E02001324,Golborne,Wigan,North West,1668,5309,429,438,286,371,6833,1588,5387,410,453,309,377,6936,1178,347,418,294,356,2593,0.218674586968628,0.846341463414634,0.922737306843267,0.951456310679612,0.944297082228117,0.373846597462514
E02001325,Lowton,Wigan,North West,1343,4837,513,519,349,387,6605,1417,5463,512,550,414,404,7343,1334,451,527,397,380,3089,0.244188174995424,0.880859375,0.958181818181818,0.958937198067633,0.940594059405941,0.420672749557402
E02001326,Lowton Common,Wigan,North West,1468,4694,439,574,364,392,6463,1407,4878,426,534,427,434,6699,1053,360,509,397,393,2712,0.215867158671587,0.845070422535211,0.953183520599251,0.929742388758782,0.905529953917051,0.404836542767577
E02001327,Kirkby North East,Knowsley,North West,2358,4919,486,309,151,139,6004,2607,6489,547,372,166,131,7705,1308,466,345,149,116,2384,0.201571890892279,0.851919561243144,0.92741935483871,0.897590361445783,0.885496183206107,0.309409474367294
E02001328,Kirkby North West,Knowsley,North West,1957,6480,565,497,336,388,8266,2008,7261,599,546,337,408,9151,1773,519,505,312,358,3467,0.244181242253133,0.86644407345576,0.924908424908425,0.925816023738872,0.877450980392157,0.378865697737952
E02001329,Kirkby South East,Knowsley,North West,1447,4896,457,259,166,266,6044,1512,5533,506,291,135,245,6710,1181,379,255,124,214,2153,0.213446593168263,0.74901185770751,0.876288659793815,0.918518518518519,0.873469387755102,0.320864381520119
E02001330,Kirkby South West & Field Lane,Knowsley,North West,1965,5736,523,345,178,309,7091,1936,6543,591,396,192,305,8027,1483,483,353,176,261,2756,0.226654439859392,0.817258883248731,0.891414141414142,0.916666666666667,0.855737704918033,0.343341223371122
E02001331,Knowsley Village & Southdene,Knowsley,North West,2080,6230,623,483,263,442,8041,2122,7234,638,538,277,420,9107,1481,522,485,254,379,3121,0.204727674868676,0.818181818181818,0.901486988847584,0.916967509025271,0.902380952380952,0.342703414955529
E02001332,Stockbridge Village,Knowsley,North West,1541,4711,273,306,256,281,5827,1680,5357,288,275,295,350,6565,1018,238,252,270,313,2091,0.190031734179578,0.826388888888889,0.916363636363636,0.915254237288136,0.894285714285714,0.318507235338919
E02001333,Prescot,Knowsley,North West,1742,5600,406,383,262,468,7119,1820,6214,460,373,295,416,7758,1590,376,349,268,393,2976,0.255873833279691,0.817391304347826,0.935656836461126,0.908474576271187,0.944711538461539,0.383604021655066
E02001334,Page Moss & Fincham,Knowsley,North West,1387,3737,222,211,153,207,4530,1562,4785,272,235,163,181,5636,952,205,197,148,153,1655,0.198955067920585,0.753676470588235,0.838297872340426,0.907975460122699,0.845303867403315,0.293647977288857
E02001335,Whiston North,Knowsley,North West,1473,5197,384,374,235,380,6570,1508,5658,407,389,230,370,7054,1701,362,353,213,349,2978,0.300636267232238,0.889434889434889,0.90745501285347,0.926086956521739,0.943243243243243,0.422171817408563
E02001336,Longview & Knowsley Park,Knowsley,North West,1641,4483,329,248,185,376,5621,1685,5163,309,277,164,286,6199,983,245,245,145,261,1879,0.190393182258377,0.792880258899676,0.884476534296029,0.884146341463415,0.912587412587413,0.303113405387966
E02001337,Mosscroft & Bakers Green,Knowsley,North West,1207,3809,262,223,160,315,4769,1137,4176,288,243,149,333,5189,954,242,227,139,299,1861,0.228448275862069,0.840277777777778,0.934156378600823,0.932885906040269,0.897897897897898,0.358643283869724
E02001338,Huyton Farm,Knowsley,North West,1282,3612,234,250,233,294,4623,1256,4144,264,264,217,309,5198,913,224,244,195,289,1865,0.220318532818533,0.848484848484848,0.924242424242424,0.898617511520737,0.935275080906149,0.358791843016545
E02001339,Whiston South,Knowsley,North West,1370,3923,300,288,218,293,5022,1346,4384,296,280,232,286,5478,1026,243,263,225,268,2025,0.234032846715329,0.820945945945946,0.939285714285714,0.969827586206897,0.937062937062937,0.369660460021906
E02001340,Court Hey & Swanside,Knowsley,North West,1787,5857,497,421,350,547,7672,1816,6413,549,475,326,563,8326,1660,483,440,312,525,3420,0.258849212537034,0.879781420765027,0.926315789473684,0.957055214723926,0.932504440497336,0.410761470093683
E02001341,Huyton East,Knowsley,North West,1569,4644,361,267,245,385,5902,1568,5275,422,340,224,355,6616,1171,331,309,199,313,2323,0.221990521327014,0.78436018957346,0.908823529411765,0.888392857142857,0.88169014084507,0.351118500604595
E02001342,Huyton West & Roby,Knowsley,North West,1119,4419,458,420,300,587,6184,1209,5054,499,437,324,653,6967,1325,443,411,309,616,3104,0.262168579343095,0.887775551102205,0.940503432494279,0.953703703703704,0.943338437978561,0.445528922061145
E02001343,"Halsnead, Cronton & Halewood East",Knowsley,North West,1230,4490,500,411,278,409,6088,1156,4748,492,446,287,357,6330,1235,460,415,273,332,2715,0.26010951979781,0.934959349593496,0.930493273542601,0.951219512195122,0.929971988795518,0.428909952606635
E02001344,Halewood North,Knowsley,North West,910,3459,285,260,139,346,4489,928,3908,339,294,146,298,4985,950,287,273,130,274,1914,0.243091095189355,0.846607669616519,0.928571428571429,0.89041095890411,0.919463087248322,0.3839518555667
E02001345,Halewood Central,Knowsley,North West,854,3417,368,313,218,305,4621,836,3647,395,331,226,318,4917,861,349,307,218,301,2036,0.236084452975048,0.883544303797468,0.927492447129909,0.964601769911504,0.946540880503145,0.414073622127313
E02001346,Halewood South,Knowsley,North West,1599,4692,369,276,185,339,5861,1644,5526,421,313,175,322,6757,1153,342,273,151,289,2208,0.208650018096272,0.812351543942993,0.87220447284345,0.862857142857143,0.897515527950311,0.326772236199497
E02001347,Fazakerley North,Liverpool,North West,1639,5056,339,277,218,331,6221,1662,5677,393,318,210,331,6929,1651,324,283,183,304,2745,0.290822617579708,0.824427480916031,0.889937106918239,0.871428571428572,0.918429003021148,0.396161062202338
E02001348,Walton Vale,Liverpool,North West,1244,4452,364,259,184,282,5541,1270,4799,391,294,249,285,6018,1187,331,270,223,260,2271,0.247343196499271,0.846547314578005,0.918367346938776,0.895582329317269,0.912280701754386,0.377367896311067
E02001349,Orrell Park,Liverpool,North West,1458,5047,414,354,206,279,6300,1302,6392,449,381,237,312,7771,1366,378,350,221,289,2604,0.213704630788486,0.841870824053452,0.918635170603675,0.932489451476793,0.926282051282051,0.335092008750483
E02001350,Croxteth West & Gillmoss,Liverpool,North West,1745,4895,422,308,211,438,6274,1910,5724,463,384,242,433,7246,1328,390,353,225,400,2696,0.232005590496157,0.842332613390929,0.919270833333333,0.929752066115702,0.92378752886836,0.37206734750207
E02001351,Fazakerley South,Liverpool,North West,1738,5744,400,294,212,300,6950,1895,7770,460,344,219,285,9078,1651,354,296,201,257,2759,0.212483912483913,0.769565217391304,0.86046511627907,0.917808219178082,0.901754385964912,0.303921568627451
E02001352,Walton North,Liverpool,North West,1400,4820,310,255,196,200,5781,1328,4869,330,275,182,226,5882,1084,264,238,166,208,1960,0.222632984185664,0.8,0.865454545454545,0.912087912087912,0.920353982300885,0.333219993199592
E02001353,Croxteth East,Liverpool,North West,1386,4820,386,254,172,283,5915,1276,5131,433,325,191,239,6319,1290,379,293,173,226,2361,0.25141297992594,0.875288683602771,0.901538461538462,0.905759162303665,0.94560669456067,0.373635068840006
E02001354,Walton East,Liverpool,North West,1605,4777,380,283,203,335,5978,1722,5470,424,347,214,290,6745,1348,335,314,193,266,2456,0.246435100548446,0.790094339622642,0.904899135446686,0.901869158878505,0.917241379310345,0.36412157153447
E02001355,Walton Hall,Liverpool,North West,1248,4235,351,306,212,288,5392,1333,4737,356,321,211,250,5875,1036,307,294,193,237,2067,0.218703820983745,0.862359550561798,0.91588785046729,0.914691943127962,0.948,0.351829787234043
E02001356,Norris Green East,Liverpool,North West,2485,5100,233,228,127,214,5902,2682,6051,265,234,166,172,6888,1252,199,210,154,157,1972,0.206907949099322,0.750943396226415,0.897435897435897,0.927710843373494,0.912790697674419,0.286295005807201
E02001357,Norris Green West,Liverpool,North West,1737,4229,331,230,179,347,5316,1784,5094,363,270,200,348,6275,1245,303,235,180,319,2282,0.244405182567727,0.834710743801653,0.87037037037037,0.9,0.916666666666667,0.363665338645418
E02001358,Walton South,Liverpool,North West,1480,4570,276,259,201,226,5532,1517,5289,313,289,178,227,6296,891,258,263,162,208,1782,0.168462847419172,0.824281150159744,0.910034602076125,0.910112359550562,0.916299559471366,0.283036848792884
E02001359,Croxteth Park,Liverpool,North West,889,3389,349,298,192,274,4502,961,3825,415,325,216,285,5066,1049,346,305,200,271,2171,0.274248366013072,0.833734939759036,0.938461538461539,0.925925925925926,0.950877192982456,0.428543229372286
E02001360,Kirkdale North,Liverpool,North West,1696,5567,476,412,259,288,7002,1896,6627,510,452,254,284,8127,1033,390,401,225,254,2303,0.155877470952165,0.764705882352941,0.88716814159292,0.885826771653543,0.894366197183099,0.283376399655469
E02001361,Anfield North,Liverpool,North West,1416,4647,411,360,258,325,6001,1490,5364,462,366,262,313,6767,1358,390,330,247,293,2618,0.25316927665921,0.844155844155844,0.901639344262295,0.942748091603053,0.936102236421725,0.386877493719521
E02001362,Muirhead Avenue,Liverpool,North West,1236,4404,412,338,273,522,5949,1406,5176,477,397,266,491,6807,1355,386,371,248,454,2814,0.261785162287481,0.809224318658281,0.934508816120907,0.932330827067669,0.924643584521385,0.413397972675187
E02001363,Yewtree,Liverpool,North West,1795,4865,305,301,208,282,5961,1847,5454,354,276,225,299,6608,1237,275,248,202,259,2221,0.226806013934727,0.77683615819209,0.898550724637681,0.897777777777778,0.866220735785953,0.336107748184019
E02001364,Anfield West,Liverpool,North West,1255,3781,272,234,133,225,4645,1303,4371,277,254,122,226,5250,938,196,220,107,205,1666,0.21459620224205,0.707581227436823,0.866141732283465,0.877049180327869,0.907079646017699,0.317333333333333
E02001365,Anfield East,Liverpool,North West,2064,6336,325,291,244,306,7502,2232,7470,398,298,218,339,8723,1358,300,254,198,313,2423,0.181793842034806,0.753768844221106,0.852348993288591,0.908256880733945,0.92330383480826,0.27777140891895
E02001366,Tuebrook,Liverpool,North West,1652,5964,383,316,280,417,7360,1743,6751,436,360,243,361,8151,1539,353,323,220,336,2771,0.227966227225596,0.809633027522936,0.897222222222222,0.905349794238683,0.930747922437673,0.339958287326708
E02001367,Sandfield Park & Holly Lodge,Liverpool,North West,1652,5796,546,548,370,585,7845,1624,6189,586,580,390,582,8327,1847,501,547,370,556,3821,0.298432703183067,0.854948805460751,0.943103448275862,0.948717948717949,0.9553264604811,0.458868740242584
E02001368,Kirkdale South & Vauxhall,Liverpool,North West,1354,4332,396,339,214,343,5624,1457,5431,440,364,246,297,6778,1052,342,330,225,260,2209,0.193702817160744,0.777272727272727,0.906593406593407,0.914634146341463,0.875420875420875,0.325907347300089
E02001369,Everton West,Liverpool,North West,1249,5597,423,405,251,291,6967,1436,6361,466,440,255,305,7827,1314,362,387,227,269,2559,0.206571293821726,0.776824034334764,0.879545454545455,0.890196078431373,0.881967213114754,0.326945189727865
E02001370,Everton East,Liverpool,North West,1521,4465,339,334,241,294,5673,1610,5408,393,337,257,279,6674,1153,271,290,235,250,2199,0.213202662721894,0.689567430025445,0.86053412462908,0.914396887159533,0.896057347670251,0.329487563679952
E02001371,Knotty Ash,Liverpool,North West,1676,4561,302,229,178,277,5547,1734,5344,314,281,194,341,6474,1246,241,245,176,305,2213,0.233158682634731,0.767515923566879,0.871886120996441,0.907216494845361,0.894428152492669,0.341828853877047
E02001372,Dovecot,Liverpool,North West,924,3754,324,270,216,439,5003,1015,4109,379,338,209,439,5474,1241,314,313,193,407,2468,0.302019956193721,0.828496042216359,0.92603550295858,0.923444976076555,0.927107061503417,0.45085860431129
E02001373,Fairfield East,Liverpool,North West,1796,6075,413,367,230,306,7391,1763,6709,444,399,217,356,8125,1782,350,357,200,325,3014,0.265613355194515,0.788288288288288,0.894736842105263,0.921658986175115,0.912921348314607,0.370953846153846
E02001374,Fairfield West & Newsham Park,Liverpool,North West,1573,6997,328,292,180,200,7997,1698,8127,375,292,193,214,9201,1290,253,226,168,159,2096,0.158730158730159,0.674666666666667,0.773972602739726,0.870466321243523,0.742990654205608,0.227801325942832
E02001375,Stoneycroft,Liverpool,North West,1262,4173,369,338,231,376,5487,1290,4799,404,347,247,369,6166,1431,320,315,232,339,2637,0.298187122317149,0.792079207920792,0.907780979827089,0.939271255060729,0.91869918699187,0.427667855984431
E02001376,Kensington,Liverpool,North West,1858,6696,297,246,175,225,7639,1951,8365,340,265,175,229,9374,1230,233,214,153,199,2029,0.147041243275553,0.685294117647059,0.807547169811321,0.874285714285714,0.868995633187773,0.216449754640495
E02001377,Edge Hill,Liverpool,North West,1274,13853,265,271,181,229,14799,1497,16324,323,262,188,266,17363,1329,237,213,159,226,2164,0.0814138691497182,0.73374613003096,0.812977099236641,0.845744680851064,0.849624060150376,0.124632839947014
E02001378,Wavertree East,Liverpool,North West,1367,4995,372,371,228,409,6375,1339,5244,417,419,230,381,6691,1451,340,381,203,349,2724,0.276697177726926,0.815347721822542,0.909307875894988,0.882608695652174,0.916010498687664,0.407114033776715
E02001380,Broad Green,Liverpool,North West,1386,4614,415,494,263,477,6263,1406,5142,440,458,286,405,6731,1485,378,435,270,373,2941,0.28879813302217,0.859090909090909,0.949781659388646,0.944055944055944,0.920987654320988,0.436933590848314
E02001381,Wavertree West,Liverpool,North West,2069,6829,321,254,162,240,7806,2393,8071,354,298,188,209,9120,1356,266,259,164,180,2225,0.168008920827655,0.751412429378531,0.869127516778524,0.872340425531915,0.861244019138756,0.243969298245614
E02001382,Childwall East,Liverpool,North West,1247,4241,392,325,274,313,5545,1334,4774,418,383,275,376,6226,1331,369,357,252,361,2670,0.278801843317972,0.882775119617225,0.932114882506527,0.916363636363636,0.960106382978723,0.428846771602955
E02001383,"Chinatown, St James & Georgian Quarter",Liverpool,North West,974,8103,229,201,120,196,8849,951,8570,258,251,112,186,9377,1120,177,194,85,142,1718,0.130688448074679,0.686046511627907,0.772908366533865,0.758928571428571,0.763440860215054,0.183214247627173
E02001384,Wavertree South,Liverpool,North West,1249,9087,254,171,132,235,9879,1429,8603,257,200,124,185,9369,1425,184,161,101,162,2033,0.16563989306056,0.715953307392996,0.805,0.814516129032258,0.875675675675676,0.216992208346675
E02001385,Toxteth Park,Liverpool,North West,2923,6312,214,177,152,233,7088,3182,8054,262,187,150,244,8897,986,152,129,93,180,1540,0.122423640427117,0.580152671755725,0.689839572192513,0.62,0.737704918032787,0.17309205350118
E02001386,Belle Vale,Liverpool,North West,1411,4554,487,451,357,459,6308,1534,5563,479,535,361,432,7370,1477,362,482,333,397,3051,0.265504224339385,0.755741127348643,0.900934579439252,0.922437673130194,0.918981481481481,0.413975576662144
E02001387,Childwall West & Wavertree Green,Liverpool,North West,1377,4730,497,389,244,521,6381,1427,5321,535,492,298,471,7117,1551,483,466,279,444,3223,0.291486562676189,0.902803738317757,0.947154471544715,0.936241610738255,0.942675159235669,0.452859350850077
E02001388,Wavertree Penny Lane,Liverpool,North West,1358,6250,284,184,133,290,7141,1205,6424,295,250,169,277,7415,1432,245,229,151,259,2316,0.222914072229141,0.830508474576271,0.916,0.893491124260355,0.935018050541516,0.312339851652057
E02001389,Princes Park,Liverpool,North West,861,5283,272,187,114,175,6031,1010,5807,267,216,113,135,6538,1104,197,183,96,100,1680,0.190115377992079,0.737827715355805,0.847222222222222,0.849557522123894,0.740740740740741,0.256959314775161
E02001390,Toxteth,Liverpool,North West,2005,6196,397,348,211,380,7532,2153,7558,426,384,235,336,8939,1729,318,314,198,284,2843,0.228764223339508,0.746478873239437,0.817708333333333,0.842553191489362,0.845238095238095,0.318044523995973
E02001391,Netherley,Liverpool,North West,1215,3398,283,312,235,319,4547,1326,4226,299,313,232,294,5364,893,224,282,213,265,1877,0.21131093232371,0.749163879598662,0.900958466453674,0.918103448275862,0.901360544217687,0.349925428784489
E02001392,Gateacre,Liverpool,North West,999,3350,410,424,294,574,5052,1058,3725,420,436,332,559,5472,1138,349,415,310,535,2747,0.305503355704698,0.830952380952381,0.951834862385321,0.933734939759036,0.957066189624329,0.502010233918129
E02001393,Calderstones,Liverpool,North West,1218,4413,546,528,318,479,6284,1243,5073,552,587,382,515,7109,1408,491,558,360,482,3299,0.277547802089493,0.889492753623188,0.950596252129472,0.942408376963351,0.935922330097087,0.464059642706429
E02001394,Mossley Hill West & Sefton Park,Liverpool,North West,1083,7031,420,404,283,440,8578,1073,7132,434,424,307,447,8744,1564,349,371,275,410,2969,0.2192933258553,0.804147465437788,0.875,0.895765472312704,0.917225950782998,0.339547118023788
E02001395,Mossley Hill East,Liverpool,North West,1168,3703,336,315,227,347,4928,1165,4013,377,328,238,342,5298,1080,311,306,224,320,2241,0.269125342636432,0.824933687002653,0.932926829268293,0.941176470588235,0.935672514619883,0.422989807474519
E02001396,Dingle,Liverpool,North West,1176,5580,372,361,204,280,6797,1253,5890,376,371,234,244,7115,1392,288,323,204,206,2413,0.236332767402377,0.765957446808511,0.870619946091644,0.871794871794872,0.844262295081967,0.339142656359803
E02001397,Woolton,Liverpool,North West,1066,4348,552,466,318,608,6292,1079,4557,577,515,322,576,6547,1300,472,469,302,536,3079,0.285275400482774,0.818024263431543,0.910679611650485,0.937888198757764,0.930555555555556,0.470291736673286
E02001398,St Michael's & Otterspool,Liverpool,North West,1022,5311,380,339,253,416,6699,1081,5809,423,395,249,374,7250,1406,320,341,217,337,2621,0.24203821656051,0.756501182033097,0.863291139240506,0.8714859437751,0.901069518716578,0.36151724137931
E02001399,West Allerton,Liverpool,North West,1368,4217,435,361,289,423,5725,1322,4646,478,423,292,437,6276,1313,400,393,277,410,2793,0.282608695652174,0.836820083682008,0.929078014184397,0.948630136986301,0.938215102974828,0.445028680688337
E02001400,Allerton,Liverpool,North West,1220,4244,346,300,223,369,5482,1339,4847,417,348,247,344,6203,1351,329,316,230,322,2548,0.27872911079018,0.788968824940048,0.908045977011494,0.931174089068826,0.936046511627907,0.410768982750282
E02001401,Hunts Cross,Liverpool,North West,1313,4639,471,399,318,564,6391,1462,5215,475,471,315,583,7059,1315,410,444,297,535,3001,0.25215723873442,0.863157894736842,0.942675159235669,0.942857142857143,0.917667238421955,0.425131038390707
E02001402,Aigburth & Grassendale,Liverpool,North West,1682,5652,518,517,350,498,7535,1732,5887,587,522,374,481,7851,1491,476,488,351,458,3264,0.253269916765755,0.810902896081772,0.934865900383142,0.938502673796791,0.952182952182952,0.415743217424532
E02001403,Garston,Liverpool,North West,1397,4435,283,212,140,217,5287,1356,4652,277,248,153,198,5528,985,187,212,137,177,1698,0.211736887360275,0.675090252707581,0.854838709677419,0.895424836601307,0.893939393939394,0.307163531114327
E02001404,Speke West & Airport,Liverpool,North West,1705,4959,304,243,189,267,5962,1682,5595,357,258,197,227,6634,1111,244,221,176,206,1958,0.198570151921358,0.683473389355742,0.856589147286822,0.893401015228426,0.907488986784141,0.295146216460657
E02001405,Speke East,Liverpool,North West,2504,5921,448,330,207,278,7184,2506,7057,508,393,206,278,8442,1369,370,342,179,234,2494,0.193991781210146,0.728346456692913,0.870229007633588,0.868932038834952,0.841726618705036,0.295427623785833
E02006932,Central & Islington,Liverpool,North West,381,16926,93,53,27,35,17134,403,17212,97,77,48,39,17473,1204,74,63,39,33,1413,0.0699511968394144,0.762886597938144,0.818181818181818,0.8125,0.846153846153846,0.0808676243346878
E02006933,Albert Dock & Queen's Dock,Liverpool,North West,589,7415,214,142,78,101,7950,706,7058,245,205,111,94,7713,1337,186,169,94,83,1869,0.189430433550581,0.759183673469388,0.824390243902439,0.846846846846847,0.882978723404255,0.242318164138468
E02006934,Pier Head,Liverpool,North West,314,7841,86,63,35,42,8067,331,6040,98,87,32,32,6289,875,73,63,26,26,1063,0.144867549668874,0.744897959183674,0.724137931034483,0.8125,0.8125,0.16902528223883
E02001406,Rainford,St. Helens,North West,1120,4153,541,733,538,635,6600,1166,4489,537,695,585,682,6988,1281,498,664,572,654,3669,0.28536422365783,0.927374301675978,0.955395683453238,0.977777777777778,0.958944281524927,0.525042930738409
E02001407,Billinge,St. Helens,North West,800,3072,514,538,408,451,4983,750,3278,502,538,415,507,5240,936,466,519,403,473,2797,0.285539963392312,0.928286852589641,0.964684014869889,0.971084337349398,0.932938856015779,0.533778625954199
E02001408,Garswood,St. Helens,North West,830,3285,420,440,313,273,4731,826,3377,389,478,329,321,4894,813,349,451,313,297,2223,0.24074622445958,0.897172236503856,0.943514644351465,0.951367781155015,0.925233644859813,0.454229668982427
E02001409,Moss Bank,St. Helens,North West,1894,6089,654,683,378,493,8297,1807,6490,624,728,416,475,8733,1850,559,679,397,445,3930,0.285053929121726,0.895833333333333,0.932692307692308,0.954326923076923,0.936842105263158,0.4500171762281
E02001410,Haydock East,St. Helens,North West,1092,3522,325,363,243,311,4764,1092,3668,314,359,251,298,4890,909,281,334,241,269,2034,0.247818974918212,0.894904458598726,0.930362116991643,0.960159362549801,0.902684563758389,0.415950920245399
E02001411,Haydock West,St. Helens,North West,1012,3479,321,394,273,403,4870,947,3605,312,357,288,422,4984,929,282,330,280,409,2230,0.257697642163662,0.903846153846154,0.92436974789916,0.972222222222222,0.969194312796209,0.447431781701445
E02001412,Windle & Denton's Green,St. Helens,North West,1765,5530,543,438,334,461,7306,1673,5811,490,531,317,508,7657,1722,449,503,300,486,3460,0.296334537945276,0.916326530612245,0.947269303201507,0.946372239747634,0.956692913385827,0.451874102128771
E02001413,Blackbrook,St. Helens,North West,1533,5555,672,731,414,386,7758,1556,5964,658,772,464,413,8271,1642,605,733,446,390,3816,0.27531857813548,0.919452887537994,0.949481865284974,0.961206896551724,0.944309927360775,0.461371055495103
E02001414,Eccleston,St. Helens,North West,909,2991,349,408,297,516,4561,916,3185,341,414,294,517,4751,999,323,409,285,496,2512,0.313657770800628,0.947214076246334,0.98792270531401,0.969387755102041,0.959381044487427,0.528730793517154
E02001415,Earlestown North,St. Helens,North West,1544,4337,278,276,187,214,5292,1437,4607,294,295,233,239,5668,950,257,271,212,218,1908,0.206207944432385,0.874149659863946,0.91864406779661,0.909871244635193,0.912133891213389,0.336626676076217
E02001416,Broad Oak,St. Helens,North West,1459,4008,323,258,134,247,4970,1433,4243,329,304,148,233,5257,990,283,269,139,211,1892,0.233325477256658,0.860182370820669,0.884868421052632,0.939189189189189,0.905579399141631,0.359901084268594
E02001417,Town Centre West,St. Helens,North West,1263,5010,348,278,195,299,6130,1203,5315,367,282,217,301,6482,1267,314,264,197,270,2312,0.238381937911571,0.85558583106267,0.936170212765957,0.907834101382488,0.897009966777409,0.356680037025609
E02001418,Earlestown South,St. Helens,North West,1163,3887,252,243,192,278,4852,1254,4348,300,234,197,282,5361,890,256,206,182,251,1785,0.204691812327507,0.853333333333333,0.88034188034188,0.923857868020305,0.890070921985816,0.332960268606603
E02001419,Town Centre East & Fingerpost,St. Helens,North West,1422,4700,329,313,213,314,5869,1530,5399,342,289,212,289,6531,1214,290,258,197,268,2227,0.224856454899055,0.847953216374269,0.892733564013841,0.929245283018868,0.927335640138408,0.340989128770479
E02001420,Newton-le-Willows,St. Helens,North West,2347,7495,515,447,356,488,9301,2416,7739,528,476,354,524,9621,1676,453,444,319,488,3380,0.216565447732265,0.857954545454545,0.932773109243698,0.901129943502825,0.931297709923664,0.351314832138031
E02001421,West Park,St. Helens,North West,1796,6907,554,498,326,467,8752,1789,7219,581,497,401,458,9156,2102,535,465,382,422,3906,0.291176063166644,0.920826161790017,0.935613682092555,0.952618453865337,0.921397379912664,0.426605504587156
E02001422,Derbyshire Hill,St. Helens,North West,1681,4288,276,226,149,245,5184,1551,4524,316,225,154,229,5448,1082,277,209,145,210,1923,0.239168877099912,0.876582278481013,0.928888888888889,0.941558441558442,0.917030567685589,0.352973568281938
E02001423,Eccleston Park,St. Helens,North West,993,3942,405,420,298,436,5501,1018,4116,439,448,349,428,5780,1186,386,420,327,398,2717,0.288143828960156,0.879271070615034,0.9375,0.936962750716332,0.929906542056075,0.470069204152249
E02001424,Thatto Heath & Lea Green,St. Helens,North West,3185,9057,638,674,492,619,11480,3147,9888,625,734,486,699,12432,2710,549,678,455,648,5040,0.274069579288026,0.8784,0.923705722070845,0.936213991769547,0.927038626609442,0.405405405405405
E02001425,Sutton Leach,St. Helens,North West,1647,6330,704,628,439,501,8602,1741,6962,714,686,477,560,9399,1806,634,650,455,529,4074,0.259408216029876,0.887955182072829,0.947521865889213,0.953878406708595,0.944642857142857,0.433450367060326
E02001426,Rainhill North,St. Helens,North West,859,3140,311,357,332,443,4583,894,3428,297,342,296,473,4836,995,268,315,286,451,2315,0.290256709451575,0.902356902356902,0.921052631578947,0.966216216216216,0.953488372093023,0.478701406120761
E02001427,Bold & Clock Face,St. Helens,North West,2066,6422,535,605,352,379,8293,2179,7169,529,590,389,369,9046,1696,462,561,360,343,3422,0.236574138652532,0.873345935727788,0.950847457627119,0.925449871465296,0.929539295392954,0.378288746407252
E02001428,Rainhill South,St. Helens,North West,825,2978,355,408,397,563,4701,823,3395,341,403,403,565,5107,984,301,377,391,535,2588,0.289837997054492,0.882697947214076,0.935483870967742,0.970223325062035,0.946902654867257,0.506755433718426
E02001429,Crossens,Sefton,North West,1034,3573,517,561,403,621,5675,1034,3888,498,577,413,614,5990,1079,416,538,399,588,3020,0.277520576131687,0.835341365461847,0.932409012131716,0.966101694915254,0.957654723127036,0.504173622704508
E02001430,Marshside,Sefton,North West,1063,3878,514,496,369,643,5900,1031,4293,492,542,402,640,6369,1143,414,522,386,622,3087,0.266247379454927,0.841463414634146,0.96309963099631,0.960199004975124,0.971875,0.48469147432878
E02001431,Hesketh Park,Sefton,North West,775,3540,652,706,596,1220,6714,824,3849,609,716,607,1115,6896,1061,504,680,579,1049,3873,0.275656014549234,0.827586206896552,0.949720670391061,0.953871499176277,0.940807174887892,0.561629930394432
E02001432,Southport Waterfront,Sefton,North West,1156,5575,515,557,377,864,7888,1122,6394,562,526,414,758,8654,1167,376,451,364,688,3046,0.182514857679074,0.669039145907473,0.857414448669202,0.879227053140097,0.907651715039578,0.351975964871736
E02001433,Southport High Park,Sefton,North West,1697,4797,375,318,283,309,6082,1648,5005,357,333,223,301,6219,1248,266,301,205,286,2306,0.249350649350649,0.745098039215686,0.903903903903904,0.919282511210762,0.950166112956811,0.370799163852709
E02001434,Meols Cop,Sefton,North West,1532,4684,415,356,205,261,5921,1480,4963,393,338,241,243,6178,1267,306,308,218,227,2326,0.255289139633286,0.778625954198473,0.911242603550296,0.904564315352697,0.934156378600823,0.376497248300421
E02001435,Southport South,Sefton,North West,1798,5385,411,374,251,368,6789,1553,5748,425,408,249,352,7182,1250,306,358,224,324,2462,0.217466945024356,0.72,0.877450980392157,0.899598393574297,0.920454545454545,0.342801448064606
E02001436,Southport Kew,Sefton,North West,1788,5484,488,435,299,504,7210,1752,6119,541,507,340,486,7993,1563,451,472,319,456,3261,0.255433894427194,0.833641404805915,0.930966469428008,0.938235294117647,0.938271604938272,0.407981984236207
E02001437,Birkdale,Sefton,North West,1158,4901,719,838,636,1352,8446,1090,5117,699,843,668,1315,8642,1447,593,778,629,1248,4695,0.282782880594098,0.848354792560801,0.922894424673784,0.941616766467066,0.949049429657795,0.543277019208517
E02001438,Hillside,Sefton,North West,1383,4400,445,405,297,386,5933,1255,4657,452,405,300,358,6172,1315,396,373,285,335,2704,0.282370624865793,0.876106194690266,0.920987654320988,0.95,0.935754189944134,0.438107582631238
E02001439,Ainsdale East,Sefton,North West,1228,3851,401,416,304,446,5418,1209,4191,418,398,300,449,5756,1230,359,365,282,430,2666,0.293486041517538,0.858851674641148,0.917085427135678,0.94,0.957683741648107,0.463168867268937
E02001440,Ainsdale West,Sefton,North West,696,2861,502,632,552,659,5206,666,3206,513,616,549,686,5570,983,468,595,527,666,3239,0.306612601372427,0.912280701754386,0.965909090909091,0.959927140255009,0.970845481049563,0.581508078994614
E02001441,Formby West & Freshfield North,Sefton,North West,974,3209,513,599,509,622,5452,963,3643,489,575,513,667,5887,1015,438,549,505,636,3143,0.278616524842163,0.895705521472393,0.954782608695652,0.984405458089669,0.95352323838081,0.533888228299643
E02001442,Formby Central & Freshfield South,Sefton,North West,925,3142,427,495,427,772,5263,881,3376,388,489,434,720,5407,916,350,459,413,701,2839,0.27132701421801,0.902061855670103,0.938650306748466,0.951612903225806,0.973611111111111,0.525060107268356
E02001443,Formby South West,Sefton,North West,883,2900,386,421,366,562,4635,887,3281,378,431,362,586,5038,909,344,416,346,559,2574,0.277049679975617,0.91005291005291,0.965197215777262,0.955801104972376,0.953924914675768,0.510917030567686
E02001444,Formby South East & Ince Blundell,Sefton,North West,952,3104,356,376,322,452,4610,906,3473,358,372,341,491,5035,916,315,353,326,471,2381,0.263748920241866,0.879888268156425,0.948924731182796,0.956011730205279,0.959266802443992,0.472889771598808
E02001445,Maghull North West & Lydiate,Sefton,North West,1029,3711,510,453,376,659,5709,1046,4143,495,507,385,605,6135,1068,457,469,358,570,2922,0.257784214337437,0.923232323232323,0.925049309664694,0.92987012987013,0.942148760330578,0.476283618581907
E02001446,Maghull North East,Sefton,North West,1023,3883,436,459,410,565,5753,1124,4198,408,460,384,603,6053,1141,384,434,355,570,2884,0.271796093377799,0.941176470588235,0.943478260869565,0.924479166666667,0.945273631840796,0.47645795473319
E02001447,Maghull South East,Sefton,North West,838,3077,410,430,324,649,4890,868,3452,405,412,349,599,5217,907,363,380,329,556,2535,0.262746234067207,0.896296296296296,0.922330097087379,0.94269340974212,0.928213689482471,0.485911443358252
E02001448,Maghull South West,Sefton,North West,1119,3896,443,405,313,510,5567,1086,4199,454,413,307,552,5925,1077,420,388,286,520,2691,0.256489640390569,0.92511013215859,0.939467312348668,0.931596091205212,0.942028985507246,0.454177215189873
E02001449,Hightown & Thornton,Sefton,North West,1437,5223,742,601,430,602,7598,1537,5884,734,610,478,603,8309,1413,667,567,437,572,3656,0.240142760027192,0.908719346049046,0.929508196721311,0.914225941422594,0.948590381426202,0.440004814057047
E02001450,Blundellsands,Sefton,North West,1254,4655,603,613,457,674,7002,1296,5057,621,653,450,701,7482,1214,559,612,411,663,3459,0.24006327862369,0.900161030595813,0.937212863705972,0.913333333333333,0.945791726105563,0.462309542902967
E02001451,Netherton North,Sefton,North West,1238,3578,296,306,194,431,4805,1202,3957,308,326,198,393,5182,828,256,288,186,366,1924,0.209249431387415,0.831168831168831,0.883435582822086,0.939393939393939,0.931297709923664,0.371285218062524
E02001452,Ford,Sefton,North West,1370,4177,287,271,182,384,5301,1157,4285,327,299,186,331,5428,908,273,266,175,306,1928,0.211901983663944,0.834862385321101,0.889632107023411,0.940860215053764,0.924471299093656,0.355195283714075
E02001453,Crosby East,Sefton,North West,1543,5312,566,478,374,556,7286,1504,5601,600,510,398,549,7658,1311,554,477,376,507,3225,0.234065345474023,0.923333333333333,0.935294117647059,0.944723618090452,0.923497267759563,0.421128231914338
E02001454,Aintree East & Waddicar,Sefton,North West,1152,4214,407,360,290,551,5822,1211,4626,432,398,298,522,6276,1244,390,367,281,494,2776,0.268914829226113,0.902777777777778,0.922110552763819,0.942953020134228,0.946360153256705,0.44231994901211
E02001455,Aintree West & Old Roan,Sefton,North West,1126,4527,375,370,271,445,5988,1124,4756,423,372,251,442,6244,1184,372,346,237,419,2558,0.248948696383516,0.879432624113475,0.93010752688172,0.944223107569721,0.947963800904977,0.409673286354901
E02001456,Brighton le Sands & Crosby West,Sefton,North West,1269,4594,468,424,292,453,6231,1252,4776,521,392,302,453,6444,1083,450,353,271,415,2572,0.226758793969849,0.863723608445298,0.900510204081633,0.897350993377484,0.916114790286976,0.399130974549969
E02001457,Netherton South,Sefton,North West,1410,4396,351,256,171,306,5480,1388,4639,363,258,158,292,5710,949,317,237,146,262,1911,0.204569950420349,0.873278236914601,0.918604651162791,0.924050632911392,0.897260273972603,0.334676007005254
E02001458,Waterloo,Sefton,North West,1380,5098,415,329,227,272,6341,1361,5446,415,365,209,302,6737,1180,359,328,198,274,2339,0.216672787366875,0.865060240963856,0.898630136986301,0.947368421052632,0.907284768211921,0.347187175300579
E02001459,Litherland North,Sefton,North West,1572,4431,357,286,221,317,5612,1463,4830,396,308,208,304,6046,1031,357,282,195,285,2150,0.213457556935818,0.901515151515152,0.915584415584416,0.9375,0.9375,0.355607012901092
E02001460,Seaforth North,Sefton,North West,1186,4843,418,382,293,449,6385,1169,5050,439,402,295,442,6628,1066,366,355,263,410,2460,0.211089108910891,0.83371298405467,0.883084577114428,0.891525423728814,0.927601809954751,0.371152685576343
E02001461,Litherland South,Sefton,North West,1223,4029,368,378,261,334,5370,1256,4578,378,376,259,310,5901,1048,341,346,239,289,2263,0.228920926168633,0.902116402116402,0.920212765957447,0.922779922779923,0.932258064516129,0.383494322996102
E02001462,Seaforth South,Sefton,North West,1759,5110,347,295,207,182,6141,1706,5426,351,304,189,205,6475,1058,297,256,168,186,1965,0.19498709915223,0.846153846153846,0.842105263157895,0.888888888888889,0.907317073170732,0.303474903474903
E02001463,Orrell,Sefton,North West,1526,4375,292,323,219,320,5529,1606,5160,320,306,207,307,6300,1114,271,281,190,292,2148,0.215891472868217,0.846875,0.918300653594771,0.917874396135266,0.95114006514658,0.340952380952381
E02001464,Bootle North,Sefton,North West,1557,4517,301,266,192,191,5467,1573,5077,311,286,196,217,6087,847,262,263,178,188,1738,0.166830805593855,0.842443729903537,0.91958041958042,0.908163265306122,0.866359447004608,0.285526531953343
E02001465,Bootle South,Sefton,North West,1419,4683,397,307,212,249,5848,1364,5291,399,339,194,248,6471,961,322,277,176,213,1949,0.181629181629182,0.807017543859649,0.817109144542773,0.907216494845361,0.858870967741936,0.301189924277546
E02001466,Bootle East,Sefton,North West,1793,5406,414,419,263,376,6878,1820,6197,482,388,292,370,7729,1093,406,342,274,337,2452,0.176375665644667,0.842323651452282,0.881443298969072,0.938356164383562,0.910810810810811,0.317246733083193
E02001467,New Brighton,Wirral,North West,1184,4877,519,493,361,511,6761,1088,4894,551,469,394,522,6830,1305,452,429,373,484,3043,0.26665304454434,0.82032667876588,0.914712153518124,0.946700507614213,0.9272030651341,0.445534407027818
E02001468,Wallasey East,Wirral,North West,1336,4909,396,348,258,372,6283,1348,5278,452,382,272,417,6801,1380,369,340,264,382,2735,0.261462675255779,0.816371681415929,0.890052356020943,0.970588235294118,0.916067146282974,0.402146743126011
E02001469,Wallasey Village,Wirral,North West,1253,4597,499,505,338,573,6512,1207,4830,571,492,368,556,6817,1372,520,467,359,528,3246,0.284057971014493,0.910683012259194,0.949186991869919,0.97554347826087,0.949640287769784,0.476162534839372
E02001470,Wallasey Central,Wirral,North West,1493,5078,564,450,333,475,6900,1521,5541,577,483,365,444,7410,1578,524,459,349,430,3340,0.284786139685977,0.908145580589255,0.950310559006211,0.956164383561644,0.968468468468468,0.450742240215924
E02001471,Egremont,Wirral,North West,1735,4812,397,332,212,338,6091,1638,5178,370,371,219,312,6450,1196,293,337,198,278,2302,0.230977211278486,0.791891891891892,0.908355795148248,0.904109589041096,0.891025641025641,0.356899224806202
E02001472,Leasowe,Wirral,North West,1405,4366,373,313,208,346,5606,1408,4772,401,363,208,321,6065,1276,347,333,195,307,2458,0.267393126571668,0.865336658354115,0.917355371900826,0.9375,0.956386292834891,0.405276174773289
E02001473,Liscard,Wirral,North West,1499,4845,445,411,320,409,6430,1355,5025,442,423,306,414,6610,1265,370,389,280,384,2688,0.251741293532338,0.83710407239819,0.919621749408983,0.915032679738562,0.927536231884058,0.406656580937973
E02001474,Seacombe,Wirral,North West,1801,4597,283,284,175,204,5543,1858,5023,306,261,182,232,6004,1116,247,231,159,206,1959,0.222177981286084,0.80718954248366,0.885057471264368,0.873626373626374,0.887931034482759,0.326282478347768
E02001475,Leasowe South & Moreton East,Wirral,North West,1504,3775,313,326,203,301,4918,1539,4168,307,322,208,291,5296,973,240,289,195,267,1964,0.233445297504799,0.781758957654723,0.897515527950311,0.9375,0.917525773195876,0.370845921450151
E02001476,Poulton,Wirral,North West,1914,5055,293,285,185,239,6057,1899,5592,325,306,182,252,6657,1309,270,286,175,230,2270,0.234084406294707,0.830769230769231,0.934640522875817,0.961538461538461,0.912698412698413,0.340994441940814
E02001477,Bidston Hill,Wirral,North West,1985,4753,348,256,156,183,5696,2066,5378,328,256,170,222,6354,1222,294,222,153,199,2090,0.227222015619189,0.896341463414634,0.8671875,0.9,0.896396396396396,0.32892666037142
E02001478,Moreton West,Wirral,North West,1451,4620,590,537,330,472,6549,1462,5095,558,628,360,545,7186,1220,461,588,340,511,3120,0.239450441609421,0.826164874551971,0.936305732484076,0.944444444444444,0.937614678899082,0.434177567492346
E02001479,Great Meols,Wirral,North West,1052,3735,427,406,264,305,5137,1013,3953,476,423,262,344,5458,950,423,406,251,333,2363,0.240323804705287,0.888655462184874,0.959810874704492,0.958015267175572,0.968023255813953,0.432942469769146
E02001480,Hoylake,Wirral,North West,1289,4485,512,442,352,711,6502,1217,4824,494,513,352,746,6929,1222,436,477,330,694,3159,0.253316749585406,0.882591093117409,0.929824561403509,0.9375,0.93029490616622,0.455909943714822
E02001481,Claughton North,Wirral,North West,1325,4984,466,480,387,463,6780,1379,5482,506,504,377,466,7335,1549,457,461,355,428,3250,0.282561109084276,0.903162055335968,0.91468253968254,0.941644562334218,0.918454935622318,0.443081117927744
E02001482,Birkenhead Central,Wirral,North West,1542,5528,372,267,209,275,6651,1493,6141,418,314,205,262,7340,1496,336,289,179,233,2533,0.243608532812246,0.803827751196172,0.920382165605096,0.873170731707317,0.889312977099237,0.345095367847411
E02001483,Saughall Massie,Wirral,North West,1180,4253,602,548,305,432,6140,1117,4464,566,529,353,418,6330,1142,489,506,341,398,2876,0.255824372759857,0.863957597173145,0.956521739130435,0.96600566572238,0.952153110047847,0.45434439178515
E02001484,Upton West,Wirral,North West,1397,4496,518,544,377,679,6614,1403,4830,538,566,383,600,6917,1273,481,527,367,577,3225,0.263561076604555,0.894052044609665,0.931095406360424,0.95822454308094,0.961666666666667,0.46624259071852
E02001485,Noctorum North & Upton East,Wirral,North West,1569,4173,325,299,207,340,5344,1640,4584,316,323,207,313,5743,1170,285,294,191,290,2230,0.255235602094241,0.901898734177215,0.910216718266254,0.922705314009662,0.926517571884984,0.38829879853735
E02001486,Claughton South & Oxton North,Wirral,North West,923,4919,598,604,438,672,7231,888,4793,597,617,414,722,7143,1285,520,562,383,676,3426,0.268099311495932,0.871021775544389,0.910858995137763,0.92512077294686,0.936288088642659,0.479630407391852
E02001487,Birkenhead South,Wirral,North West,2433,6256,356,296,199,194,7301,2337,6625,405,309,234,197,7770,1457,332,282,211,182,2464,0.219924528301887,0.819753086419753,0.912621359223301,0.901709401709402,0.923857868020305,0.317117117117117
E02001488,Oxton South,Wirral,North West,1658,5346,387,369,299,363,6764,1552,5599,395,393,273,358,7018,1373,332,367,254,339,2665,0.245222361135917,0.840506329113924,0.933842239185751,0.93040293040293,0.946927374301676,0.379737817041892
E02001489,Greasby,Wirral,North West,1168,4406,707,691,433,680,6917,1184,4587,648,733,486,703,7157,1066,595,701,470,679,3511,0.23239590146065,0.91820987654321,0.956343792633015,0.967078189300411,0.965860597439545,0.49056867402543
E02001490,Noctorum South,Wirral,North West,1528,4916,478,544,375,392,6705,1485,5398,490,592,404,428,7312,1401,448,569,388,407,3213,0.259540570581697,0.914285714285714,0.961148648648649,0.96039603960396,0.950934579439252,0.43941466083151
E02001491,Woodchurch,Wirral,North West,1488,4097,386,361,187,351,5382,1484,4518,395,368,198,305,5784,1207,321,320,178,288,2314,0.267153607791058,0.812658227848101,0.869565217391304,0.898989898989899,0.944262295081967,0.400069156293223
E02001492,West Kirby,Wirral,North West,1331,4388,506,520,410,677,6501,1274,4592,491,538,386,689,6696,1187,435,504,365,652,3143,0.258493031358885,0.885947046843177,0.936802973977695,0.94559585492228,0.946298984034833,0.469384707287933
E02001493,Tranmere,Wirral,North West,1794,5266,378,340,206,291,6481,1942,6085,404,335,225,286,7335,1344,318,304,199,255,2420,0.220870994248151,0.787128712871287,0.907462686567164,0.884444444444445,0.891608391608392,0.329925017041581
E02001494,Caldy & Newton,Wirral,North West,1183,3731,573,587,394,575,5860,1193,4115,550,618,426,570,6279,1095,508,586,408,538,3135,0.266099635479951,0.923636363636364,0.948220064724919,0.957746478873239,0.943859649122807,0.499283325370282
E02001495,Egerton Park,Wirral,North West,1583,4904,448,353,300,398,6403,1511,5204,441,388,280,409,6722,1292,385,359,263,374,2673,0.248270561106841,0.873015873015873,0.925257731958763,0.939285714285714,0.914425427872861,0.39764950907468
E02001496,Prenton,Wirral,North West,1107,3694,391,355,294,424,5158,1047,3771,379,371,289,394,5204,1019,353,344,280,372,2368,0.270220100769027,0.931398416886544,0.92722371967655,0.968858131487889,0.944162436548223,0.455034588777863
E02001497,Bebington New Ferry,Wirral,North West,1748,5124,389,377,254,296,6440,1753,5542,412,397,240,359,6950,1138,354,358,220,317,2387,0.205341032118369,0.859223300970874,0.90176322418136,0.916666666666667,0.883008356545961,0.343453237410072
E02001498,Woodhey,Wirral,North West,1465,4521,401,396,281,419,6018,1364,4744,407,409,301,387,6248,1276,360,398,290,375,2699,0.268971332209106,0.884520884520885,0.973105134474328,0.963455149501661,0.968992248062015,0.431978233034571
E02001499,Thursaston & Irby,Wirral,North West,1037,3558,491,513,380,642,5584,1041,3848,501,548,376,619,5892,1135,461,520,360,603,3079,0.29495841995842,0.920159680638723,0.948905109489051,0.957446808510638,0.974151857835218,0.522572980312288
E02001500,Pensby & Thingwall,Wirral,North West,1268,4230,544,536,414,544,6268,1196,4507,496,558,404,602,6567,1336,454,537,389,587,3303,0.296427779010428,0.915322580645161,0.96236559139785,0.962871287128713,0.975083056478405,0.502969392416629
E02001501,Higher Bebington,Wirral,North West,1509,4811,433,498,327,425,6494,1348,5024,433,489,358,453,6757,1328,397,467,336,438,2966,0.264331210191083,0.916859122401848,0.955010224948875,0.93854748603352,0.966887417218543,0.438952197720882
E02001502,Lower Bebington & Bromborough Pool,Wirral,North West,1826,5839,519,499,397,564,7818,1778,6132,509,490,385,558,8074,1410,460,458,362,527,3217,0.229941291585127,0.903732809430255,0.93469387755102,0.94025974025974,0.944444444444444,0.398439435224176
E02001503,Heswall,Wirral,North West,1161,4038,528,549,456,719,6290,1137,4254,516,555,472,735,6532,1236,482,536,452,700,3406,0.290550070521862,0.934108527131783,0.965765765765766,0.957627118644068,0.952380952380952,0.521432945499082
E02001504,"Poulton, Raby Mere & Thornton Hough",Wirral,North West,1015,3734,554,672,498,743,6201,1020,3936,547,662,518,723,6386,1049,512,648,501,696,3406,0.266514227642276,0.936014625228519,0.978851963746223,0.967181467181467,0.962655601659751,0.533354212339493
E02001505,Bromborough North,Wirral,North West,1111,3796,345,375,312,406,5234,1114,4107,374,364,292,437,5574,1037,349,336,272,414,2408,0.252495738982226,0.933155080213904,0.923076923076923,0.931506849315068,0.947368421052632,0.432005740940079
E02001506,Gayton & Lower Heswall,Wirral,North West,1320,4431,711,776,578,949,7445,1305,4921,669,787,587,948,7912,1433,633,764,568,923,4321,0.291200975411502,0.946188340807175,0.970775095298602,0.96763202725724,0.973628691983122,0.5461324570273
E02001507,Bromborough South,Wirral,North West,1174,3907,456,621,423,558,5965,1143,4098,485,569,449,601,6202,1065,457,535,432,570,3059,0.259882869692533,0.942268041237113,0.9402460456942,0.962138084632517,0.948419301164726,0.493227990970655
E02001508,Eastham,Wirral,North West,1604,4950,485,414,319,521,6689,1602,5276,447,440,311,477,6951,1328,382,413,289,440,2852,0.251705837755876,0.854586129753915,0.938636363636364,0.929260450160772,0.922431865828092,0.410300676161703
E02003314,Hoo Peninsula,Medway,South East,1071,3693,482,474,320,335,5304,1107,4058,508,502,335,374,5777,1057,450,463,307,338,2615,0.260473139477575,0.885826771653543,0.922310756972112,0.916417910447761,0.903743315508021,0.452657088454215
E02003315,Cliffe,Medway,South East,1065,3363,357,377,200,231,4528,1038,3669,333,422,230,236,4890,897,322,395,217,223,2054,0.244480784955029,0.966966966966967,0.936018957345972,0.943478260869565,0.944915254237288,0.420040899795501
E02003316,Hoo St Werburgh & High Halstow,Medway,South East,2379,6654,547,579,404,410,8594,2578,7446,569,622,447,446,9530,1816,502,585,421,423,3747,0.24388933655654,0.882249560632689,0.940514469453376,0.941834451901566,0.948430493273543,0.393179433368311
E02003317,Wainscott & City Estate,Medway,South East,1386,4199,311,324,238,373,5445,1464,4472,329,347,256,368,5772,1075,299,313,244,351,2282,0.240384615384615,0.908814589665653,0.902017291066282,0.953125,0.953804347826087,0.395356895356895
E02003318,Broomhill,Medway,South East,1042,3637,359,351,266,319,4932,1012,3781,368,369,252,350,5120,728,330,353,246,327,1984,0.192541655646654,0.896739130434783,0.956639566395664,0.976190476190476,0.934285714285714,0.3875
E02003319,Strood North & Frindsbury,Medway,South East,1878,5519,317,300,167,275,6578,1861,5690,333,266,190,267,6746,941,268,240,171,239,1859,0.165377855887522,0.804804804804805,0.902255639097744,0.9,0.895131086142322,0.27557070856804
E02003320,Chatham Maritime,Medway,South East,1834,6556,308,223,153,168,7408,1915,6550,335,290,201,202,7578,877,240,253,177,179,1726,0.133893129770992,0.716417910447761,0.872413793103448,0.880597014925373,0.886138613861386,0.227764581683822
E02003321,Rede Common,Medway,South East,1524,3971,286,306,209,273,5045,1504,4288,292,307,222,286,5395,752,244,278,204,272,1750,0.175373134328358,0.835616438356164,0.905537459283387,0.918918918918919,0.951048951048951,0.324374420759963
E02003322,Gillingham North,Medway,South East,1613,6000,210,174,120,188,6692,1504,5717,238,187,122,180,6444,676,154,159,104,155,1248,0.118243834178765,0.647058823529412,0.850267379679144,0.852459016393443,0.861111111111111,0.19366852886406
E02003323,Gillingham North East,Medway,South East,1920,4922,263,218,145,225,5773,1856,5090,295,230,162,223,6000,762,193,202,147,201,1505,0.149705304518664,0.654237288135593,0.878260869565217,0.907407407407407,0.901345291479821,0.250833333333333
E02003324,Strood South & Temple Marsh,Medway,South East,2414,6305,344,358,189,252,7448,2484,6769,387,360,204,252,7972,1103,304,316,187,232,2142,0.162948736888758,0.785529715762274,0.877777777777778,0.916666666666667,0.920634920634921,0.268690416457602
E02003325,Gillingham Central,Medway,South East,1854,5214,246,173,136,151,5920,1881,5628,270,190,142,154,6384,791,142,135,116,135,1319,0.140547263681592,0.525925925925926,0.710526315789474,0.816901408450704,0.876623376623377,0.206610275689223
E02003326,Gillingham East,Medway,South East,1815,5143,305,329,195,234,6206,1687,5422,317,327,217,241,6524,814,215,266,192,217,1704,0.150129103651789,0.678233438485805,0.813455657492355,0.884792626728111,0.900414937759336,0.261189454322502
E02003327,Rochester West,Medway,South East,1405,5053,264,339,194,280,6130,1310,5026,312,330,240,302,6210,791,254,288,222,281,1836,0.157381615598886,0.814102564102564,0.872727272727273,0.925,0.93046357615894,0.295652173913044
E02003328,Chatham Central and Rochester Riverside,Medway,South East,2060,6932,285,202,165,183,7767,2236,7239,323,229,167,225,8183,872,195,186,148,194,1595,0.120458626882166,0.603715170278638,0.812227074235808,0.88622754491018,0.862222222222222,0.194916289869241
E02003329,Gillingham South,Medway,South East,1775,4642,244,200,120,158,5364,1763,5030,240,239,134,150,5793,894,131,176,122,122,1445,0.177733598409543,0.545833333333333,0.736401673640167,0.91044776119403,0.813333333333333,0.24943897807699
E02003330,Rochester East,Medway,South East,1519,4330,275,268,156,198,5227,1521,4632,307,248,178,216,5581,809,244,219,156,195,1623,0.174654576856649,0.794788273615635,0.883064516129032,0.876404494382023,0.902777777777778,0.290808098907006
E02003331,Twydall,Medway,South East,1836,5351,472,430,313,453,7019,1771,5771,513,443,338,468,7533,1083,355,405,314,433,2590,0.187662450181944,0.692007797270955,0.914221218961625,0.928994082840237,0.925213675213675,0.343820523031993
E02003332,Gillingham South East,Medway,South East,1266,3903,300,300,187,344,5034,1224,4121,346,342,216,367,5392,679,225,293,199,322,1718,0.16476583353555,0.650289017341041,0.85672514619883,0.921296296296296,0.877384196185286,0.318620178041543
E02003333,Luton,Medway,South East,1804,4960,212,176,123,182,5653,2023,5086,223,189,126,186,5810,556,138,154,112,171,1131,0.109319701140385,0.618834080717489,0.814814814814815,0.888888888888889,0.919354838709677,0.194664371772806
E02003334,Chatham South West,Medway,South East,1391,4021,209,195,147,216,4788,1439,4425,228,207,157,222,5239,651,169,175,137,195,1327,0.147118644067797,0.741228070175439,0.845410628019324,0.872611464968153,0.878378378378378,0.253292613094102
E02003335,Chatham South East,Medway,South East,2162,4861,174,169,91,135,5430,2333,5165,194,172,120,117,5768,646,120,152,102,102,1122,0.125072604065828,0.618556701030928,0.883720930232558,0.85,0.871794871794872,0.194521497919556
E02003336,Rainham North West,Medway,South East,1074,3479,387,354,321,461,5002,1143,3831,407,407,313,470,5428,764,299,379,305,451,2198,0.199425737405377,0.734643734643735,0.931203931203931,0.97444089456869,0.959574468085106,0.404937361827561
E02003337,Rochester South West,Medway,South East,1323,4715,316,291,220,366,5908,1435,5353,328,323,215,367,6586,904,273,293,201,335,2006,0.168877265084999,0.832317073170732,0.907120743034056,0.934883720930232,0.912806539509537,0.304585484360765
E02003338,Rainham North East,Medway,South East,1452,4431,366,389,248,312,5746,1430,4613,381,402,287,325,6008,845,244,369,271,307,2036,0.183177975287232,0.640419947506562,0.917910447761194,0.944250871080139,0.944615384615385,0.338881491344874
E02003339,Rochester South East,Medway,South East,1253,3891,325,358,243,421,5238,1202,4149,332,331,277,407,5496,771,290,300,261,367,1989,0.185827910339841,0.873493975903615,0.906344410876133,0.942238267148014,0.901719901719902,0.361899563318777
E02003340,Wayfield,Medway,South East,1738,4931,390,325,245,374,6265,1716,5198,402,375,249,381,6605,875,343,344,232,348,2142,0.168333974605618,0.853233830845771,0.917333333333333,0.931726907630522,0.913385826771654,0.324299772899319
E02003341,Cuxton & Halling,Medway,South East,1266,4056,342,388,286,258,5330,1316,4342,348,404,271,296,5661,771,306,383,257,281,1998,0.177567941040995,0.879310344827586,0.948019801980198,0.948339483394834,0.949324324324324,0.352941176470588
E02003342,Rainham South East,Medway,South East,1218,3634,392,436,272,401,5135,1151,3864,366,435,315,400,5380,752,238,418,306,386,2100,0.194616977225673,0.650273224043716,0.960919540229885,0.971428571428571,0.965,0.390334572490706
E02003343,Rainham South West,Medway,South East,910,3363,406,493,347,395,5004,924,3632,412,509,368,451,5372,730,301,473,354,425,2283,0.200991189427313,0.730582524271845,0.929273084479371,0.96195652173913,0.942350332594235,0.424981384959047
E02003344,Capstone,Medway,South East,1503,4510,411,297,184,213,5615,1396,4514,387,359,191,216,5667,725,327,332,175,202,1761,0.160611431103234,0.844961240310077,0.924791086350975,0.916230366492147,0.935185185185185,0.310746426680784
E02003345,Parkwood East,Medway,South East,1287,3734,362,328,163,178,4765,1328,3968,341,353,193,191,5046,763,242,331,183,183,1702,0.192288306451613,0.709677419354839,0.937677053824363,0.948186528497409,0.958115183246073,0.337296868806976
E02003346,Horsted,Medway,South East,1377,4074,383,436,277,403,5573,1318,4281,381,431,305,420,5818,789,326,403,286,390,2194,0.184302733006307,0.855643044619423,0.935034802784223,0.937704918032787,0.928571428571429,0.377105534547955
E02003347,Settington,Medway,South East,1353,4116,224,220,99,114,4773,1325,4109,240,228,134,149,4860,734,201,210,125,134,1404,0.178632270625456,0.8375,0.921052631578947,0.932835820895522,0.899328859060403,0.288888888888889
E02003348,Hempstead & Wigmore,Medway,South East,1274,4399,528,631,382,567,6507,1313,4808,585,630,422,578,7023,1032,469,595,400,551,3047,0.214642262895175,0.801709401709402,0.944444444444444,0.947867298578199,0.953287197231834,0.433860173714937
E02003349,Parkwood West,Medway,South East,1452,4158,409,541,314,414,5836,1386,4434,425,530,383,440,6212,916,283,499,366,415,2479,0.20658547586829,0.665882352941177,0.941509433962264,0.955613577023499,0.943181818181818,0.399066323245332
E02003350,Walderslade,Medway,South East,1291,3784,322,343,218,317,4984,1340,4205,343,369,254,347,5518,771,286,339,241,320,1957,0.183353151010702,0.833819241982507,0.91869918699187,0.948818897637795,0.922190201729107,0.354657484595868
E02003351,Lordswood,Medway,South East,1645,4764,386,462,280,269,6161,1642,4958,412,446,336,288,6440,797,342,418,315,266,2138,0.160750302541347,0.830097087378641,0.937219730941704,0.9375,0.923611111111111,0.331987577639752
E02003352,Winkfield & Cranbourne,Bracknell Forest,South East,967,3443,350,425,302,374,4894,929,3579,357,426,351,452,5165,511,320,379,334,425,1969,0.142777312098352,0.896358543417367,0.889671361502347,0.951566951566952,0.940265486725664,0.381219748305905
E02003353,Binfield & Popeswood,Bracknell Forest,South East,1965,6849,468,382,250,392,8341,2310,7973,567,453,318,399,9710,1110,485,413,296,375,2679,0.139219867051298,0.855379188712522,0.911699779249448,0.930817610062893,0.93984962406015,0.275901132852729
E02003354,Wick Hill,Bracknell Forest,South East,1974,6626,440,354,207,361,7988,1978,7208,443,387,256,386,8680,971,393,355,239,361,2319,0.134711431742508,0.887133182844244,0.917312661498708,0.93359375,0.935233160621762,0.267165898617512
E02003355,Priestwood,Bracknell Forest,South East,1530,4378,239,174,157,271,5219,1541,4738,288,181,144,252,5603,683,244,164,128,231,1450,0.144153651329675,0.847222222222222,0.906077348066298,0.888888888888889,0.916666666666667,0.258789933963948
E02003356,Chavey Down & North Ascot West,Bracknell Forest,South East,1454,4546,363,303,209,404,5825,1474,4764,391,320,239,392,6106,710,355,288,223,367,1943,0.149034424853065,0.907928388746803,0.9,0.933054393305439,0.936224489795918,0.318211595152309
E02003357,Bullbrook,Bracknell Forest,South East,2255,6662,335,291,216,445,7949,2247,7426,369,322,219,441,8777,1029,301,281,189,408,2208,0.138567196337194,0.815718157181572,0.872670807453416,0.863013698630137,0.925170068027211,0.251566594508374
E02003358,Central Bracknell & Wildridings,Bracknell Forest,South East,2423,7593,348,354,211,412,8918,2403,8159,388,333,264,428,9572,1176,324,296,242,390,2428,0.144135310699841,0.835051546391753,0.888888888888889,0.916666666666667,0.911214953271028,0.253656498119515
E02003359,Crown Wood,Bracknell Forest,South East,1293,4581,253,160,102,124,5220,1193,4692,288,197,117,128,5422,658,256,186,110,117,1327,0.140238704177323,0.888888888888889,0.944162436548223,0.94017094017094,0.9140625,0.244743637034305
E02003360,Great Hollands,Bracknell Forest,South East,2968,7452,455,452,262,228,8849,2800,7977,500,482,330,278,9567,1217,429,439,309,252,2646,0.152563620408675,0.858,0.910788381742739,0.936363636363636,0.906474820143885,0.276575729068674
E02003361,Birch Hill & Hanworth East,Bracknell Forest,South East,1501,4797,342,320,167,258,5884,1518,5342,360,329,219,249,6499,830,288,304,209,229,1860,0.15537251965556,0.8,0.924012158054711,0.954337899543379,0.919678714859438,0.286197876596399
E02003362,Hanworth West,Bracknell Forest,South East,1523,4304,329,338,163,169,5303,1404,4583,360,339,212,215,5709,716,330,317,199,193,1755,0.156229543966834,0.916666666666667,0.935103244837758,0.938679245283019,0.897674418604651,0.307409353652128
E02003363,Crowthorne South,Bracknell Forest,South East,1448,4304,354,376,286,495,5815,1412,4370,344,365,311,528,5918,645,307,342,297,514,2105,0.147597254004577,0.892441860465116,0.936986301369863,0.954983922829582,0.973484848484848,0.355694491382224
E02003364,Owlsmoor & Broadmoor,Bracknell Forest,South East,1359,4432,299,298,211,159,5399,1342,4676,356,311,226,186,5755,788,308,285,214,173,1768,0.168520102651839,0.865168539325843,0.916398713826366,0.946902654867257,0.93010752688172,0.307211120764553
E02003365,Sandhurst,Bracknell Forest,South East,1386,4043,398,384,219,345,5389,1336,4441,410,392,262,337,5842,736,353,363,243,318,2013,0.165728439540644,0.860975609756098,0.926020408163265,0.927480916030534,0.943620178041543,0.344573776104074
E02003366,College Town,Bracknell Forest,South East,1296,5186,321,279,170,258,6214,1216,5573,367,336,179,288,6743,677,317,317,163,259,1733,0.121478557329984,0.863760217983651,0.943452380952381,0.910614525139665,0.899305555555556,0.257007266795195
E02003367,"Chieveley, East Isley & Compton",West Berkshire,South East,1455,3785,358,357,254,242,4996,1289,4127,367,353,261,276,5384,636,295,334,254,270,1789,0.154107099588079,0.803814713896458,0.946175637393768,0.973180076628353,0.978260869565217,0.332280832095097
E02003368,Lambourn & Great Shefford,West Berkshire,South East,1025,3392,355,365,273,279,4664,1001,3991,364,385,309,329,5378,473,251,359,296,317,1696,0.118516662490604,0.68956043956044,0.932467532467532,0.957928802588997,0.963525835866261,0.315358869468204
E02003369,Streatley & Pangbourne,West Berkshire,South East,1302,3828,350,341,275,406,5200,1202,4179,377,366,292,421,5635,741,290,345,276,404,2056,0.177315147164393,0.769230769230769,0.942622950819672,0.945205479452055,0.959619952494062,0.364862466725821
E02003370,Purley on Thames,West Berkshire,South East,1189,3969,419,440,274,370,5472,1201,4406,413,443,329,394,5985,811,327,420,315,368,2241,0.184067181116659,0.791767554479419,0.948081264108352,0.957446808510638,0.934010152284264,0.374436090225564
E02003371,Westwood,West Berkshire,South East,1020,3436,331,284,279,352,4682,1057,3888,344,334,271,398,5235,751,292,315,262,374,1994,0.193158436213992,0.848837209302326,0.94311377245509,0.966789667896679,0.939698492462312,0.380897803247373
E02003372,Calcot North & Little Heath,West Berkshire,South East,1499,4498,458,433,314,426,6129,1531,5054,462,440,321,457,6734,964,381,419,305,439,2508,0.190740007914523,0.824675324675325,0.952272727272727,0.950155763239875,0.960612691466083,0.372438372438372
E02003373,Hermitage & Cold Ash,West Berkshire,South East,2025,5153,422,424,289,348,6636,1949,5308,411,450,304,390,6863,851,347,419,296,371,2284,0.160324039186134,0.844282238442822,0.931111111111111,0.973684210526316,0.951282051282051,0.332799067463209
E02003374,Calcot South,West Berkshire,South East,1030,3609,366,253,128,171,4527,1105,3929,344,297,182,214,4966,809,270,279,176,198,1732,0.205904810384322,0.784883720930233,0.939393939393939,0.967032967032967,0.925233644859813,0.348771647200967
E02003375,Theale & Beenham,West Berkshire,South East,1168,3616,331,293,192,290,4722,1145,4036,328,306,230,277,5177,765,245,282,222,263,1777,0.189544103072349,0.746951219512195,0.92156862745098,0.965217391304348,0.949458483754513,0.343248985899169
E02003376,Hungerford,West Berkshire,South East,1060,3393,356,372,302,364,4787,1033,3573,370,378,318,406,5045,605,288,356,304,389,1942,0.169325496781416,0.778378378378378,0.941798941798942,0.955974842767296,0.958128078817734,0.384935579781962
E02003377,Thatcham South East & Bradfield,West Berkshire,South East,2184,6128,616,629,322,457,8152,2224,6748,658,625,426,486,8943,994,543,595,404,460,2996,0.147302904564315,0.825227963525836,0.952,0.948356807511737,0.946502057613169,0.335010622833501
E02003378,Newbury North West,West Berkshire,South East,1368,4551,436,502,342,628,6459,1386,5125,439,487,387,595,7033,778,316,460,366,564,2484,0.151804878048781,0.719817767653758,0.944558521560575,0.945736434108527,0.947899159663866,0.353192094412057
E02003379,Newbury Clay Hill,West Berkshire,South East,1418,4442,276,280,190,306,5494,1373,4833,260,296,196,326,5911,669,181,278,186,310,1624,0.138423339540658,0.696153846153846,0.939189189189189,0.948979591836735,0.950920245398773,0.274742006428692
E02003380,Thatcham West,West Berkshire,South East,1471,4978,455,393,235,284,6345,1465,5535,466,424,265,261,6951,841,354,407,249,242,2093,0.151942186088528,0.759656652360515,0.959905660377358,0.939622641509434,0.9272030651341,0.30110775427996
E02003381,Burghfield Common,West Berkshire,South East,1294,3578,288,324,185,260,4635,1312,3785,327,305,191,306,4914,642,284,291,184,290,1691,0.169616908850727,0.868501529051988,0.954098360655738,0.963350785340314,0.947712418300654,0.344118844118844
E02003382,Thatcham Town,West Berkshire,South East,1598,4972,352,346,301,403,6374,1564,5151,342,378,299,416,6586,821,237,356,286,391,2091,0.159386526887983,0.692982456140351,0.941798941798942,0.956521739130435,0.939903846153846,0.317491648952323
E02003383,Thatcham North East,West Berkshire,South East,1504,4330,310,282,152,211,5285,1458,4802,339,326,187,228,5882,713,264,312,180,217,1686,0.148479800083299,0.778761061946903,0.957055214723926,0.962566844919786,0.951754385964912,0.286637198231894
E02003384,Kintbury & Boxford,West Berkshire,South East,1197,3801,398,419,310,387,5315,1097,4063,427,422,329,430,5671,580,354,407,308,421,2070,0.14275166133399,0.82903981264637,0.964454976303318,0.936170212765957,0.97906976744186,0.365014988538177
E02003385,Newbury Central & Greenham,West Berkshire,South East,1863,6974,395,373,268,390,8400,2021,7927,435,382,302,447,9493,1009,334,357,285,425,2410,0.127286489214078,0.767816091954023,0.934554973821989,0.943708609271523,0.950782997762864,0.253871273569999
E02003386,Newbury South West,West Berkshire,South East,1685,5131,361,439,279,343,6553,1653,5821,392,444,328,381,7366,799,294,427,308,364,2192,0.137261638893661,0.75,0.961711711711712,0.939024390243902,0.955380577427822,0.297583491718708
E02003387,Newbury Wash Common,West Berkshire,South East,2043,5353,520,631,373,532,7409,1963,5854,509,594,430,573,7960,763,424,566,416,558,2727,0.130338230269901,0.833005893909627,0.952861952861953,0.967441860465116,0.973821989528796,0.342587939698492
E02003388,Mortimer & Aldermaston Wharf,West Berkshire,South East,1172,3395,319,360,250,320,4644,1146,3823,328,343,286,338,5118,681,276,325,280,326,1888,0.178132356787863,0.841463414634146,0.947521865889213,0.979020979020979,0.964497041420118,0.368894099257523
E02003389,Caversham Emmer Green,Reading,South East,1565,4163,412,465,333,466,5839,1538,5130,424,510,376,504,6944,687,334,489,359,486,2355,0.133918128654971,0.787735849056604,0.958823529411765,0.954787234042553,0.964285714285714,0.339141705069124
E02003390,Caversham Heights,Reading,South East,1567,4056,421,390,292,421,5580,1638,5011,448,413,322,450,6644,571,382,392,305,440,2090,0.113949311514668,0.852678571428571,0.949152542372881,0.947204968944099,0.977777777777778,0.314569536423841
E02003391,Caversham Balmore Park,Reading,South East,1874,4518,385,371,315,538,6127,1963,5830,381,418,334,548,7511,627,279,385,322,528,2141,0.107547169811321,0.732283464566929,0.921052631578947,0.964071856287425,0.963503649635036,0.285048595393423
E02003392,Lower Caversham,Reading,South East,1645,5193,276,245,178,302,6194,1817,6696,308,261,217,307,7789,627,232,234,194,275,1562,0.0936379928315412,0.753246753246753,0.896551724137931,0.894009216589862,0.895765472312704,0.200539221979715
E02003393,Tilehurst North,Reading,South East,1542,4463,360,396,294,425,5938,1544,5379,408,400,330,479,6996,1017,342,375,311,455,2500,0.189068600111545,0.838235294117647,0.9375,0.942424242424242,0.949895615866388,0.357347055460263
E02003394,Norcot North,Reading,South East,2207,4783,287,245,154,297,5766,2193,6344,328,295,181,307,7455,882,211,245,154,256,1748,0.139029003783102,0.643292682926829,0.830508474576271,0.850828729281768,0.833876221498371,0.234473507712944
E02003395,Battle & Caversham Bridge,Reading,South East,2404,7144,197,171,115,155,7782,2418,9912,301,213,152,213,10791,1074,172,162,113,157,1678,0.108353510895884,0.571428571428571,0.76056338028169,0.743421052631579,0.737089201877934,0.155499953665091
E02003396,Norcot South,Reading,South East,2019,6094,247,245,209,310,7105,2077,8050,343,311,218,312,9234,1032,232,249,185,265,1963,0.128198757763975,0.676384839650146,0.80064308681672,0.848623853211009,0.849358974358974,0.212583928958198
E02003397,Tilehurst South,Reading,South East,1744,4201,329,392,269,452,5643,1856,5503,365,378,277,445,6968,1008,264,341,255,407,2275,0.183172814828276,0.723287671232877,0.902116402116402,0.92057761732852,0.914606741573034,0.326492537313433
E02003398,Palmer Park,Reading,South East,2153,7576,264,247,163,168,8418,2369,9928,326,264,178,214,10910,1049,224,214,144,170,1801,0.105660757453666,0.687116564417178,0.810606060606061,0.808988764044944,0.794392523364486,0.165077910174152
E02003399,Reading Central,Reading,South East,2433,11498,243,235,156,118,12250,2659,15634,325,228,171,178,16536,1141,186,181,127,139,1774,0.0729819623896636,0.572307692307692,0.793859649122807,0.742690058479532,0.780898876404494,0.107281083696178
E02003400,Wokingham Road,Reading,South East,1298,6083,202,166,129,285,6865,1239,7114,238,218,164,309,8043,766,196,196,144,284,1586,0.107675007028395,0.823529411764706,0.89908256880734,0.878048780487805,0.919093851132686,0.197190103195325
E02003401,Coley Park,Reading,South East,1857,5659,283,231,211,456,6840,1902,6869,339,247,200,468,8123,899,221,199,175,414,1908,0.13087785703887,0.651917404129794,0.805668016194332,0.875,0.884615384615385,0.234888587960113
E02003402,Southampton Street & Redlands Road,Reading,South East,1683,7970,255,203,136,203,8767,1868,10739,286,269,184,203,11681,1078,200,216,156,163,1813,0.100381786013595,0.699300699300699,0.802973977695167,0.847826086956522,0.802955665024631,0.155209314271038
E02003403,Southcote,Reading,South East,1986,5052,391,396,320,496,6655,2021,6373,438,398,319,460,7988,1204,320,354,291,427,2596,0.188922014749725,0.730593607305936,0.889447236180905,0.912225705329154,0.928260869565217,0.324987481221833
E02003404,Leighton Park,Reading,South East,1359,7343,214,207,162,265,8191,1542,9473,255,213,177,274,10392,717,190,179,159,256,1501,0.0756887997466484,0.745098039215686,0.84037558685446,0.898305084745763,0.934306569343066,0.144438029253272
E02003405,Kennet Island & Green Park,Reading,South East,2870,7458,345,275,170,244,8492,3154,10253,381,333,232,264,11463,1345,286,280,199,224,2334,0.131181117721642,0.750656167979003,0.840840840840841,0.857758620689655,0.848484848484848,0.203611619994766
E02003406,Whitley Wood,Reading,South East,1608,4442,366,282,178,246,5514,1771,5920,414,316,200,282,7132,945,336,273,175,253,1982,0.159628378378378,0.811594202898551,0.863924050632912,0.875,0.897163120567376,0.277902411665732
E02003407,Britwell,Slough,South East,3049,6121,293,197,117,293,7021,3136,7844,348,255,128,261,8836,1389,277,219,110,226,2221,0.177078021417644,0.795977011494253,0.858823529411765,0.859375,0.865900383141763,0.251358080579448
E02003408,Manor Park,Slough,South East,3057,6796,394,242,214,279,7925,3139,8869,441,323,188,324,10145,1161,310,257,161,268,2157,0.130905400834367,0.702947845804989,0.795665634674923,0.856382978723404,0.82716049382716,0.212617052735338
E02003409,Haymill & Lynch Hill,Slough,South East,2404,6484,351,272,186,260,7553,2408,7362,403,312,216,304,8597,1307,335,278,193,268,2381,0.177533279000272,0.831265508684863,0.891025641025641,0.893518518518519,0.881578947368421,0.276957078050483
E02003410,Baylis & Stoke,Slough,South East,3230,7175,365,254,220,301,8315,3468,9885,448,287,202,321,11143,1222,344,225,159,271,2221,0.123621648963075,0.767857142857143,0.78397212543554,0.787128712871287,0.844236760124611,0.199317957462084
E02003411,Wexham Lea,Slough,South East,2923,7139,358,264,234,411,8406,3212,9221,436,300,216,424,10597,1637,327,255,184,352,2755,0.177529552109316,0.75,0.85,0.851851851851852,0.830188679245283,0.259979239407379
E02003412,Cippenham Green,Slough,South East,2435,6111,404,321,255,294,7385,2563,7127,411,360,211,302,8411,1107,342,309,193,270,2221,0.155324821102848,0.832116788321168,0.858333333333333,0.914691943127962,0.894039735099338,0.26405897039591
E02003413,Stoke Road & Wexham Road,Slough,South East,3501,8655,462,288,190,305,9900,3788,11991,523,352,210,364,13440,1422,373,278,170,291,2534,0.11858894170628,0.713193116634799,0.789772727272727,0.80952380952381,0.79945054945055,0.188541666666667
E02003414,Cippenham Meadows,Slough,South East,3775,8312,388,317,197,207,9421,3841,9640,432,332,207,226,10837,1327,334,274,173,183,2291,0.137655601659751,0.773148148148148,0.825301204819277,0.835748792270531,0.809734513274336,0.211405370489988
E02003415,Chalvey,Slough,South East,3558,8330,364,234,175,301,9404,3859,10535,359,259,176,340,11669,1008,243,198,138,269,1856,0.0956810631229236,0.676880222841226,0.764478764478765,0.784090909090909,0.791176470588235,0.159053903505013
E02003416,Langley St Mary's,Slough,South East,2331,5829,341,265,209,295,6939,2416,6621,368,275,207,306,7777,1017,305,240,185,270,2017,0.153602174898052,0.828804347826087,0.872727272727273,0.893719806763285,0.882352941176471,0.259354506879259
E02003417,Central Slough & Upton Court,Slough,South East,2771,7551,394,268,204,312,8729,3152,9470,431,343,216,333,10793,1174,328,287,190,292,2271,0.123970432946146,0.761020881670534,0.836734693877551,0.87962962962963,0.876876876876877,0.210414157324192
E02003418,Langley Kederminster,Slough,South East,2634,6383,402,236,153,308,7482,2547,7459,407,295,171,297,8629,1159,333,250,146,249,2137,0.155382759082987,0.818181818181818,0.847457627118644,0.853801169590643,0.838383838383838,0.247653262255186
E02003419,Langley Foxborough,Slough,South East,2208,5566,283,274,226,286,6635,2271,6233,320,256,193,327,7329,978,245,214,160,274,1871,0.156906786459169,0.765625,0.8359375,0.829015544041451,0.837920489296636,0.255287215172602
E02003420,Colnbrook & Poyle,Slough,South East,1581,4426,169,138,102,132,4967,1597,4675,234,168,107,125,5309,619,183,144,93,104,1143,0.132406417112299,0.782051282051282,0.857142857142857,0.869158878504673,0.832,0.215294782444905
E02003421,Pinkney's Green & Furze Platt Road,Windsor and Maidenhead,South East,1081,3318,293,313,229,372,4525,1108,3706,295,350,255,368,4974,609,258,317,245,339,1768,0.164328116567728,0.874576271186441,0.905714285714286,0.96078431372549,0.921195652173913,0.355448331322879
E02003422,Cookham & Waltham,Windsor and Maidenhead,South East,2194,6497,684,751,527,799,9258,2144,7494,690,783,573,787,10327,1143,599,737,549,744,3772,0.152522017614091,0.868115942028986,0.94125159642401,0.958115183246073,0.945362134688691,0.365256124721604
E02003423,Furze Platt,Windsor and Maidenhead,South East,1506,3915,298,293,201,257,4964,1507,4543,300,256,198,251,5548,830,251,233,178,228,1720,0.182698657274928,0.836666666666667,0.91015625,0.898989898989899,0.908366533864542,0.310021629416006
E02003424,Maidenhead East,Windsor and Maidenhead,South East,1587,5370,442,512,414,635,7373,1590,6180,522,501,433,669,8305,941,447,450,397,603,2838,0.152265372168285,0.85632183908046,0.898203592814371,0.916859122401848,0.901345291479821,0.341721854304636
E02003425,Maidenhead Central,Windsor and Maidenhead,South East,2837,8632,397,361,318,558,10266,2837,9858,449,396,362,541,11606,1249,355,333,322,483,2742,0.126699127612092,0.79064587973274,0.840909090909091,0.889502762430939,0.89279112754159,0.236257108392211
E02003426,Maidenhead Highway,Windsor and Maidenhead,South East,1957,5991,474,419,328,617,7829,1889,6571,465,464,340,610,8450,1038,407,422,314,570,2751,0.157966823923299,0.875268817204301,0.90948275862069,0.923529411764706,0.934426229508197,0.325562130177515
E02003427,Boyn Hill & Norreys Drive,Windsor and Maidenhead,South East,1970,5154,279,279,214,324,6250,1939,5914,305,276,193,326,7014,979,244,244,174,295,1936,0.165539398038553,0.8,0.884057971014493,0.901554404145078,0.904907975460123,0.276019389791845
E02003428,Cox Green,Windsor and Maidenhead,South East,1999,5436,505,502,331,355,7129,1909,5991,527,506,361,412,7797,1187,480,475,343,389,2874,0.198130529127024,0.910815939278937,0.938735177865613,0.950138504155125,0.944174757281553,0.368603308964987
E02003429,Bray Wick & Holyport,Windsor and Maidenhead,South East,1495,4511,435,465,315,451,6177,1449,5130,455,485,363,448,6881,872,407,442,346,425,2492,0.169980506822612,0.894505494505495,0.911340206185567,0.953168044077135,0.948660714285714,0.362156663275687
E02003430,Windsor Town & Eton,Windsor and Maidenhead,South East,1332,4728,297,270,139,299,5733,1602,5681,311,275,164,298,6729,697,244,236,145,265,1587,0.122689667312093,0.784565916398714,0.858181818181818,0.884146341463415,0.889261744966443,0.235844850646456
E02003431,Datchet,Windsor and Maidenhead,South East,1327,4247,306,328,215,344,5440,1377,4796,364,340,252,319,6071,624,319,315,233,289,1780,0.130108423686405,0.876373626373626,0.926470588235294,0.924603174603175,0.905956112852665,0.293197166858837
E02003432,Clewer Village,Windsor and Maidenhead,South East,1403,4786,247,248,186,359,5826,1412,5814,295,273,176,369,6927,825,244,245,157,349,1820,0.141898864809082,0.827118644067797,0.897435897435897,0.892045454545455,0.94579945799458,0.262740002887253
E02003433,Dedworth,Windsor and Maidenhead,South East,1377,3772,300,371,309,495,5247,1305,3849,345,335,309,452,5290,819,312,319,296,425,2171,0.212782540919719,0.904347826086956,0.952238805970149,0.957928802588997,0.940265486725664,0.410396975425331
E02003434,Clewer New Town,Windsor and Maidenhead,South East,1935,5575,372,389,261,581,7178,1904,6388,408,400,294,559,8049,1187,344,355,260,525,2671,0.185817157169693,0.843137254901961,0.8875,0.884353741496599,0.9391771019678,0.331842464902472
E02003435,Spital & Cranbourne Park,Windsor and Maidenhead,South East,1538,4476,273,329,273,323,5674,1516,5211,343,356,284,340,6534,932,289,322,265,301,2109,0.178852427557091,0.842565597667639,0.904494382022472,0.933098591549296,0.885294117647059,0.32277318640955
E02003436,Old Windsor & Wraysbury,Windsor and Maidenhead,South East,1451,5036,525,535,382,622,7100,1490,5718,553,548,393,638,7850,933,499,509,356,594,2891,0.163168940188877,0.902350813743219,0.928832116788321,0.905852417302799,0.931034482758621,0.36828025477707
E02003437,Ascot & North Ascot East,Windsor and Maidenhead,South East,1522,4534,386,409,292,411,6032,1520,5132,381,416,322,395,6646,795,315,368,295,364,2137,0.154910366328917,0.826771653543307,0.884615384615385,0.916149068322981,0.921518987341772,0.321546795064701
E02003438,South Ascot & Sunningdale,Windsor and Maidenhead,South East,2215,6264,527,631,416,857,8695,2212,7455,553,623,485,853,9969,960,491,583,450,811,3295,0.128772635814889,0.887884267631103,0.935794542536116,0.927835051546392,0.950762016412661,0.330524626341659
E02003439,Twyford East & Wargrave,Wokingham,South East,945,3275,321,363,287,408,4654,1011,3846,299,372,312,444,5273,597,245,357,295,426,1920,0.155226209048362,0.819397993311037,0.959677419354839,0.94551282051282,0.959459459459459,0.364119097288071
E02003440,Twyford West & Charvil,Wokingham,South East,1978,5512,428,462,356,532,7290,1984,6060,433,489,397,532,7911,904,365,464,385,515,2633,0.149174917491749,0.842956120092379,0.948875255623722,0.969773299748111,0.968045112781955,0.332827708254329
E02003441,Sonning & Woodley North,Wokingham,South East,1434,4459,407,434,357,590,6247,1425,4960,433,419,369,587,6768,890,377,395,351,550,2563,0.179435483870968,0.87066974595843,0.94272076372315,0.951219512195122,0.936967632027257,0.378693853427896
E02003442,Woodley East,Wokingham,South East,1771,4999,328,302,197,254,6080,1815,5673,365,323,217,288,6866,904,300,309,207,272,1992,0.159351313238146,0.821917808219178,0.956656346749226,0.953917050691244,0.944444444444444,0.290125254879115
E02003443,Woodley South,Wokingham,South East,1654,4041,308,358,287,595,5589,1556,4387,270,328,269,534,5788,739,210,303,254,510,2016,0.168452245270116,0.777777777777778,0.923780487804878,0.944237918215613,0.955056179775281,0.348306841741534
E02003444,Earley,Wokingham,South East,2157,6138,357,362,308,492,7657,2068,6790,407,341,310,510,8358,1016,349,324,290,471,2450,0.149631811487482,0.857493857493857,0.950146627565982,0.935483870967742,0.923529411764706,0.293132328308208
E02003445,Southlake,Wokingham,South East,1814,5201,428,451,375,453,6908,1823,5715,445,473,391,492,7516,975,345,444,378,470,2612,0.170603674540682,0.775280898876405,0.938689217758985,0.966751918158568,0.955284552845528,0.347525279403938
E02003446,Lower Earley North,Wokingham,South East,1772,6779,409,491,291,403,8373,1681,7686,425,491,337,418,9357,876,381,459,318,400,2434,0.113973458235753,0.896470588235294,0.934826883910387,0.943620178041543,0.956937799043062,0.260126108795554
E02003447,Winnersh,Wokingham,South East,2323,6591,398,380,221,424,8014,2367,7260,399,409,300,429,8797,1095,332,386,287,401,2501,0.150826446280992,0.832080200501253,0.943765281173594,0.956666666666667,0.934731934731935,0.284301466409003
E02003448,Wokingham North & Hurst,Wokingham,South East,1572,4432,427,404,268,362,5893,1660,5079,395,427,292,377,6570,865,318,401,276,366,2226,0.17030911596771,0.805063291139241,0.939110070257611,0.945205479452055,0.970822281167109,0.338812785388128
E02003449,Lower Earley South,Wokingham,South East,1691,5306,253,237,124,198,6118,1598,5614,313,227,150,184,6488,767,277,210,140,169,1563,0.136622728892056,0.884984025559105,0.92511013215859,0.933333333333333,0.918478260869565,0.240906288532676
E02003450,Shinfield,Wokingham,South East,2836,7977,447,405,285,388,9502,3012,9101,522,453,285,472,10833,1256,437,409,264,442,2808,0.138006812438194,0.837164750957854,0.902869757174393,0.926315789473684,0.936440677966102,0.259207975630019
E02003451,Wokingham Town,Wokingham,South East,1696,5358,405,446,379,802,7390,1733,6144,420,466,402,760,8192,1110,314,439,386,732,2981,0.1806640625,0.747619047619048,0.94206008583691,0.960199004975124,0.963157894736842,0.3638916015625
E02003452,Wokingham East,Wokingham,South East,2053,5184,324,355,292,365,6520,2173,5937,362,353,297,353,7302,997,292,330,287,337,2243,0.167929930941553,0.806629834254144,0.934844192634561,0.966329966329966,0.954674220963173,0.307176116132566
E02003453,Barkham & Woose Hill,Wokingham,South East,1470,4054,381,354,210,246,5245,1433,4570,403,383,255,265,5876,817,343,362,245,257,2024,0.178774617067834,0.851116625310174,0.945169712793734,0.96078431372549,0.969811320754717,0.344452008168822
E02003454,Wokingham West & South,Wokingham,South East,1921,5148,431,422,335,544,6880,1836,5562,436,449,345,541,7333,924,334,424,338,517,2537,0.166127292340885,0.76605504587156,0.944320712694877,0.979710144927536,0.955637707948244,0.345970271375972
E02003455,Spencers Wood & Swallowfield,Wokingham,South East,1965,5259,396,407,250,342,6654,2290,6593,420,434,280,367,8094,1064,326,404,263,328,2385,0.161383285302594,0.776190476190476,0.930875576036866,0.939285714285714,0.893732970027248,0.29466271312083
E02003456,Arborfield & Garrison,Wokingham,South East,1674,4258,287,277,191,297,5310,1940,5017,305,313,215,316,6166,839,231,290,206,294,1860,0.167231413195137,0.757377049180328,0.926517571884984,0.958139534883721,0.930379746835443,0.301654232890042
E02003457,Finchampstead,Wokingham,South East,1906,6059,622,604,393,421,8099,1792,6508,588,646,438,492,8672,1218,507,619,423,475,3242,0.187154271665642,0.862244897959184,0.958204334365325,0.965753424657534,0.965447154471545,0.373846863468635
E02003458,Crowthorne North,Wokingham,South East,1667,4643,456,503,349,446,6397,1753,5512,490,513,399,513,7427,973,438,485,378,484,2758,0.176523947750363,0.893877551020408,0.94541910331384,0.947368421052632,0.943469785575049,0.371347785108388
E02003459,Olney & Lavendon,Milton Keynes,South East,1621,4691,564,546,368,582,6751,1571,5433,569,600,419,598,7619,899,527,580,411,586,3003,0.165470274249954,0.926186291739895,0.966666666666667,0.98090692124105,0.979933110367893,0.394146213413834
E02003460,"Hanslope, Castlethorpe & Sherington",Milton Keynes,South East,2264,6284,669,612,431,504,8500,2329,7316,679,694,468,563,9720,1133,595,660,447,539,3374,0.15486604702023,0.876288659793815,0.951008645533141,0.955128205128205,0.957371225577265,0.347119341563786
E02003461,Newport Pagnell North,Milton Keynes,South East,1434,3970,482,474,350,509,5785,1456,4775,482,538,337,496,6628,675,396,520,320,477,2388,0.141361256544503,0.821576763485477,0.966542750929368,0.949554896142433,0.961693548387097,0.36028968014484
E02003462,Newport Pagnell South,Milton Keynes,South East,1449,4700,426,370,233,358,6087,1561,5684,488,404,284,354,7214,795,372,384,274,330,2155,0.139866291344124,0.762295081967213,0.95049504950495,0.964788732394366,0.932203389830508,0.298724701968395
E02003463,Great Linford & Giffard Park,Milton Keynes,South East,1225,3949,473,426,221,272,5341,1193,4864,480,456,269,294,6363,715,387,418,255,270,2045,0.146998355263158,0.80625,0.916666666666667,0.947955390334572,0.918367346938776,0.321389281785321
E02003464,Stantonbury & Bradville,Milton Keynes,South East,1689,4187,302,245,141,131,5006,1620,5110,325,285,169,143,6032,748,243,262,154,134,1541,0.146379647749511,0.747692307692308,0.919298245614035,0.911242603550296,0.937062937062937,0.255470822281167
E02003465,Willen & Downhead Park,Milton Keynes,South East,968,3707,430,339,232,404,5112,927,4335,507,397,276,390,5905,661,414,375,258,372,2080,0.152479815455594,0.816568047337278,0.944584382871536,0.934782608695652,0.953846153846154,0.352243861134632
E02003466,Wolverton & New Bradwell,Milton Keynes,South East,1867,5025,277,207,122,219,5850,1740,5553,294,265,144,193,6449,673,217,232,124,179,1425,0.121195750045021,0.738095238095238,0.875471698113208,0.861111111111111,0.927461139896373,0.220964490618701
E02003467,Linford Wood,Milton Keynes,South East,1415,3956,328,261,157,325,5027,1351,4910,356,305,211,325,6107,615,275,286,195,300,1671,0.125254582484725,0.77247191011236,0.937704918032787,0.924170616113744,0.923076923076923,0.273620435565744
E02003468,Stony Stratford & Old Wolverton,Milton Keynes,South East,1778,4827,500,422,342,441,6532,1715,5673,494,477,350,437,7431,840,396,450,333,414,2433,0.14806980433633,0.801619433198381,0.943396226415094,0.951428571428571,0.947368421052632,0.327412192167945
E02003469,Bradwell Village,Milton Keynes,South East,1043,3459,386,318,159,187,4509,1067,3931,435,354,199,228,5147,629,356,324,186,213,1708,0.160010175527856,0.818390804597701,0.915254237288136,0.934673366834171,0.93421052631579,0.331843792500486
E02003470,Stacey Bushes & Fullers Slade,Milton Keynes,South East,1837,3536,235,173,98,86,4128,1758,4457,236,188,124,92,5097,524,162,157,109,79,1031,0.117567870765089,0.686440677966102,0.835106382978723,0.879032258064516,0.858695652173913,0.202275848538356
E02003471,Bradwell Common,Milton Keynes,South East,1366,4204,356,278,177,185,5200,1335,5113,394,290,167,194,6158,687,308,263,151,169,1578,0.134363387443771,0.781725888324873,0.906896551724138,0.904191616766467,0.871134020618557,0.256252029879831
E02003472,Central Milton Keynes & Newlands,Milton Keynes,South East,1856,7375,243,133,93,127,7971,1953,8749,247,190,92,112,9390,731,173,166,77,99,1246,0.0835524059892559,0.700404858299595,0.873684210526316,0.836956521739131,0.883928571428571,0.132694355697551
E02003473,Two Mile Ash,Milton Keynes,South East,1110,3475,278,241,181,163,4338,1093,3936,325,268,181,179,4889,599,251,254,165,164,1433,0.152184959349594,0.772307692307692,0.947761194029851,0.911602209944751,0.916201117318436,0.293106974841481
E02003474,Woughton & Woolstone,Milton Keynes,South East,2063,5731,398,314,186,190,6819,2081,6449,423,371,190,199,7632,848,325,334,175,180,1862,0.131493254768181,0.768321513002364,0.900269541778976,0.921052631578947,0.904522613065327,0.243972746331237
E02003475,"Broughton, Middleton & Kents Hill",Milton Keynes,South East,6470,14901,541,342,166,307,16257,7194,17791,603,436,242,331,19403,2054,453,367,210,294,3378,0.115451632848069,0.751243781094527,0.841743119266055,0.867768595041322,0.88821752265861,0.174096789156316
E02003476,Eaglestone & Fishermead,Milton Keynes,South East,2299,5850,336,244,150,207,6787,2116,6719,324,277,142,184,7646,971,235,241,129,171,1747,0.144515552909659,0.725308641975309,0.870036101083033,0.908450704225352,0.929347826086957,0.228485482605284
E02003477,Shenley Wood & Grange Farm,Milton Keynes,South East,3972,9777,458,439,313,439,11426,4420,11912,459,478,349,440,13638,1738,366,443,320,418,3285,0.145903290799194,0.797385620915033,0.926778242677824,0.916905444126075,0.95,0.240871095468544
E02003478,Loughton,Milton Keynes,South East,1464,4384,289,277,144,214,5308,1436,5008,340,285,167,217,6017,783,258,260,157,194,1652,0.156349840255591,0.758823529411765,0.912280701754386,0.940119760479042,0.894009216589862,0.274555426292172
E02003479,Oldbrook & Coffee Hall,Milton Keynes,South East,1828,4967,250,205,101,88,5611,1833,5948,274,246,115,122,6705,771,205,219,100,105,1400,0.129623402824479,0.748175182481752,0.890243902439024,0.869565217391304,0.860655737704918,0.208799403430276
E02003480,Walnut Tree & Tilbrook,Milton Keynes,South East,1772,5548,289,219,136,113,6305,1696,6235,359,244,142,150,7130,896,292,223,129,136,1676,0.143704891740176,0.813370473537604,0.913934426229508,0.908450704225352,0.906666666666667,0.235063113604488
E02003481,Denbigh,Milton Keynes,South East,2170,4936,330,238,157,183,5844,2025,5819,349,242,163,200,6773,805,241,213,147,177,1583,0.138339920948617,0.69054441260745,0.880165289256198,0.901840490797546,0.885,0.233722131994685
E02003482,Bow Brickhill & Woburn Sands,Milton Keynes,South East,1337,4075,388,325,232,367,5387,1506,5206,418,396,267,382,6669,945,377,379,257,366,2324,0.181521321552055,0.901913875598086,0.957070707070707,0.962546816479401,0.958115183246073,0.348478032688559
E02003483,Westcroft & Shenley Brook End,Milton Keynes,South East,2811,7538,265,175,111,146,8235,2849,8658,315,247,109,158,9487,1248,243,210,100,128,1929,0.144144144144144,0.771428571428571,0.850202429149798,0.91743119266055,0.810126582278481,0.203330873827343
E02003484,Furzton,Milton Keynes,South East,1549,4497,372,307,158,178,5512,1479,5232,375,360,219,196,6382,913,304,319,192,183,1911,0.174503058103976,0.810666666666667,0.886111111111111,0.876712328767123,0.933673469387755,0.299435913506738
E02003485,Bletchley North West,Milton Keynes,South East,1867,4628,380,383,385,397,6173,1768,5680,438,403,347,425,7293,1016,363,370,323,401,2473,0.17887323943662,0.828767123287671,0.918114143920596,0.930835734870317,0.943529411764706,0.339092280268751
E02003486,Tattenhoe & Emerson Valley,Milton Keynes,South East,2287,6307,296,195,151,165,7114,2452,7235,336,264,162,164,8161,1136,267,236,141,143,1923,0.157014512785073,0.794642857142857,0.893939393939394,0.87037037037037,0.871951219512195,0.235632888126455
E02003487,Far Bletchley,Milton Keynes,South East,1542,4041,451,469,334,421,5716,1485,4878,431,462,357,404,6532,996,381,441,336,385,2539,0.204182041820418,0.883990719257541,0.954545454545455,0.941176470588235,0.952970297029703,0.388701775872627
E02003488,Bletchley East,Milton Keynes,South East,1717,4632,421,377,314,413,6157,1799,5980,434,393,330,400,7537,945,377,355,306,355,2338,0.158026755852843,0.868663594470046,0.903307888040712,0.927272727272727,0.8875,0.310202998540533
E02003489,Bletchley West,Milton Keynes,South East,1488,4238,414,393,250,546,5841,1466,4924,384,441,265,475,6489,885,349,408,250,425,2317,0.179731925264013,0.908854166666667,0.925170068027211,0.943396226415094,0.894736842105263,0.357065803667745
E02003490,Bletchley South,Milton Keynes,South East,2933,5389,280,310,127,231,6337,3160,7163,292,321,207,225,8208,1172,246,295,185,201,2099,0.163618595560519,0.842465753424658,0.919003115264798,0.893719806763285,0.893333333333333,0.2557261208577
E02003491,Patcham East,Brighton and Hove,South East,1633,4877,336,352,278,378,6221,1564,5517,375,387,251,414,6944,965,317,352,238,383,2255,0.174913902483234,0.845333333333333,0.909560723514212,0.948207171314741,0.92512077294686,0.324740783410138
E02003492,Coldean & Moulsecoomb North,Brighton and Hove,South East,1068,9863,223,188,139,227,10640,1096,14807,237,205,148,223,15620,925,199,195,136,201,1656,0.062470453164044,0.839662447257384,0.951219512195122,0.918918918918919,0.901345291479821,0.106017925736236
E02003493,Patcham West & Westdene,Brighton and Hove,South East,1508,4820,387,443,354,711,6715,1525,5302,423,455,347,712,7239,961,378,419,326,669,2753,0.181252357600905,0.893617021276596,0.920879120879121,0.939481268011527,0.939606741573034,0.380301146567205
E02003494,Hollingbury,Brighton and Hove,South East,1270,4120,343,304,203,308,5278,1297,4669,355,370,222,333,5949,869,312,345,208,315,2049,0.186121225101735,0.87887323943662,0.932432432432432,0.936936936936937,0.945945945945946,0.344427634896621
E02003495,Mile Oak,Brighton and Hove,South East,1391,4495,312,347,253,285,5692,1396,4864,323,351,269,321,6128,996,296,331,257,304,2184,0.204769736842105,0.91640866873065,0.943019943019943,0.955390334572491,0.947040498442368,0.356396866840731
E02003496,Hangleton North,Brighton and Hove,South East,1481,4540,326,371,305,494,6036,1575,5024,364,395,265,514,6562,1007,317,365,247,480,2416,0.200437898089172,0.870879120879121,0.924050632911392,0.932075471698113,0.933852140077821,0.36818043279488
E02003497,West Blatchington,Brighton and Hove,South East,1566,4522,398,416,265,479,6080,1575,5276,430,415,315,473,6909,989,386,383,290,412,2460,0.187452615617892,0.897674418604651,0.92289156626506,0.920634920634921,0.871035940803383,0.356057316543639
E02003498,Hollingdean & Moulsecoomb West,Brighton and Hove,South East,1563,6478,283,263,200,291,7515,1504,6525,325,254,196,282,7582,1035,244,232,174,243,1928,0.158620689655172,0.750769230769231,0.913385826771654,0.887755102040816,0.861702127659575,0.254286467950409
E02003499,Bevendean & Moulsecoomb East,Brighton and Hove,South East,1332,5747,232,259,182,292,6712,1323,6314,273,248,215,284,7334,964,217,215,181,238,1815,0.152676591700982,0.794871794871795,0.866935483870968,0.841860465116279,0.838028169014084,0.247477502045269
E02003500,Fiveways,Brighton and Hove,South East,1668,5787,283,220,103,166,6559,1669,6638,339,283,140,171,7571,1069,299,249,129,146,1892,0.161042482675505,0.882005899705015,0.879858657243816,0.921428571428571,0.853801169590643,0.249900937788931
E02003501,Withdean Woods,Brighton and Hove,South East,1586,5937,336,326,213,399,7211,1546,6282,378,354,235,349,7598,971,318,316,215,303,2123,0.154568608723337,0.841269841269841,0.892655367231638,0.914893617021277,0.868194842406877,0.279415635693604
E02003502,Portslade Village,Brighton and Hove,South East,1608,4930,317,320,190,320,6077,1564,5481,337,355,219,338,6730,1199,279,323,203,299,2303,0.218755701514322,0.827893175074184,0.909859154929577,0.926940639269406,0.884615384615385,0.342199108469539
E02003503,Hangleton South,Brighton and Hove,South East,1864,5593,372,402,257,462,7086,1853,6414,448,420,262,445,7989,1253,374,372,233,407,2639,0.195353913314624,0.834821428571429,0.885714285714286,0.889312977099237,0.914606741573034,0.330329202653649
E02003504,Preston Park,Brighton and Hove,South East,1293,6512,305,276,120,263,7476,1326,7604,357,292,189,233,8675,1041,305,256,164,204,1970,0.136901630720673,0.854341736694678,0.876712328767123,0.867724867724868,0.875536480686695,0.227089337175793
E02003505,Round Hill,Brighton and Hove,South East,1042,8719,233,149,78,144,9323,920,8228,225,177,91,119,8840,1018,182,138,79,97,1514,0.123723869713175,0.808888888888889,0.779661016949153,0.868131868131868,0.815126050420168,0.171266968325792
E02003506,Aldrington,Brighton and Hove,South East,1692,4813,236,161,131,179,5520,1665,5552,256,193,125,169,6295,828,194,166,109,147,1444,0.149135446685879,0.7578125,0.860103626943005,0.872,0.869822485207101,0.229388403494837
E02003507,Woodingdean,Brighton and Hove,South East,1898,5844,519,515,404,671,7953,1824,6265,559,543,448,652,8467,1363,470,494,402,564,3293,0.21755786113328,0.840787119856887,0.9097605893186,0.897321428571429,0.865030674846626,0.388921695996221
E02003508,Elm Grove & Bear Road,Brighton and Hove,South East,1335,7832,209,190,114,157,8502,1263,7281,263,222,116,159,8041,1095,214,192,104,144,1749,0.150391429748661,0.813688212927757,0.864864864864865,0.896551724137931,0.905660377358491,0.217510259917921
E02003509,Goldsmid West,Brighton and Hove,South East,1311,6963,292,269,208,311,8043,1369,7746,321,312,241,307,8927,969,231,253,199,251,1903,0.125096824167312,0.719626168224299,0.810897435897436,0.825726141078838,0.817589576547231,0.213173518539263
E02003510,Goldsmid East,Brighton and Hove,South East,1376,6347,288,296,196,445,7572,1457,7754,356,355,255,474,9194,1148,272,292,216,416,2344,0.148052618003611,0.764044943820225,0.822535211267606,0.847058823529412,0.877637130801688,0.254948879704155
E02003511,Portslade by Sea,Brighton and Hove,South East,1838,5517,310,283,223,327,6660,1850,6381,347,317,229,356,7630,1264,289,278,204,315,2350,0.198088073969597,0.832853025936599,0.876971608832808,0.890829694323144,0.884831460674157,0.307994757536042
E02003512,Hanover,Brighton and Hove,South East,1298,7965,249,173,111,132,8630,1187,7773,278,197,105,122,8475,1071,215,153,94,93,1626,0.137784639135469,0.773381294964029,0.776649746192893,0.895238095238095,0.762295081967213,0.191858407079646
E02003513,Aldrington South,Brighton and Hove,South East,1183,4119,322,331,203,437,5412,1165,4513,333,312,228,447,5833,840,269,256,203,393,1961,0.186128960779969,0.807807807807808,0.82051282051282,0.890350877192983,0.879194630872483,0.336190639465112
E02003514,Seven Dials,Brighton and Hove,South East,869,7934,250,185,127,195,8691,862,8542,286,234,125,163,9350,1053,219,183,110,143,1708,0.123273238117537,0.765734265734266,0.782051282051282,0.88,0.877300613496933,0.182673796791444
E02003515,Whitehawk,Brighton and Hove,South East,2075,5949,323,306,205,312,7095,2015,6986,368,343,202,290,8189,1629,262,291,185,250,2617,0.233180647008302,0.711956521739131,0.848396501457726,0.915841584158416,0.862068965517241,0.319575039687386
E02003516,Hove Central,Brighton and Hove,South East,808,7344,273,246,168,257,8288,927,7973,303,261,181,262,8980,1013,214,218,161,232,1838,0.127053806597266,0.706270627062706,0.835249042145594,0.889502762430939,0.885496183206107,0.20467706013363
E02003517,North Laine & the Lanes,Brighton and Hove,South East,1077,10713,288,252,146,196,11595,1034,13022,347,285,188,216,14058,1144,247,236,154,174,1955,0.0878513285209645,0.711815561959654,0.828070175438597,0.819148936170213,0.805555555555556,0.139066723573766
E02003518,King Alfred,Brighton and Hove,South East,962,5741,310,352,254,495,7152,917,6267,391,354,290,479,7781,966,303,284,249,415,2217,0.15414073719483,0.774936061381074,0.80225988700565,0.858620689655172,0.866388308977036,0.284924816861586
E02003519,Brunswick,Brighton and Hove,South East,692,8487,248,195,122,138,9190,753,9466,305,241,131,156,10299,1091,212,169,98,125,1695,0.115254595394042,0.695081967213115,0.701244813278008,0.748091603053435,0.801282051282051,0.164579085348092
E02003520,St James's Street & Queen's Park,Brighton and Hove,South East,1056,7374,310,265,180,236,8365,1087,9303,382,293,191,259,10428,1340,253,242,148,202,2185,0.144039557132108,0.662303664921466,0.825938566552901,0.774869109947644,0.77992277992278,0.209532029152282
E02003521,Kemptown,Brighton and Hove,South East,911,6127,360,321,270,413,7491,917,6669,365,369,251,428,8082,1364,271,320,228,356,2539,0.204528415054731,0.742465753424658,0.867208672086721,0.908366533864542,0.831775700934579,0.314154912150458
E02003522,Roedean & Marina,Brighton and Hove,South East,1087,5377,346,373,218,316,6630,1168,5850,396,403,251,304,7204,1264,319,346,217,270,2416,0.216068376068376,0.805555555555556,0.858560794044665,0.864541832669323,0.888157894736842,0.335369239311494
E02003523,Rottingdean & Saltdean,Brighton and Hove,South East,1477,5842,668,745,551,851,8657,1436,6198,747,756,633,910,9244,1177,626,679,590,812,3884,0.189899967731526,0.838018741633199,0.898148148148148,0.932069510268562,0.892307692307692,0.420164430982259
E02003524,Paulsgrove East,Portsmouth,South East,1844,4997,366,306,184,268,6121,1915,5611,368,352,217,244,6792,1297,311,311,196,222,2337,0.231153092140438,0.845108695652174,0.883522727272727,0.903225806451613,0.909836065573771,0.344081272084806
E02003525,Wymering,Portsmouth,South East,1520,4115,245,229,139,201,4929,1504,4692,267,250,157,196,5562,1298,223,223,142,177,2063,0.276641091219096,0.835205992509363,0.892,0.904458598726115,0.903061224489796,0.370909744696152
E02003526,Cosham North,Portsmouth,South East,1136,3628,430,479,347,697,5581,1093,3843,458,474,375,706,5856,1050,398,443,365,683,2939,0.273224043715847,0.868995633187773,0.934599156118144,0.973333333333333,0.967422096317281,0.501878415300546
E02003527,Paulsgrove West & Port Solent,Portsmouth,South East,1299,3877,282,345,226,299,5029,1252,4090,319,366,247,286,5308,913,270,343,231,268,2025,0.223227383863081,0.846394984326019,0.937158469945355,0.935222672064777,0.937062937062937,0.381499623210249
E02003529,Cosham South,Portsmouth,South East,1803,5187,335,375,219,385,6501,1719,5385,363,351,271,414,6784,1393,299,330,255,386,2663,0.258681522748375,0.823691460055096,0.94017094017094,0.940959409594096,0.932367149758454,0.392541273584906
E02003530,Hilsea,Portsmouth,South East,1638,4729,359,387,247,390,6112,1630,4929,402,378,261,350,6320,1117,342,343,250,330,2382,0.226617975248529,0.850746268656716,0.907407407407407,0.957854406130268,0.942857142857143,0.376898734177215
E02003531,Anchorage Park & Copnor,Portsmouth,South East,1241,5045,366,394,284,382,6471,1276,5281,419,409,300,397,6806,1196,392,386,286,369,2629,0.226472259041848,0.935560859188544,0.943765281173594,0.953333333333333,0.929471032745592,0.386276814575375
E02003532,Alexandra Park,Portsmouth,South East,1545,5058,297,301,195,221,6072,1574,5651,376,291,237,236,6791,1088,325,267,223,211,2114,0.192532295168997,0.86436170212766,0.917525773195876,0.940928270042194,0.894067796610169,0.311294360182595
E02003533,North End West & Whale Island,Portsmouth,South East,1212,3768,218,192,134,208,4520,1244,5215,225,215,172,205,6032,838,198,193,159,190,1578,0.160690316395014,0.88,0.897674418604651,0.924418604651163,0.926829268292683,0.261604774535809
E02003534,North End East,Portsmouth,South East,1972,5923,329,321,205,249,7027,1848,6289,376,345,238,260,7508,1258,322,324,216,237,2357,0.200031801558276,0.856382978723404,0.939130434782609,0.907563025210084,0.911538461538461,0.313931806073522
E02003535,Fratton North,Portsmouth,South East,2311,6622,279,276,148,228,7553,2216,7103,323,288,182,237,8133,1381,281,256,170,215,2303,0.194424890891173,0.869969040247678,0.888888888888889,0.934065934065934,0.907172995780591,0.28316734292389
E02003536,Landport,Portsmouth,South East,2022,5069,348,305,202,265,6189,2058,5900,346,326,220,261,7053,961,278,286,195,233,1953,0.162881355932203,0.803468208092486,0.877300613496933,0.886363636363636,0.89272030651341,0.276903445342407
E02003537,Baffins,Portsmouth,South East,2064,6590,465,473,289,454,8271,1987,7069,503,452,309,447,8780,1608,443,418,293,423,3185,0.227472061111897,0.880715705765408,0.924778761061947,0.948220064724919,0.946308724832215,0.362756264236902
E02003538,Fratton Kingston,Portsmouth,South East,2129,7438,288,283,184,240,8433,2275,8131,326,282,198,282,9219,1267,267,237,180,246,2197,0.155823391956709,0.819018404907976,0.840425531914894,0.909090909090909,0.872340425531915,0.238312181364573
E02003539,Fratton West & Portsea,Portsmouth,South East,2326,12803,384,331,260,318,14096,2414,18560,442,354,261,333,19950,1588,372,309,239,301,2809,0.0855603448275862,0.841628959276018,0.872881355932204,0.915708812260536,0.903903903903904,0.140802005012531
E02003540,Milton,Portsmouth,South East,1805,5995,383,523,401,586,7888,1833,6463,456,472,443,598,8432,1537,410,439,423,575,3384,0.237815256073031,0.899122807017544,0.930084745762712,0.954853273137697,0.961538461538461,0.401328273244782
E02003541,Somers Town,Portsmouth,South East,2145,9291,323,308,230,391,10543,2030,9306,339,319,229,384,10577,1022,264,273,211,347,2117,0.109821620459918,0.778761061946903,0.855799373040752,0.921397379912664,0.903645833333333,0.200151271627115
E02003542,Southsea Haslemere Road,Portsmouth,South East,1491,6975,258,258,162,258,7911,1444,6869,266,278,183,267,7863,1165,215,257,169,251,2057,0.169602562236133,0.808270676691729,0.924460431654676,0.923497267759563,0.940074906367041,0.261604985374539
E02003543,Southsea Fawcett Road,Portsmouth,South East,963,7085,263,206,122,215,7891,1044,7009,280,261,143,208,7901,960,229,234,126,189,1738,0.13696675702668,0.817857142857143,0.896551724137931,0.881118881118881,0.908653846153846,0.219972155423364
E02003544,Southsea Prince Albert Road,Portsmouth,South East,1260,4412,193,191,138,171,5105,1217,4770,209,202,137,191,5509,1049,181,189,125,178,1722,0.219916142557652,0.866028708133971,0.935643564356436,0.912408759124088,0.931937172774869,0.312579415501906
E02003545,Southsea West,Portsmouth,South East,885,5444,293,297,194,350,6578,743,5847,322,307,204,358,7038,865,253,261,190,326,1895,0.147939114075594,0.785714285714286,0.850162866449512,0.931372549019608,0.910614525139665,0.269252628587667
E02003546,Eastney,Portsmouth,South East,1587,5482,382,426,278,442,7010,1276,5598,449,420,332,452,7251,1248,395,382,313,431,2769,0.222936763129689,0.879732739420935,0.909523809523809,0.942771084337349,0.953539823008849,0.381878361605296
E02003547,Old Portsmouth & Southsea Common,Portsmouth,South East,1072,6617,401,489,338,610,8455,871,6833,409,512,350,619,8723,897,351,453,325,594,2620,0.13127469632665,0.858190709046455,0.884765625,0.928571428571429,0.959612277867528,0.300355382322595
E02003548,Southsea Waverley Road,Portsmouth,South East,993,4818,230,264,150,319,5781,819,5003,286,236,178,331,6034,899,245,214,162,296,1816,0.179692184689186,0.856643356643357,0.906779661016949,0.910112359550562,0.894259818731118,0.300961219754723
E02006821,Drayton & Farlington,Portsmouth,South East,1348,3893,290,360,281,403,5227,1316,4015,285,341,274,448,5363,1069,242,319,266,432,2328,0.266251556662516,0.849122807017544,0.935483870967742,0.970802919708029,0.964285714285714,0.434085399962707
E02003549,Bassett Green,Southampton,South East,1083,6691,334,309,238,344,7916,1177,8344,359,320,222,345,9590,1208,306,299,204,325,2342,0.144774688398849,0.852367688022284,0.934375,0.918918918918919,0.942028985507246,0.244212721584984
E02003550,Aldermoor & Lordswood,Southampton,South East,1672,4597,492,471,238,267,6065,1617,5356,477,474,293,279,6879,1688,411,444,274,260,3077,0.315160567587752,0.861635220125786,0.936708860759494,0.935153583617747,0.931899641577061,0.447303387120221
E02003551,Stoneham,Southampton,South East,1011,5074,243,252,169,215,5953,952,6668,251,269,180,207,7575,726,222,248,172,194,1562,0.108878224355129,0.884462151394422,0.921933085501859,0.955555555555556,0.93719806763285,0.206204620462046
E02003552,Coxford & Lords Hill,Southampton,South East,1169,3647,372,351,219,227,4816,1195,4325,368,385,239,254,5571,1266,289,354,223,240,2372,0.29271676300578,0.785326086956522,0.919480519480519,0.933054393305439,0.944881889763779,0.42577634176988
E02003553,Swaythling,Southampton,South East,1226,6054,227,163,99,143,6686,1307,7114,213,182,98,155,7762,823,170,156,91,143,1383,0.115687377003092,0.7981220657277,0.857142857142857,0.928571428571429,0.92258064516129,0.178175727905179
E02003554,Hollybrook,Southampton,South East,1004,3918,322,324,229,439,5232,969,4224,316,355,262,429,5586,1144,261,331,246,404,2386,0.270833333333333,0.825949367088608,0.932394366197183,0.938931297709924,0.941724941724942,0.427139276763337
E02003555,Maybush,Southampton,South East,1860,5064,403,310,229,309,6315,1908,5997,450,373,233,309,7362,1584,362,348,216,294,2804,0.264132066033017,0.804444444444444,0.932975871313673,0.927038626609442,0.951456310679612,0.380874762292855
E02003556,Townhill Park,Southampton,South East,1226,3531,262,281,212,322,4608,1179,3739,264,264,249,308,4824,721,223,250,239,292,1725,0.192832308103771,0.84469696969697,0.946969696969697,0.959839357429719,0.948051948051948,0.357587064676617
E02003557,Highfield & University,Southampton,South East,889,5156,230,292,213,345,6236,891,5535,252,289,227,362,6665,912,220,258,211,344,1945,0.164769647696477,0.873015873015873,0.892733564013841,0.929515418502203,0.950276243093923,0.291822955738935
E02003558,Shirley Warren,Southampton,South East,1613,4505,239,243,181,271,5439,1671,5505,254,250,198,255,6462,1439,180,217,180,231,2247,0.261398728428701,0.708661417322835,0.868,0.909090909090909,0.905882352941176,0.347725162488394
E02003559,Upper Shirley,Southampton,South East,1630,4776,402,363,227,436,6204,1587,5441,410,400,269,401,6921,1327,346,368,252,380,2673,0.243888990994303,0.84390243902439,0.92,0.936802973977695,0.947630922693267,0.386215864759428
E02003560,Redbridge & Millbrook West,Southampton,South East,1971,4541,306,197,158,263,5465,1937,5164,314,245,170,251,6144,1134,261,227,158,228,2008,0.219597211463981,0.831210191082803,0.926530612244898,0.929411764705882,0.908366533864542,0.326822916666667
E02003561,St Denys,Southampton,South East,1072,6622,223,232,153,281,7511,1008,6857,260,229,173,277,7796,884,215,206,152,256,1713,0.12891935248651,0.826923076923077,0.899563318777293,0.878612716763006,0.924187725631769,0.219728065674705
E02003562,Bitterne West,Southampton,South East,1757,5502,300,338,241,353,6734,1568,5707,359,322,253,352,6993,993,298,288,235,333,2147,0.173996845978623,0.83008356545961,0.894409937888199,0.928853754940711,0.946022727272727,0.307021307021307
E02003563,Shirley South,Southampton,South East,1665,4906,299,285,240,425,6155,1735,5768,321,297,238,386,7010,1257,246,276,214,358,2351,0.217926490984743,0.766355140186916,0.929292929292929,0.899159663865546,0.927461139896373,0.335378031383738
E02003564,Bitterne East,Southampton,South East,1688,4553,345,364,273,447,5982,1697,5148,368,367,279,460,6622,871,289,337,272,444,2213,0.169191919191919,0.785326086956522,0.918256130790191,0.974910394265233,0.965217391304348,0.334189066747206
E02003565,Bevois Town,Southampton,South East,679,6345,115,130,76,173,6839,818,6344,155,139,97,165,6900,771,107,114,87,150,1229,0.121532156368222,0.690322580645161,0.820143884892086,0.896907216494845,0.909090909090909,0.178115942028986
E02003566,Harefield,Southampton,South East,1263,3560,312,344,225,385,4826,1304,4104,360,331,257,372,5424,757,278,305,239,351,1930,0.184454191033138,0.772222222222222,0.921450151057402,0.929961089494163,0.943548387096774,0.355825958702065
E02003567,Regents Park & Millbrook East,Southampton,South East,1902,4803,310,261,160,239,5773,1886,5747,361,283,215,215,6821,1196,297,262,196,195,2146,0.208108578388725,0.822714681440443,0.925795053003534,0.911627906976744,0.906976744186047,0.31461662512828
E02003568,Banister Park & Howard Road,Southampton,South East,1283,6896,271,195,124,228,7714,1235,7431,300,212,200,230,8373,1118,234,186,177,212,1927,0.15045081415691,0.78,0.877358490566038,0.885,0.921739130434783,0.230144512122298
E02003569,Freemantle,Southampton,South East,1433,5802,280,225,109,162,6578,1372,6201,283,209,157,181,7031,1027,209,181,148,167,1732,0.165618448637317,0.738515901060071,0.866028708133971,0.942675159235669,0.922651933701657,0.246337647560802
E02003570,Newtown & Nicholstown,Southampton,South East,2536,9216,167,122,90,86,9681,2695,12257,255,163,85,129,12889,861,142,123,65,108,1299,0.0702455739577384,0.556862745098039,0.754601226993865,0.764705882352941,0.837209302325582,0.100783613934363
E02003571,Central Southampton West,Southampton,South East,670,9765,148,120,117,289,10439,778,8738,170,152,123,266,9449,766,114,126,110,244,1360,0.0876630807965209,0.670588235294118,0.828947368421053,0.894308943089431,0.917293233082707,0.143930574663986
E02003572,Bitterne South,Southampton,South East,1309,3700,287,297,204,303,4791,1192,4152,326,293,220,326,5317,691,245,274,211,301,1722,0.166425818882466,0.751533742331288,0.935153583617747,0.959090909090909,0.923312883435583,0.323866842204251
E02003573,Thornhill,Southampton,South East,1711,4406,359,355,263,442,5825,1781,5142,374,354,290,426,6586,843,277,323,272,407,2122,0.163943990665111,0.740641711229947,0.912429378531073,0.937931034482759,0.955399061032864,0.32219860309748
E02003574,Sholing East,Southampton,South East,1307,4435,395,483,310,407,6030,1278,4863,407,464,376,401,6511,821,327,440,351,381,2320,0.168825827678388,0.803439803439803,0.948275862068965,0.933510638297872,0.950124688279302,0.356320073721395
E02003575,Hightown,Southampton,South East,1754,3879,255,269,192,236,4831,1706,4366,252,236,211,232,5297,625,196,214,202,213,1450,0.143151626202474,0.777777777777778,0.906779661016949,0.957345971563981,0.918103448275862,0.273739852746838
E02003576,Itchen,Southampton,South East,1805,5259,312,279,232,244,6326,1716,5779,339,318,221,292,6949,965,245,299,208,268,1985,0.166983907250389,0.722713864306785,0.940251572327044,0.941176470588235,0.917808219178082,0.285652611886602
E02003577,Central Southampton East,Southampton,South East,2002,11380,276,221,143,179,12199,2116,14021,367,246,164,178,14976,1041,242,191,133,146,1753,0.0742457741958491,0.659400544959128,0.776422764227642,0.810975609756098,0.820224719101124,0.117053952991453
E02003578,Sholing West,Southampton,South East,1143,3878,291,267,217,270,4923,1134,4252,329,288,229,275,5373,753,271,275,217,263,1779,0.177093132643462,0.82370820668693,0.954861111111111,0.947598253275109,0.956363636363636,0.331099944165271
E02003579,Woolston,Southampton,South East,1835,5865,361,343,241,447,7257,1797,6689,406,359,264,429,8147,1188,306,321,244,382,2441,0.177605023172373,0.753694581280788,0.894150417827298,0.924242424242424,0.89044289044289,0.299619491837486
E02003580,Weston,Southampton,South East,1573,3580,270,249,146,185,4430,1597,4130,275,250,166,179,5000,752,202,227,148,165,1494,0.182082324455206,0.734545454545455,0.908,0.891566265060241,0.921787709497207,0.2988
E02003581,Cowes Central,Isle of Wight,South East,1388,4878,412,454,292,461,6497,1334,5039,445,451,369,462,6766,1376,396,416,346,437,2971,0.27307005358206,0.889887640449438,0.922394678492239,0.937669376693767,0.945887445887446,0.439107301211942
E02003582,"Cowes West, Gurnard & Northwood",Isle of Wight,South East,1492,4795,577,654,463,627,7116,1439,5135,536,644,509,630,7454,1579,493,604,492,590,3758,0.307497565725414,0.919776119402985,0.937888198757764,0.966601178781925,0.936507936507937,0.504158840890797
E02003583,East Cowes & Osborne,Isle of Wight,South East,1255,4134,546,649,412,438,6179,1309,4320,546,641,518,452,6477,1292,496,602,496,430,3316,0.299074074074074,0.908424908424908,0.939157566302652,0.957528957528958,0.951327433628319,0.511965416087695
E02003584,Ryde Central,Isle of Wight,South East,816,4212,418,451,252,319,5652,761,4262,426,430,280,362,5760,979,335,377,253,330,2274,0.229704364148287,0.786384976525822,0.876744186046512,0.903571428571429,0.911602209944751,0.394791666666667
E02003585,Binstead & Wootton,Isle of Wight,South East,893,3464,592,664,516,653,5889,868,3596,549,648,563,677,6033,1030,485,618,532,639,3304,0.28642936596218,0.883424408014572,0.953703703703704,0.9449378330373,0.943870014771049,0.547654566550638
E02003586,Ryde West & Havenstreet,Isle of Wight,South East,1467,4419,503,544,429,506,6401,1340,4786,526,566,436,569,6883,1188,450,524,412,539,3113,0.248223986627664,0.855513307984791,0.925795053003534,0.944954128440367,0.947275922671353,0.452273717855586
E02003587,Ryde South,Isle of Wight,South East,1802,5275,490,484,318,400,6967,1740,5535,476,505,361,425,7302,1226,387,475,340,387,2815,0.221499548328817,0.813025210084034,0.940594059405941,0.941828254847645,0.910588235294118,0.385510818953711
E02003588,Newport East & Parkhurst East,Isle of Wight,South East,1533,5090,512,459,361,482,6904,1655,5718,526,492,399,520,7655,1707,441,452,375,475,3450,0.298530954879328,0.838403041825095,0.91869918699187,0.93984962406015,0.913461538461539,0.450685826257348
E02003589,Newport Central & Parkhurst West,Isle of Wight,South East,1463,5368,373,318,261,350,6670,1467,4990,356,372,270,342,6330,1480,298,342,242,319,2681,0.296593186372746,0.837078651685393,0.919354838709677,0.896296296296296,0.932748538011696,0.423538704581359
E02003590,Bembridge & Nettlestone,Isle of Wight,South East,866,3494,665,899,579,957,6594,897,3625,707,822,664,980,6798,1031,621,769,634,945,4000,0.284413793103448,0.878359264497878,0.935523114355231,0.954819277108434,0.964285714285714,0.588408355398647
E02003591,Newport South & West,Isle of Wight,South East,1822,5555,543,641,454,603,7796,1657,5832,559,624,494,649,8158,1726,453,581,469,619,3848,0.295953360768176,0.810375670840787,0.931089743589744,0.949392712550607,0.953775038520801,0.471684236332435
E02003592,Yarmouth & Freshwater,Isle of Wight,South East,1064,4554,972,1044,773,1080,8423,1082,4968,949,1080,853,1167,9017,1905,882,1047,822,1111,5767,0.383454106280193,0.929399367755532,0.969444444444444,0.963657678780774,0.952013710368466,0.639569701674615
E02003593,Brighstone & Shalfleet,Isle of Wight,South East,647,2811,502,523,327,459,4622,619,2930,527,503,420,476,4856,947,468,483,403,455,2756,0.32320819112628,0.888045540796964,0.960238568588469,0.959523809523809,0.955882352941176,0.567545304777595
E02003594,Sandown & Brading,Isle of Wight,South East,1467,5381,687,693,473,729,7963,1390,5650,749,705,538,715,8357,1474,617,651,515,660,3917,0.260884955752212,0.823765020026702,0.923404255319149,0.95724907063197,0.923076923076923,0.468708866818236
E02003595,Shanklin West & Newchurch,Isle of Wight,South East,999,4127,713,789,579,699,6907,1031,4443,782,805,655,761,7446,1212,667,772,638,724,4013,0.272788656313302,0.852941176470588,0.959006211180124,0.974045801526718,0.95137976346912,0.538947085683589
E02003596,Shanklin Central & Lake,Isle of Wight,South East,1248,4901,773,737,508,782,7701,1214,5170,787,773,588,732,8050,1296,622,721,555,676,3870,0.250676982591876,0.790343074968234,0.932729624838292,0.943877551020408,0.923497267759563,0.480745341614907
E02003597,"Niton, Shorwell & Godshill",Isle of Wight,South East,802,3082,509,574,327,445,4937,795,3300,499,590,376,462,5227,886,439,551,359,433,2668,0.268484848484849,0.879759519038076,0.933898305084746,0.954787234042553,0.937229437229437,0.510426630954659
E02003598,Ventnor & Wroxall,Isle of Wight,South East,997,4024,680,765,480,583,6532,1009,4277,640,755,535,606,6813,956,488,696,496,567,3203,0.223521159691372,0.7625,0.921854304635762,0.927102803738318,0.935643564356436,0.47013063261412
E02003652,"Buckingham South, Maids Moreton & Akeley",Buckinghamshire,South East,2524,7069,478,445,301,415,8708,2334,7346,527,464,349,461,9147,982,487,445,337,436,2687,0.13367819221345,0.924098671726755,0.959051724137931,0.965616045845272,0.945770065075922,0.293757516125506
E02003653,Buckingham North,Buckinghamshire,South East,1241,4355,316,354,248,361,5634,1278,5607,364,369,261,394,6995,715,337,341,250,372,2015,0.127519172462993,0.925824175824176,0.924119241192412,0.957854406130268,0.944162436548223,0.288062902072909
E02003654,Newton Longville & Great Horwood,Buckinghamshire,South East,1034,3420,425,408,230,293,4776,966,3565,397,405,292,270,4929,604,369,388,287,259,1907,0.169424964936886,0.929471032745592,0.958024691358025,0.982876712328767,0.959259259259259,0.386893893284642
E02003655,"Marsh Gibbon, Steeple Claydon & Tingewick",Buckinghamshire,South East,2021,6140,583,611,382,400,8116,1989,6712,602,646,400,457,8817,1068,545,605,380,434,3032,0.15911799761621,0.90531561461794,0.936532507739938,0.95,0.949671772428884,0.343881138709312
E02003656,Winslow & Padbury,Buckinghamshire,South East,1050,3741,384,423,288,456,5292,1071,3902,401,406,320,442,5471,787,366,387,313,424,2277,0.201691440287032,0.912718204488778,0.95320197044335,0.978125,0.959276018099547,0.416194479985377
E02003657,"Granborough, Stewkley & Great Brickhill",Buckinghamshire,South East,1321,4059,421,435,250,342,5507,1407,4524,472,466,295,385,6142,861,427,442,288,368,2386,0.190318302387268,0.904661016949153,0.948497854077253,0.976271186440678,0.955844155844156,0.388472810159557
E02003658,"Wing, Wingrave & Bierton",Buckinghamshire,South East,1923,5149,541,502,331,468,6991,1934,5907,484,579,384,479,7833,1222,441,553,371,458,3045,0.206873201286609,0.911157024793388,0.955094991364421,0.966145833333333,0.95615866388309,0.388739946380697
E02003659,Waddesdon & Whitchurch,Buckinghamshire,South East,2210,6285,445,453,309,343,7835,2119,6177,439,482,340,393,7831,1302,412,462,329,381,2886,0.210781932977173,0.938496583143508,0.95850622406639,0.967647058823529,0.969465648854962,0.368535308389733
E02003660,"Cheddington, Pitstone & Edlesborough",Buckinghamshire,South East,1978,6334,586,600,372,478,8370,2000,6741,604,623,439,514,8921,1167,552,598,416,485,3218,0.17311971517579,0.913907284768212,0.959871589085072,0.947608200455581,0.943579766536965,0.360721892164556
E02003661,"Oakley, Brill & Edgcott",Buckinghamshire,South East,1126,3794,354,309,207,295,4959,1005,3974,372,310,216,273,5145,782,326,299,208,260,1875,0.19677906391545,0.876344086021505,0.964516129032258,0.962962962962963,0.952380952380952,0.364431486880466
E02003662,Watermead & Elmhurst,Buckinghamshire,South East,1301,4545,256,205,189,209,5404,1179,4489,259,219,173,241,5381,888,212,201,158,209,1668,0.19781688572065,0.818532818532819,0.917808219178082,0.913294797687861,0.867219917012448,0.309979557703029
E02003663,Berryfields & Haydon Hill,Buckinghamshire,South East,3720,8074,283,202,165,192,8916,3933,9113,343,255,154,204,10069,1629,262,219,132,177,2419,0.178755623834083,0.763848396501458,0.858823529411765,0.857142857142857,0.867647058823529,0.240242327937233
E02003664,Gatehouse,Buckinghamshire,South East,2235,5636,233,234,133,337,6573,1978,5503,248,243,143,297,6434,947,196,212,123,256,1734,0.172087952026168,0.790322580645161,0.872427983539095,0.86013986013986,0.861952861952862,0.269505750699409
E02003665,Victoria Park,Buckinghamshire,South East,1262,4033,228,260,153,248,4922,1214,4155,210,253,168,241,5027,851,185,231,157,224,1648,0.204813477737665,0.880952380952381,0.91304347826087,0.934523809523809,0.929460580912863,0.327829719514621
E02003666,Aylesbury Central,Buckinghamshire,South East,1648,5727,263,229,164,359,6742,1512,5482,290,238,185,325,6520,979,225,219,172,284,1879,0.178584458226924,0.775862068965517,0.920168067226891,0.92972972972973,0.873846153846154,0.28819018404908
E02003667,Fairford Leys,Buckinghamshire,South East,2009,6773,377,302,164,209,7825,1889,6123,366,317,197,199,7202,1194,316,296,180,175,2161,0.19500244977952,0.863387978142077,0.933753943217665,0.913705583756345,0.879396984924623,0.300055540127742
E02003668,Bedgrove & Walton,Buckinghamshire,South East,1714,5210,471,497,402,713,7293,1636,5352,466,516,429,721,7484,1300,430,493,411,687,3321,0.242899850523169,0.92274678111588,0.955426356589147,0.958041958041958,0.952843273231623,0.443746659540353
E02003669,California & Southcourt,Buckinghamshire,South East,1941,5201,281,211,160,168,6021,1842,5225,280,219,150,202,6076,912,225,182,136,156,1611,0.174545454545455,0.803571428571429,0.831050228310502,0.906666666666667,0.772277227722772,0.265141540487163
E02003670,Mandeville & Elm Farm,Buckinghamshire,South East,1967,6543,451,399,258,368,8019,1786,6226,449,403,274,373,7725,1653,392,383,249,339,3016,0.265499518149695,0.873051224944321,0.950372208436725,0.908759124087591,0.908847184986595,0.39042071197411
E02003671,Walton Court & Hawkslade,Buckinghamshire,South East,1402,4164,273,182,104,98,4821,1329,4134,251,224,125,116,4850,837,210,206,115,95,1463,0.202467343976778,0.836653386454183,0.919642857142857,0.92,0.818965517241379,0.301649484536082
E02003672,Stoke Mandeville & Aston Clinton,Buckinghamshire,South East,2055,6348,629,674,456,659,8766,2240,7174,702,724,533,632,9765,1615,636,700,505,602,4058,0.225118483412322,0.905982905982906,0.966850828729282,0.947467166979362,0.95253164556962,0.415565796210958
E02003673,"Haddenham, Dinton & Stone",Buckinghamshire,South East,1616,5046,537,637,472,664,7356,1730,5585,523,665,500,686,7959,1251,473,627,483,646,3480,0.223992837958818,0.904397705544933,0.942857142857143,0.966,0.941690962099125,0.437240859404448
E02003674,"Worminghall, Long Crendon & Cuddington",Buckinghamshire,South East,1082,3105,348,379,283,290,4405,1030,3303,367,396,297,324,4687,651,310,376,289,307,1933,0.197093551316985,0.844686648501362,0.949494949494949,0.973063973063973,0.947530864197531,0.412417324514615
E02003675,Wendover,Buckinghamshire,South East,2030,5704,428,432,369,625,7558,1833,6066,419,444,386,553,7868,1082,358,421,364,526,2751,0.178371249587867,0.854415274463007,0.948198198198198,0.94300518134715,0.951175406871609,0.349644128113879
E02003676,"Hyde Heath, Bellingdon & Latimer",Buckinghamshire,South East,1387,4585,503,528,398,531,6545,1421,5113,529,576,448,556,7222,930,463,554,428,527,2902,0.181889301779777,0.87523629489603,0.961805555555556,0.955357142857143,0.947841726618705,0.401827748546109
E02003677,Chesham West,Buckinghamshire,South East,2296,6178,456,449,323,490,7896,2279,6907,457,467,344,488,8663,1360,362,442,320,460,2944,0.19690169393369,0.792122538293217,0.946466809421842,0.930232558139535,0.942622950819672,0.339836084497287
E02003678,Chesham East,Buckinghamshire,South East,1226,3470,286,261,197,366,4580,1146,3922,302,290,202,362,5078,799,259,270,194,346,1868,0.203722590515043,0.857615894039735,0.931034482758621,0.96039603960396,0.955801104972376,0.367861362741237
E02003679,Chesham South,Buckinghamshire,South East,1467,4390,270,297,245,397,5599,1296,4824,286,289,233,398,6030,836,212,260,220,379,1907,0.173300165837479,0.741258741258741,0.899653979238754,0.944206008583691,0.952261306532663,0.316252072968491
E02003680,Great Missenden & Prestwood,Buckinghamshire,South East,1817,5398,544,632,491,722,7787,1792,5996,563,648,537,766,8510,1074,500,624,523,721,3442,0.179119412941961,0.88809946714032,0.962962962962963,0.973929236499069,0.941253263707572,0.404465334900118
E02003681,Amersham-on-the-Hill & Chesham Bois,Buckinghamshire,South East,2456,5912,484,548,399,835,8178,2248,6563,514,507,482,786,8852,1105,447,474,461,758,3245,0.168368124333384,0.869649805447471,0.93491124260355,0.95643153526971,0.964376590330789,0.366583822864889
E02003682,Old Amersham,Buckinghamshire,South East,1638,4558,345,426,288,357,5974,1567,4917,386,419,315,437,6474,831,352,395,295,419,2292,0.169005491153142,0.911917098445596,0.94272076372315,0.936507936507937,0.958810068649886,0.354031510658017
E02003683,Little Chalfont,Buckinghamshire,South East,1594,4198,358,350,267,484,5657,1531,4523,326,362,283,425,5919,876,282,332,277,410,2177,0.193676763210259,0.865030674846626,0.917127071823204,0.978798586572438,0.964705882352941,0.36779861463085
E02003685,"Chalfont St Giles, Seer Green & Jordans",Buckinghamshire,South East,1646,4533,420,480,350,556,6339,1629,5109,458,503,362,540,6972,861,415,472,339,504,2591,0.168526130358191,0.906113537117904,0.938369781312127,0.93646408839779,0.933333333333333,0.371629374641423
E02003686,Chalfont Common & St Peter East,Buckinghamshire,South East,1377,4159,380,435,335,687,5996,1350,4779,408,454,399,666,6706,967,374,435,385,637,2798,0.202343586524378,0.916666666666667,0.958149779735683,0.964912280701754,0.956456456456456,0.417238294065016
E02003687,Chalfont St Peter West,Buckinghamshire,South East,1278,3303,288,281,209,467,4548,1245,3756,317,306,221,378,4978,685,288,283,215,347,1818,0.182374866879659,0.908517350157729,0.92483660130719,0.972850678733032,0.917989417989418,0.365206910405786
E02003688,Beaconsfield Town,Buckinghamshire,South East,2739,7376,580,590,476,991,10013,2617,8072,572,578,480,970,10672,1030,492,524,450,897,3393,0.127601585728444,0.86013986013986,0.906574394463668,0.9375,0.924742268041237,0.317934782608696
E02003689,Gerrards Cross,Buckinghamshire,South East,1846,5263,450,502,358,703,7276,1895,6184,517,517,362,702,8282,1232,454,460,325,651,3122,0.199223803363519,0.878143133462282,0.889748549323018,0.897790055248619,0.927350427350427,0.376962086452548
E02003690,Denham,Buckinghamshire,South East,1121,4040,357,366,328,675,5766,1200,4773,401,401,336,630,6541,1008,349,373,313,586,2629,0.211187932118165,0.870324189526185,0.930174563591022,0.931547619047619,0.93015873015873,0.401926310961627
E02003691,Farnham & Hedgerley,Buckinghamshire,South East,1369,3988,336,418,278,519,5539,1351,4448,394,417,316,549,6124,688,359,386,294,518,2245,0.154676258992806,0.911167512690355,0.925659472422062,0.930379746835443,0.943533697632058,0.366590463749184
E02003692,Stoke Poges & George Green,Buckinghamshire,South East,1659,5433,483,503,352,557,7328,1598,5839,518,485,369,585,7796,1152,472,447,345,549,2965,0.197294057201576,0.911196911196911,0.921649484536082,0.934959349593496,0.938461538461539,0.380323242688558
E02003693,"Burham North, Taplow & Dorney",Buckinghamshire,South East,1078,3938,439,401,346,517,5641,1190,4410,462,453,370,522,6217,773,403,420,346,486,2428,0.175283446712018,0.872294372294372,0.927152317880795,0.935135135135135,0.931034482758621,0.390542062087824
E02003694,Burnham South,Buckinghamshire,South East,1689,4895,406,338,257,385,6281,1642,5411,392,372,251,434,6860,1184,341,342,236,406,2509,0.218813527998522,0.869897959183674,0.919354838709677,0.940239043824701,0.935483870967742,0.365743440233236
E02003695,Iver & Richings Park,Buckinghamshire,South East,2134,6972,569,492,371,557,8961,2013,7126,598,530,355,510,9119,1278,534,485,330,450,3077,0.179343250070166,0.892976588628762,0.915094339622642,0.929577464788732,0.882352941176471,0.337427349490076
E02003696,Princes Risborough,Buckinghamshire,South East,1331,4200,527,613,429,851,6620,1377,4933,502,606,500,839,7380,970,405,569,485,820,3249,0.196634907764038,0.806772908366534,0.938943894389439,0.97,0.977353992848629,0.440243902439024
E02003697,"Longwick, Kimble & Lacey Green",Buckinghamshire,South East,1044,3224,375,402,310,414,4725,1087,3646,398,415,329,441,5229,733,350,397,314,420,2214,0.201042238069117,0.879396984924623,0.956626506024096,0.954407294832827,0.952380952380952,0.423407917383821
E02003698,Walter's Ash & Hughenden Valley,Buckinghamshire,South East,1420,4509,492,614,471,575,6661,1381,4908,508,616,466,581,7079,871,453,589,451,556,2920,0.177465362673187,0.891732283464567,0.956168831168831,0.967811158798283,0.95697074010327,0.412487639497104
E02003699,Stokenchurch,Buckinghamshire,South East,1086,3228,366,327,243,333,4497,1100,3590,353,341,249,336,4869,785,317,324,238,321,1985,0.21866295264624,0.898016997167139,0.950146627565982,0.955823293172691,0.955357142857143,0.407681248716369
E02003701,Downley,Buckinghamshire,South East,2504,7050,450,518,393,548,8959,2461,7923,485,510,455,641,10014,1226,400,473,433,605,3137,0.154739366401616,0.824742268041237,0.927450980392157,0.951648351648352,0.94383775351014,0.313261433992411
E02003702,"Bledlow, Cadmore End & Hambleden Valley",Buckinghamshire,South East,1371,4908,460,503,364,418,6653,1282,6028,474,468,372,445,7787,817,414,446,353,424,2454,0.135534173855342,0.873417721518987,0.952991452991453,0.948924731182796,0.952808988764045,0.315140618980352
E02003703,Terriers & Amersham Hill,Buckinghamshire,South East,1853,5486,339,248,209,259,6541,1860,6253,386,263,233,295,7430,834,315,240,214,259,1862,0.133375979529826,0.816062176165803,0.91254752851711,0.918454935622318,0.877966101694915,0.250605652759085
E02003704,Tylers Green,Buckinghamshire,South East,1135,3321,355,332,227,274,4509,1116,3742,364,349,264,299,5018,499,327,338,254,281,1699,0.133351149118119,0.898351648351648,0.968481375358166,0.962121212121212,0.939799331103679,0.33858110801116
E02003705,Bowerdean,Buckinghamshire,South East,1591,4572,235,168,145,188,5308,1694,5334,285,192,124,223,6158,707,198,151,102,170,1328,0.13254593175853,0.694736842105263,0.786458333333333,0.82258064516129,0.762331838565022,0.215654433257551
E02003706,Totteridge,Buckinghamshire,South East,1560,4374,255,225,201,272,5327,1446,4544,265,243,167,286,5505,607,208,214,159,254,1442,0.133582746478873,0.784905660377359,0.880658436213992,0.952095808383234,0.888111888111888,0.261943687556767
E02003707,Sands,Buckinghamshire,South East,1604,4628,208,192,110,213,5351,1477,4741,232,226,113,173,5485,621,182,199,101,147,1250,0.130985024256486,0.78448275862069,0.880530973451327,0.893805309734513,0.84971098265896,0.227894257064722
E02003708,Oakridge & Castlefield,Buckinghamshire,South East,2593,6422,282,136,123,202,7165,2576,7883,316,163,120,236,8718,924,214,125,94,173,1530,0.117214258531016,0.677215189873418,0.766871165644172,0.783333333333333,0.733050847457627,0.175498967653131
E02003709,Micklefield,Buckinghamshire,South East,1456,3558,180,143,130,200,4211,1385,3889,231,158,129,195,4602,545,171,142,111,174,1143,0.140138853175624,0.74025974025974,0.89873417721519,0.86046511627907,0.892307692307692,0.248370273794003
E02003710,Town Centre & Marlow Hill,Buckinghamshire,South East,2817,7640,386,311,255,386,8978,2943,9226,402,341,260,414,10643,1296,330,313,240,359,2538,0.140472577498374,0.82089552238806,0.917888563049853,0.923076923076923,0.867149758454106,0.238466597763788
E02003711,Ryemead & Wycombe Marsh,Buckinghamshire,South East,2112,6310,333,354,228,334,7559,2047,6326,358,328,216,321,7549,904,284,292,194,275,1949,0.142902307935504,0.793296089385475,0.890243902439024,0.898148148148148,0.856697819314642,0.258179891376341
E02003712,Lane End & Booker,Buckinghamshire,South East,1524,4470,445,469,307,604,6295,1510,5190,429,479,345,558,7001,866,353,435,325,520,2499,0.166859344894027,0.822843822843823,0.908141962421712,0.942028985507246,0.931899641577061,0.356949007284674
E02003713,Flackwell Heath,Buckinghamshire,South East,1145,3143,366,346,284,518,4657,1094,3484,372,343,292,506,4997,558,324,328,284,469,1963,0.1601607347876,0.870967741935484,0.956268221574344,0.972602739726027,0.926877470355731,0.392835701420853
E02003714,Loudwater & Wooburn Green,Buckinghamshire,South East,1373,3979,347,298,243,280,5147,1350,4354,395,328,270,285,5632,662,328,306,246,256,1798,0.152044097381718,0.830379746835443,0.932926829268293,0.911111111111111,0.898245614035088,0.319247159090909
E02003715,"Marlow Bottom, Danesfield & Well End",Buckinghamshire,South East,1298,3489,417,474,330,373,5083,1312,3961,446,454,357,367,5585,538,403,414,335,347,2037,0.135824286796264,0.903587443946188,0.911894273127753,0.938375350140056,0.94550408719346,0.364726947179946
E02003716,Bourne End,Buckinghamshire,South East,914,3063,354,362,298,480,4557,890,3310,353,373,304,455,4795,467,303,344,292,423,1829,0.141087613293051,0.858356940509915,0.92225201072386,0.960526315789474,0.92967032967033,0.381438998957247
E02003717,Marlow West & North,Buckinghamshire,South East,1851,4734,480,532,457,776,6979,1836,5518,523,570,475,729,7815,759,469,542,450,693,2913,0.137549836897427,0.896749521988528,0.950877192982456,0.947368421052632,0.950617283950617,0.37274472168906
E02003718,Marlow East,Buckinghamshire,South East,1237,3177,283,309,206,387,4362,1192,3677,305,293,241,367,4883,459,269,281,228,345,1582,0.124830024476475,0.881967213114754,0.959044368600683,0.946058091286307,0.940054495912807,0.32398115912349
E02006823,Knotty Green & Holmer Green,Buckinghamshire,South East,1700,4782,544,577,417,745,7065,1688,5352,575,599,493,742,7761,782,517,573,473,693,3038,0.146113602391629,0.899130434782609,0.956594323873122,0.959432048681542,0.933962264150943,0.391444401494653
E02006824,Hazlemere,Buckinghamshire,South East,1894,5162,523,606,491,629,7411,1797,5867,541,570,497,687,8162,946,493,545,478,650,3112,0.161240838588717,0.911275415896488,0.956140350877193,0.961770623742455,0.946142649199418,0.38127909826023
E02004356,Langney West,Eastbourne,South East,1559,4523,373,383,256,369,5904,1528,4991,394,366,294,371,6416,1622,343,346,282,332,2925,0.324984972951312,0.870558375634518,0.945355191256831,0.959183673469388,0.894878706199461,0.455891521197008
E02004357,Hampden Park North,Eastbourne,South East,1837,4663,411,429,225,295,6023,1755,5116,404,428,255,298,6501,1593,343,396,232,263,2827,0.31137607505864,0.849009900990099,0.925233644859813,0.909803921568627,0.88255033557047,0.434856175972927
E02004358,Langney East,Eastbourne,South East,1557,4223,497,618,409,695,6442,1605,4655,505,580,429,675,6844,1433,438,550,403,628,3452,0.307841031149302,0.867326732673267,0.948275862068965,0.939393939393939,0.93037037037037,0.504383401519579
E02004359,Hampden Park South,Eastbourne,South East,1342,4435,491,585,403,843,6757,1315,4751,479,553,443,757,6983,1655,423,512,426,694,3710,0.348347716270259,0.883089770354906,0.925858951175407,0.961625282167043,0.916776750330251,0.531290276385508
E02004361,Ratton,Eastbourne,South East,1622,4482,488,521,386,669,6546,1587,4891,473,517,398,644,6923,1787,424,477,383,590,3661,0.365364956041709,0.896405919661734,0.922630560928433,0.962311557788945,0.916149068322981,0.528816986855409
E02004362,Roselands,Eastbourne,South East,1842,5513,440,406,290,470,7119,1780,6020,420,457,302,432,7631,1881,343,423,286,387,3320,0.312458471760797,0.816666666666667,0.925601750547046,0.947019867549669,0.895833333333333,0.435067487878391
E02004363,Upperton,Eastbourne,South East,872,4059,431,440,357,820,6107,980,4290,390,466,368,741,6255,1536,320,412,345,658,3271,0.358041958041958,0.82051282051282,0.88412017167382,0.9375,0.887989203778677,0.522941646682654
E02004364,Old Town & Motcombe,Eastbourne,South East,1426,4547,539,576,369,797,6828,1371,4951,528,604,415,716,7214,1867,462,551,376,662,3918,0.377095536255302,0.875,0.912251655629139,0.906024096385542,0.924581005586592,0.543110618242307
E02004365,Pier,Eastbourne,South East,1453,6035,307,231,149,217,6939,1532,7137,336,263,127,222,8085,1730,223,205,107,182,2447,0.242398766988931,0.663690476190476,0.779467680608365,0.84251968503937,0.81981981981982,0.302659245516388
E02004366,King Edward's Parade,Eastbourne,South East,931,4719,452,508,347,950,6976,979,5085,410,512,388,892,7287,1234,328,449,348,821,3180,0.24267453294002,0.8,0.876953125,0.896907216494845,0.920403587443946,0.436393577603952
E02004367,Meads,Eastbourne,South East,773,3365,548,742,578,1326,6559,735,3452,557,687,621,1183,6500,1163,489,639,575,1091,3957,0.336906141367323,0.877917414721724,0.930131004366812,0.925925925925926,0.922231614539307,0.608769230769231
E02006857,St Anthony's Hill,Eastbourne,South East,1607,5003,540,722,431,655,7351,1705,5436,543,664,493,666,7802,1558,467,621,462,608,3716,0.286607799852833,0.860036832412523,0.935240963855422,0.937119675456389,0.912912912912913,0.476288131248398
E02006858,Sovereign Harbour,Eastbourne,South East,1112,4224,595,676,386,380,6261,1065,4221,555,628,449,417,6270,1152,488,568,408,375,2991,0.272921108742004,0.879279279279279,0.904458598726115,0.908685968819599,0.899280575539568,0.477033492822967
E02004368,Ashdown,Hastings,South East,1614,5246,467,562,290,350,6915,1611,5423,511,481,321,368,7104,1301,347,446,296,336,2726,0.239904112115065,0.679060665362035,0.927234927234927,0.922118380062305,0.91304347826087,0.383727477477478
E02004369,Conquest & St Helens,Hastings,South East,1397,5016,716,935,637,989,8293,1433,5577,724,910,691,1002,8904,1496,547,842,656,912,4453,0.268244575936884,0.755524861878453,0.925274725274725,0.949348769898697,0.910179640718563,0.500112309074573
E02004370,Hollington,Hastings,South East,1867,4813,414,385,226,304,6142,1987,5495,434,407,271,263,6870,1174,254,354,234,215,2231,0.213648771610555,0.585253456221198,0.86977886977887,0.863468634686347,0.817490494296578,0.324745269286754
E02004371,Ore,Hastings,South East,1511,4326,411,381,223,326,5667,1620,4601,422,389,277,289,5978,1098,326,360,250,259,2293,0.238643773092806,0.772511848341232,0.925449871465296,0.902527075812274,0.896193771626298,0.383573101371696
E02004372,Broomgrove,Hastings,South East,1971,4438,295,288,149,231,5401,1963,4934,328,279,166,244,5951,1036,208,237,148,212,1841,0.209971625456019,0.634146341463415,0.849462365591398,0.891566265060241,0.868852459016394,0.30935977146698
E02004373,Silverhill,Hastings,South East,1721,5375,478,526,292,452,7123,1694,5672,496,518,364,419,7469,1286,323,461,330,393,2793,0.22672778561354,0.651209677419355,0.88996138996139,0.906593406593407,0.937947494033413,0.373945641986879
E02004374,Old Hastings,Hastings,South East,1329,4732,431,440,295,431,6329,1201,4970,443,435,305,390,6543,1118,301,388,274,349,2430,0.224949698189135,0.679458239277652,0.891954022988506,0.898360655737705,0.894871794871795,0.371389270976616
E02004375,Braybrooke & Bohemia,Hastings,South East,1480,5555,515,433,243,354,7100,1408,5697,533,466,254,419,7369,1117,328,405,222,358,2430,0.196068106020713,0.615384615384615,0.869098712446352,0.874015748031496,0.854415274463007,0.329759804586782
E02004376,Central Hastings,Hastings,South East,1126,4911,328,318,153,253,5963,1083,5310,355,326,197,254,6442,915,200,269,158,216,1758,0.172316384180791,0.563380281690141,0.825153374233129,0.802030456852792,0.850393700787402,0.272896615957777
E02004377,West St Leonards,Hastings,South East,1909,6265,672,705,484,909,9035,1825,6632,695,657,484,757,9225,1547,497,591,439,678,3752,0.233262967430639,0.715107913669065,0.899543378995434,0.90702479338843,0.895640686922061,0.406720867208672
E02004378,Central St Leonards,Hastings,South East,1235,5981,496,425,248,383,7533,1279,6142,479,433,299,303,7656,1076,244,332,246,259,2157,0.175187235428199,0.509394572025052,0.766743648960739,0.822742474916388,0.854785478547855,0.281739811912226
E02004379,"Chailey, Newick & Barcombe",Lewes,South East,1508,4606,554,569,338,439,6506,1365,4716,505,536,395,435,6587,915,411,504,380,425,2635,0.194020356234097,0.813861386138614,0.940298507462687,0.962025316455696,0.977011494252874,0.400030362835889
E02004380,"Wivelsfield Green, Ditchling & Rodmell",Lewes,South East,1544,5382,627,605,434,972,8020,1554,5655,613,656,506,888,8318,1096,535,620,486,855,3592,0.193810786914235,0.872756933115824,0.945121951219512,0.960474308300395,0.962837837837838,0.431834575619139
E02004381,Lewes Central & East,Lewes,South East,1792,6281,555,553,363,592,8344,1685,6511,558,553,427,589,8638,1516,476,502,394,556,3444,0.232836737828291,0.853046594982079,0.907775768535262,0.92271662763466,0.943972835314092,0.39870340356564
E02004382,"Ringmer, Glynde & South Heighton",Lewes,South East,1130,3559,452,509,362,630,5512,1139,3821,436,502,373,612,5744,1005,387,478,357,589,2816,0.263020151792724,0.887614678899083,0.952191235059761,0.957104557640751,0.962418300653595,0.49025069637883
E02004383,Lewes West,Lewes,South East,1486,4789,391,429,293,419,6321,1343,5334,449,441,293,473,6990,1055,400,411,275,454,2595,0.197787776527934,0.89086859688196,0.931972789115646,0.938566552901024,0.959830866807611,0.371244635193133
E02004384,East Saltdean & Telscombe Cliffs,Lewes,South East,1358,4633,506,463,345,570,6517,1208,4613,471,478,341,515,6418,908,400,438,304,455,2505,0.196835031432907,0.849256900212314,0.916317991631799,0.89149560117302,0.883495145631068,0.390308507323154
E02004385,Peacehaven West,Lewes,South East,1279,4468,492,528,367,531,6386,1319,4806,528,557,426,608,6925,916,465,516,389,545,2831,0.190595089471494,0.880681818181818,0.926391382405745,0.913145539906103,0.896381578947369,0.408808664259928
E02004386,Newhaven Town,Lewes,South East,1185,3928,407,465,333,411,5544,1201,4073,415,441,356,410,5695,899,354,405,337,376,2371,0.220721826663393,0.853012048192771,0.918367346938776,0.946629213483146,0.917073170731707,0.416330114135206
E02004387,Newhaven West,Lewes,South East,1521,4001,287,213,167,177,4845,1482,4188,272,246,168,198,5072,746,234,214,146,176,1516,0.178127984718243,0.860294117647059,0.869918699186992,0.869047619047619,0.888888888888889,0.298895899053628
E02004388,Peacehaven East,Lewes,South East,1423,4545,417,488,380,578,6408,1440,4839,465,471,392,523,6690,991,399,424,354,462,2630,0.204794379003926,0.858064516129032,0.900212314225053,0.903061224489796,0.883365200764818,0.393124065769806
E02004389,East Blatchington,Lewes,South East,1243,4889,790,969,680,1207,8535,1195,4916,778,925,750,1166,8535,1900,714,861,717,1090,5282,0.386493083807974,0.917737789203085,0.930810810810811,0.956,0.934819897084048,0.618863503222027
E02004390,Seaford Eastbourne Road,Lewes,South East,1337,4129,643,731,530,809,6842,1291,4361,611,777,582,797,7128,1555,573,729,566,754,4177,0.356569594129787,0.937806873977087,0.938223938223938,0.972508591065292,0.946047678795483,0.585998877665544
E02004391,Seaford Town,Lewes,South East,884,3683,500,516,365,734,5798,854,3741,470,550,363,723,5847,1279,409,491,340,644,3163,0.341887195936915,0.870212765957447,0.892727272727273,0.9366391184573,0.890733056708161,0.540961176671798
E02004392,"Robertsbridge, Hurst Green & Ticehurst",Rother,South East,1860,5378,593,649,427,545,7592,1724,5698,624,654,483,598,8057,1321,564,608,462,577,3532,0.231835731835732,0.903846153846154,0.929663608562691,0.956521739130435,0.964882943143813,0.438376566960407
E02004393,"Northiam, Peasmarsh & Camber",Rother,South East,892,3416,582,620,439,546,5603,906,3735,578,648,474,603,6038,929,448,599,445,574,2995,0.248728246318608,0.775086505190311,0.924382716049383,0.938818565400844,0.951907131011609,0.496025173898642
E02004394,"Burwash, Sedlescombe & Staplecross",Rother,South East,1214,4554,601,704,417,588,6864,1203,4804,621,677,475,588,7165,1255,534,637,445,563,3434,0.261240632805995,0.859903381642512,0.940915805022157,0.936842105263158,0.957482993197279,0.479274249825541
E02004395,Rye & Winchelsea,Rother,South East,1221,4515,668,764,479,685,7111,1139,4403,575,703,518,673,6872,1111,428,645,493,636,3313,0.252327958210311,0.744347826086957,0.917496443812233,0.951737451737452,0.945022288261516,0.482101280558789
E02004396,"Westfield, Fairlight & Broad Oak",Rother,South East,1145,4633,889,990,692,809,8013,1286,5265,845,997,737,873,8717,1408,664,941,691,810,4514,0.267426400759734,0.785798816568047,0.94383149448345,0.937584803256445,0.927835051546392,0.517838705976827
E02004397,Battle & Catsfield,Rother,South East,1696,4805,571,572,408,683,7039,1533,5017,538,589,471,632,7247,1227,463,569,452,604,3315,0.244568467211481,0.860594795539033,0.966044142614601,0.959660297239915,0.955696202531646,0.457430660963157
E02004398,Bexhill North & Sidley,Rother,South East,2114,5532,489,551,377,606,7555,2027,5866,422,512,385,545,7730,1442,263,461,361,505,3032,0.24582338902148,0.623222748815166,0.900390625,0.937662337662338,0.926605504587156,0.392238033635188
E02004399,Bexhill East & Pebsham,Rother,South East,1117,4301,677,732,542,887,7139,1110,4376,608,736,588,900,7208,1251,420,680,560,854,3765,0.285877513711152,0.690789473684211,0.923913043478261,0.952380952380952,0.948888888888889,0.522336293007769
E02004400,"Collington, Cooden & Little Common",Rother,South East,938,4471,1030,1337,891,1463,9192,1055,4933,976,1318,988,1486,9701,1358,744,1258,949,1427,5736,0.275288870869653,0.762295081967213,0.954476479514416,0.960526315789474,0.960296096904441,0.591279249561901
E02004401,Kewhurst,Rother,South East,934,3652,725,865,687,1271,7200,824,3577,647,883,705,1200,7012,999,481,852,672,1145,4149,0.279284316466313,0.743431221020093,0.964892412231031,0.953191489361702,0.954166666666667,0.591699942954934
E02004402,Bexhill Central,Rother,South East,1328,5478,651,722,525,937,8313,1224,5335,619,735,553,930,8172,1413,404,654,511,852,3834,0.26485473289597,0.652665589660743,0.889795918367347,0.924050632911392,0.916129032258065,0.469162995594714
E02004403,Forest Row & Coleman's Hatch,Wealden,South East,1226,4083,461,467,303,374,5688,1218,4382,480,453,355,407,6077,539,356,387,311,357,1950,0.123003194888179,0.741666666666667,0.85430463576159,0.876056338028169,0.877149877149877,0.32088201415172
E02004404,Frant & Groombridge,Wealden,South East,1207,3845,438,411,276,397,5367,1078,3958,414,438,306,381,5497,641,378,412,279,371,2081,0.161950480040424,0.91304347826087,0.940639269406393,0.911764705882353,0.973753280839895,0.378570129161361
E02004405,Crowborough North East,Wealden,South East,1241,3655,384,437,309,433,5218,1115,3471,379,443,345,466,5104,531,327,425,334,448,2065,0.152981849611063,0.862796833773087,0.959367945823928,0.968115942028986,0.96137339055794,0.404584639498433
E02004406,Crowborough Whitehill & Warren,Wealden,South East,1066,4046,527,699,435,820,6527,1044,4190,509,671,511,826,6707,726,452,633,492,787,3090,0.17326968973747,0.888015717092338,0.943368107302534,0.962818003913894,0.952784503631961,0.460712688236171
E02004407,Mayfield & Wadhurst,Wealden,South East,1362,4528,519,569,459,657,6732,1361,4836,547,565,469,666,7083,705,485,537,436,637,2800,0.145781637717122,0.886654478976234,0.950442477876106,0.929637526652452,0.956456456456456,0.395312720598616
E02004408,Crowborough South East,Wealden,South East,1449,5172,470,461,259,349,6711,1512,5435,488,493,291,367,7074,883,395,434,273,340,2325,0.162465501379945,0.809426229508197,0.880324543610548,0.938144329896907,0.926430517711172,0.328668363019508
E02004409,Chelwood & Nutley,Wealden,South East,812,3193,407,384,307,348,4639,790,3337,415,420,332,410,4914,518,354,392,312,387,1963,0.15522924782739,0.853012048192771,0.933333333333333,0.939759036144578,0.94390243902439,0.3994708994709
E02004410,"Buxted, Framfield & Rotherfield",Wealden,South East,1307,4818,610,677,428,565,7098,1256,4814,620,661,492,554,7141,756,557,617,471,530,2931,0.157041960947237,0.898387096774194,0.933434190620272,0.957317073170732,0.956678700361011,0.410446716146198
E02004411,Uckfield Town & North,Wealden,South East,1585,5045,538,608,372,494,7057,1508,5286,497,594,460,519,7356,896,417,571,447,495,2826,0.169504351116156,0.839034205231388,0.961279461279461,0.971739130434783,0.953757225433526,0.384176182707993
E02004412,Heathfield,Wealden,South East,1315,4764,478,621,417,565,6845,1303,4809,485,582,450,575,6901,909,360,543,430,545,2787,0.189020586400499,0.742268041237113,0.93298969072165,0.955555555555556,0.947826086956522,0.403854513838574
E02004413,Broad Oak & Horam,Wealden,South East,1133,3965,494,530,398,585,5972,1127,4245,491,525,432,577,6270,839,396,484,411,556,2686,0.197644287396938,0.806517311608961,0.921904761904762,0.951388888888889,0.963604852686309,0.428389154704944
E02004414,Uckfield South,Wealden,South East,1113,4207,299,379,193,275,5353,1159,4279,316,345,235,297,5472,779,273,323,228,275,1878,0.182051881280673,0.863924050632912,0.936231884057971,0.970212765957447,0.925925925925926,0.343201754385965
E02004415,"Five Ash Down, Horsted & Chiddingly",Wealden,South East,1196,4102,529,466,297,426,5820,1132,4215,562,470,347,423,6017,762,501,443,337,405,2448,0.180782918149466,0.891459074733096,0.942553191489362,0.971181556195966,0.957446808510638,0.406847266079442
E02004416,Herstmonceux & Ninfield,Wealden,South East,1005,3643,518,558,335,431,5485,957,3895,530,564,406,438,5833,838,422,537,388,414,2599,0.215147625160462,0.79622641509434,0.952127659574468,0.955665024630542,0.945205479452055,0.445568318189611
E02004417,Hailsham Central & East,Wealden,South East,1007,3379,383,425,402,648,5237,1057,3689,373,444,390,663,5559,1191,340,422,376,628,2957,0.322851721333695,0.911528150134048,0.95045045045045,0.964102564102564,0.947209653092006,0.53193020327397
E02004418,Hailsham South & West,Wealden,South East,1089,3199,342,420,288,462,4711,1026,3342,341,376,333,501,4893,1064,312,357,318,468,2519,0.31837223219629,0.914956011730205,0.949468085106383,0.954954954954955,0.934131736526946,0.514817085632536
E02004419,Hailsham East,Wealden,South East,1285,3503,314,375,271,402,4865,1212,3760,321,407,294,436,5218,1188,283,371,274,399,2515,0.315957446808511,0.881619937694704,0.911547911547912,0.931972789115646,0.915137614678899,0.48198543503258
E02004420,"Hailsham North, Alfriston & East Dean",Wealden,South East,2637,7417,950,1057,735,1075,11234,2501,7968,926,1071,819,1086,11870,2396,857,1022,782,1025,6082,0.30070281124498,0.92548596112311,0.954248366013072,0.954822954822955,0.943830570902394,0.512384161752317
E02004421,Polegate,Wealden,South East,1657,5161,553,658,503,839,7714,1587,5248,584,625,518,847,7822,1138,497,575,487,783,3480,0.216844512195122,0.851027397260274,0.92,0.94015444015444,0.92443919716647,0.44489900281258
E02004422,"Stone Cross, Westham & Pevensey Bay",Wealden,South East,1880,6149,744,815,561,829,9098,1848,6531,718,847,636,819,9551,1729,634,795,604,763,4525,0.264737406216506,0.883008356545961,0.938606847697757,0.949685534591195,0.931623931623932,0.473772379855513
E02004423,Willingdon,Wealden,South East,962,3910,570,744,550,796,6570,963,4100,544,707,592,813,6756,1194,486,676,565,753,3674,0.291219512195122,0.893382352941176,0.956152758132956,0.954391891891892,0.92619926199262,0.543812907045589
E02004675,Tadley West,Basingstoke and Deane,South East,1448,4440,374,422,286,368,5890,1459,4982,409,441,335,388,6555,1042,372,417,317,364,2512,0.20915295062224,0.909535452322738,0.945578231292517,0.946268656716418,0.938144329896907,0.383218916857361
E02004676,"Tadley East, Pamber & Silchester",Basingstoke and Deane,South East,1284,4475,539,554,350,506,6424,1272,4990,500,586,395,517,6988,1001,456,560,378,494,2889,0.20060120240481,0.912,0.955631399317406,0.956962025316456,0.955512572533849,0.413423010875787
E02004677,"Woolton Hill, Burghclere & Bishops Green",Basingstoke and Deane,South East,1651,4347,454,457,288,387,5933,1491,4747,472,459,339,401,6418,632,420,440,330,391,2213,0.133136717927112,0.889830508474576,0.958605664488017,0.973451327433628,0.975062344139651,0.344811467746962
E02004678,Kingsclere & Heath End,Basingstoke and Deane,South East,1252,4323,436,478,344,426,6007,1253,4803,456,504,361,472,6596,828,419,478,348,449,2522,0.172392254840725,0.918859649122807,0.948412698412698,0.96398891966759,0.951271186440678,0.382352941176471
E02004679,"Bramley, Sherfield & the Sherbornes",Basingstoke and Deane,South East,1885,5895,453,468,314,430,7560,2129,6715,491,476,341,489,8512,1259,447,457,326,471,2960,0.187490692479523,0.910386965376782,0.960084033613445,0.956011730205279,0.96319018404908,0.347744360902256
E02004680,Chineham,Basingstoke and Deane,South East,1681,5121,330,257,136,140,5984,1633,5517,336,282,205,170,6510,944,309,258,190,163,1864,0.17110748595251,0.919642857142857,0.914893617021277,0.926829268292683,0.958823529411765,0.286328725038402
E02004681,Popley,Basingstoke and Deane,South East,3439,9022,412,438,311,291,10474,3666,10135,414,470,339,365,11723,1801,354,426,304,323,3208,0.177701036013814,0.855072463768116,0.906382978723404,0.896755162241888,0.884931506849315,0.273650089567517
E02004682,Daneshill & Little Basing,Basingstoke and Deane,South East,1711,5513,369,313,196,212,6603,1671,5872,366,338,234,253,7063,983,322,315,224,235,2079,0.167404632152589,0.879781420765027,0.931952662721893,0.957264957264957,0.928853754940711,0.294350842418236
E02004683,Houndmills & Oakridge,Basingstoke and Deane,South East,1454,4890,249,262,213,391,6005,1509,5729,278,287,234,397,6925,976,247,257,218,363,2061,0.170361319602025,0.888489208633094,0.895470383275261,0.931623931623932,0.914357682619647,0.297617328519856
E02004684,Winklebury & Rooksdown,Basingstoke and Deane,South East,2314,6915,324,364,282,314,8199,2356,7708,329,386,282,372,9077,1680,290,360,260,345,2935,0.217955371043072,0.88145896656535,0.932642487046632,0.921985815602837,0.92741935483871,0.323344717417649
E02004685,"Basingstoke Central, Black Dam & Eastrop",Basingstoke and Deane,South East,1256,5381,287,257,202,322,6449,1275,6164,286,310,200,364,7324,845,243,286,188,345,1907,0.137086307592472,0.84965034965035,0.92258064516129,0.94,0.947802197802198,0.260376843255052
E02004686,Kings Furlong,Basingstoke and Deane,South East,1581,5714,347,289,204,341,6895,1681,6634,323,323,226,323,7829,938,277,295,209,290,2009,0.141392824841724,0.857585139318885,0.913312693498452,0.924778761061947,0.897832817337461,0.256610039596372
E02004687,Buckskin & Worting,Basingstoke and Deane,South East,1865,4707,290,269,203,193,5662,1876,5222,270,289,217,221,6219,950,241,270,194,207,1862,0.181922635005745,0.892592592592593,0.934256055363322,0.894009216589862,0.936651583710407,0.299405049043255
E02004688,South Ham & West Ham,Basingstoke and Deane,South East,1508,4899,324,354,277,435,6289,1551,5469,362,380,261,443,6915,1029,321,345,234,417,2346,0.188151398793198,0.886740331491713,0.907894736842105,0.896551724137931,0.941309255079007,0.339262472885033
E02004689,East Oakley,Basingstoke and Deane,South East,860,2827,415,555,315,463,4575,851,3156,407,514,369,433,4879,654,384,495,352,421,2306,0.20722433460076,0.943488943488943,0.963035019455253,0.953929539295393,0.972286374133949,0.472637835622054
E02004690,Viables,Basingstoke and Deane,South East,1457,5057,387,373,225,334,6376,1442,5554,415,415,272,361,7017,975,384,391,257,335,2342,0.175549153763054,0.925301204819277,0.942168674698795,0.944852941176471,0.92797783933518,0.333760866467151
E02004691,Old Basing & the Candovers,Basingstoke and Deane,South East,1273,4408,529,542,375,609,6463,1237,4868,566,551,395,666,7046,912,517,536,381,643,2989,0.1873459326212,0.913427561837456,0.972776769509982,0.964556962025316,0.965465465465465,0.424212319046267
E02004692,Kempshott,Basingstoke and Deane,South East,1103,3792,547,662,430,545,5976,1052,4237,566,625,482,547,6457,822,532,604,465,530,2953,0.19400519235308,0.939929328621908,0.9664,0.964730290456431,0.968921389396709,0.457333126839089
E02004693,Brighton Hill,Basingstoke and Deane,South East,1637,4532,364,306,171,215,5588,1544,5130,350,339,203,232,6254,994,312,317,182,212,2017,0.193762183235867,0.891428571428572,0.935103244837758,0.896551724137931,0.913793103448276,0.322513591301567
E02004694,Whitchurch & Ashmansworth,Basingstoke and Deane,South East,1365,4207,372,435,321,434,5769,1415,4633,428,446,331,444,6282,952,383,424,309,426,2494,0.205482408806389,0.894859813084112,0.95067264573991,0.933534743202417,0.959459459459459,0.397007322508755
E02004695,Hatch Warren,Basingstoke and Deane,South East,2052,5821,259,242,131,104,6557,1892,6387,334,249,157,115,7242,1067,304,235,139,108,1853,0.167058086738688,0.910179640718563,0.943775100401606,0.885350318471338,0.939130434782609,0.255868544600939
E02004696,Overton & North Waltham,Basingstoke and Deane,South East,1292,3961,418,442,304,411,5536,1414,4490,432,470,342,420,6154,780,398,449,333,410,2370,0.173719376391982,0.921296296296296,0.95531914893617,0.973684210526316,0.976190476190476,0.385115372115697
E02004697,Bentley & Holybourne,East Hampshire,South East,1289,3887,405,466,263,459,5480,1239,4370,418,428,294,476,5986,845,389,408,286,445,2373,0.193363844393593,0.930622009569378,0.953271028037383,0.972789115646258,0.934873949579832,0.396424991647177
E02004698,Alton Westbrooke & Eastbrooke,East Hampshire,South East,1279,3741,265,334,213,468,5021,1311,4157,281,306,225,471,5440,878,244,274,215,459,2070,0.211210007216743,0.868327402135231,0.895424836601307,0.955555555555556,0.974522292993631,0.380514705882353
E02004699,"Alton Ashdell, Whitedown & Amery",East Hampshire,South East,1777,6416,606,695,513,839,9069,1646,6684,623,728,553,783,9371,1386,582,695,525,759,3947,0.207360861759426,0.934189406099519,0.95467032967033,0.949367088607595,0.969348659003831,0.421193042364742
E02004700,Bordon Camp,East Hampshire,South East,1290,3737,179,205,95,136,4352,1454,4347,223,203,120,139,5032,1069,195,190,115,133,1702,0.245916724177594,0.874439461883408,0.935960591133005,0.958333333333333,0.956834532374101,0.338235294117647
E02004702,Bordon & Lindford,East Hampshire,South East,1523,5227,380,371,307,349,6634,1473,5497,419,394,293,330,6933,1401,390,381,276,316,2764,0.25486629070402,0.930787589498807,0.967005076142132,0.9419795221843,0.957575757575757,0.398673013125631
E02004703,Four Marks & Tisted,East Hampshire,South East,2153,6974,807,949,618,786,10134,2124,7708,841,975,660,775,10959,1327,788,929,631,745,4420,0.172158796056046,0.936979785969084,0.952820512820513,0.956060606060606,0.961290322580645,0.403321470937129
E02004704,Whitehill & Selborne,East Hampshire,South East,992,3341,369,358,242,287,4597,1017,3794,373,373,285,316,5141,832,349,349,281,305,2116,0.219293621507644,0.935656836461126,0.935656836461126,0.985964912280702,0.965189873417722,0.411593075277183
E02004705,Liphook,East Hampshire,South East,1863,5400,487,564,385,642,7478,1832,5948,537,567,421,748,8221,852,471,527,402,710,2962,0.143241425689307,0.877094972067039,0.929453262786596,0.954869358669834,0.949197860962567,0.360296800875806
E02004706,Liss & Hawkley,East Hampshire,South East,1407,4418,461,542,349,609,6379,1254,4614,453,533,412,610,6622,713,412,504,404,583,2616,0.154529692241006,0.909492273730684,0.945590994371482,0.980582524271845,0.955737704918033,0.395046813651465
E02004707,Petersfield North & East Meon,East Hampshire,South East,2088,6561,735,735,550,854,9435,1934,6930,804,736,616,840,9926,883,743,687,593,808,3714,0.127417027417027,0.924129353233831,0.933423913043478,0.962662337662338,0.961904761904762,0.374168849486198
E02004708,Petersfield South,East Hampshire,South East,1725,5394,482,534,443,641,7494,1760,5962,502,548,404,668,8084,821,444,509,381,634,2789,0.137705467963771,0.884462151394422,0.928832116788321,0.943069306930693,0.949101796407186,0.345002474022761
E02004709,Clanfield & Finchdean,East Hampshire,South East,1554,4948,534,561,351,461,6855,1587,5387,551,569,417,477,7401,902,511,543,405,459,2820,0.167440133655096,0.927404718693285,0.954305799648506,0.971223021582734,0.962264150943396,0.381029590595865
E02004710,Horndean North,East Hampshire,South East,1163,3812,415,461,290,317,5295,1101,4207,394,456,345,367,5769,811,378,430,332,359,2310,0.192773948181602,0.959390862944162,0.942982456140351,0.96231884057971,0.978201634877384,0.400416016640666
E02006829,Horndean South & Rowlands Castle,East Hampshire,South East,1082,3889,500,503,420,702,6014,1118,4303,499,493,442,653,6390,813,458,471,425,635,2802,0.188937950267255,0.917835671342685,0.955375253549696,0.961538461538461,0.972434915773354,0.43849765258216
E02006838,Headley Down & Grayshott,East Hampshire,South East,956,3817,486,554,429,644,5930,986,4083,498,553,466,626,6226,842,444,531,453,607,2877,0.206220915993142,0.891566265060241,0.960216998191682,0.972103004291846,0.969648562300319,0.462094442659814
E02004712,Hiltingbury,Eastleigh,South East,1862,4769,480,594,512,790,7145,1767,5053,441,553,533,802,7382,1107,392,533,504,778,3314,0.219077775578864,0.888888888888889,0.963833634719711,0.945590994371482,0.970074812967581,0.448929829314549
E02004713,Chandler's Ford East,Eastleigh,South East,1513,4580,522,589,321,517,6529,1563,4857,541,598,360,530,6886,1045,477,554,334,498,2908,0.21515338686432,0.881700554528651,0.926421404682274,0.927777777777778,0.939622641509434,0.422306128376416
E02004714,Chandler's Ford West,Eastleigh,South East,1245,4529,515,579,340,515,6478,1181,4610,543,574,372,574,6673,962,464,553,355,555,2889,0.208676789587852,0.85451197053407,0.963414634146341,0.954301075268817,0.966898954703833,0.432938708227184
E02004715,Boyatt Wood,Eastleigh,South East,1837,5885,438,400,307,447,7477,1733,5689,438,449,299,471,7346,1083,385,409,277,417,2571,0.190367375637195,0.878995433789955,0.910913140311804,0.926421404682274,0.885350318471338,0.349986387149469
E02004716,Bishopstoke,Eastleigh,South East,1763,5429,473,468,340,430,7140,1734,5587,523,475,353,449,7387,1039,452,456,334,424,2705,0.18596742437802,0.864244741873805,0.96,0.946175637393768,0.944320712694877,0.366183836469473
E02004717,Eastleigh West,Eastleigh,South East,2599,7711,440,395,283,540,9369,2905,8296,448,411,298,506,9959,1435,382,377,271,451,2916,0.172974927675988,0.852678571428571,0.917274939172749,0.909395973154362,0.891304347826087,0.292800481976102
E02004718,Central Eastleigh,Eastleigh,South East,1795,6465,329,258,169,276,7497,1701,6321,376,292,195,301,7485,952,317,260,171,247,1947,0.150609080841639,0.843085106382979,0.89041095890411,0.876923076923077,0.820598006644518,0.260120240480962
E02004719,Fair Oak,Eastleigh,South East,2014,6559,563,594,421,538,8675,2053,7150,604,625,453,605,9437,1249,533,594,434,579,3389,0.174685314685315,0.882450331125828,0.9504,0.958057395143488,0.95702479338843,0.359118363886828
E02004720,West End & Chartwell Green,Eastleigh,South East,1715,6630,719,726,487,786,9348,1775,7055,720,725,557,821,9878,1411,628,696,534,792,4061,0.2,0.872222222222222,0.96,0.958707360861759,0.964677222898904,0.411115610447459
E02004721,Hedge End North & Botley North,Eastleigh,South East,2762,6983,365,295,184,230,8057,2876,7519,347,322,203,255,8646,1503,313,297,190,245,2548,0.199893602872722,0.902017291066282,0.922360248447205,0.935960591133005,0.96078431372549,0.29470275271802
E02004722,Hedge End Wildern & Botley South,Eastleigh,South East,1345,4147,446,437,314,493,5837,1296,4343,438,421,328,509,6039,936,387,393,313,492,2521,0.215519226341239,0.883561643835616,0.933491686460808,0.954268292682927,0.966601178781925,0.417453220731909
E02004723,Hedge End South,Eastleigh,South East,1780,5830,593,601,463,652,8139,1726,6034,575,592,454,671,8326,1269,520,574,442,653,3458,0.210308253231687,0.904347826086956,0.969594594594595,0.973568281938326,0.97317436661699,0.415325486428057
E02004724,Lowford,Eastleigh,South East,1613,5362,410,388,272,363,6795,1759,5894,446,415,305,354,7414,1152,385,386,296,338,2557,0.195453003053953,0.86322869955157,0.930120481927711,0.970491803278689,0.954802259887006,0.344888049635824
E02004725,Netley,Eastleigh,South East,906,3187,336,324,238,448,4533,902,3343,329,364,247,439,4722,681,295,346,238,426,1986,0.203709243194735,0.896656534954407,0.950549450549451,0.963562753036437,0.970387243735763,0.420584498094028
E02004726,Hamble-le-Rice,Eastleigh,South East,1005,3537,336,380,242,316,4811,1015,3792,358,377,273,331,5131,658,309,352,262,313,1894,0.173523206751055,0.863128491620112,0.93368700265252,0.95970695970696,0.945619335347432,0.369128824790489
E02004727,Swanwick & Sarisbury Green,Fareham,South East,2200,6309,413,424,260,352,7758,2171,6625,436,441,300,399,8201,1169,405,414,282,367,2637,0.176452830188679,0.928899082568807,0.938775510204082,0.94,0.919799498746867,0.321546152908182
E02004728,Park Gate & Segensworth,Fareham,South East,1731,5759,490,451,337,507,7544,1658,5696,461,506,382,559,7604,1110,408,483,368,543,2912,0.194873595505618,0.885032537960955,0.954545454545455,0.963350785340314,0.971377459749553,0.382956338769069
E02004729,Fareham North West,Fareham,South East,1300,4596,367,440,348,405,6156,1233,4628,403,425,344,447,6247,1013,353,400,325,429,2520,0.218885047536733,0.875930521091811,0.941176470588235,0.944767441860465,0.959731543624161,0.403393628941892
E02004730,Fareham Common,Fareham,South East,1296,5063,559,674,456,880,7632,1299,5155,561,615,518,813,7662,1175,498,590,502,786,3551,0.227934044616877,0.887700534759358,0.959349593495935,0.969111969111969,0.966789667896679,0.463456016705821
E02004731,Locks Heath,Fareham,South East,1297,4858,500,464,367,521,6710,1221,4786,489,483,365,531,6654,914,452,471,351,513,2701,0.19097367321354,0.924335378323108,0.975155279503106,0.961643835616438,0.966101694915254,0.405921250375714
E02004732,Warsash,Fareham,South East,1574,5108,505,482,391,557,7043,1569,5553,523,559,421,642,7698,1120,459,537,405,616,3137,0.201692778678192,0.877629063097514,0.960644007155635,0.961995249406176,0.959501557632399,0.407508443751624
E02004733,Titchfield & Titchfield Common,Fareham,South East,1440,4966,478,479,296,424,6643,1369,4968,492,496,334,460,6750,1018,438,472,321,447,2696,0.204911433172303,0.890243902439024,0.951612903225806,0.961077844311377,0.971739130434783,0.399407407407407
E02004734,Fareham Town & Cams Hill,Fareham,South East,1635,6825,500,584,448,677,9034,1524,6474,570,606,480,743,8873,1364,487,574,456,720,3601,0.21068890948409,0.854385964912281,0.947194719471947,0.95,0.969044414535666,0.405837935309366
E02004735,Fareham West,Fareham,South East,1137,4198,492,610,463,692,6455,1090,4044,479,581,517,722,6343,988,440,556,505,687,3176,0.24431256181998,0.918580375782881,0.95697074010327,0.97678916827853,0.951523545706371,0.500709443481003
E02004736,Portchester North West,Fareham,South East,1192,4409,558,682,487,620,6756,1251,4768,513,675,537,653,7146,1023,475,644,525,627,3294,0.214555369127517,0.925925925925926,0.954074074074074,0.977653631284916,0.960183767228178,0.46095717884131
E02004737,Fareham Fort,Fareham,South East,1528,5040,310,389,245,464,6448,1471,4810,313,352,277,447,6199,1021,256,319,259,420,2275,0.212266112266112,0.817891373801917,0.90625,0.935018050541516,0.939597315436242,0.366994676560736
E02004738,Portchester South East,Fareham,South East,1148,4394,501,529,343,540,6307,1130,4501,483,515,382,553,6434,968,442,495,373,534,2812,0.215063319262386,0.915113871635611,0.961165048543689,0.976439790575916,0.965641952983725,0.43705315511346
E02004739,Stubbington,Fareham,South East,949,3791,466,594,453,732,6036,918,5727,500,593,498,721,8039,983,419,577,479,693,3151,0.171643094115593,0.838,0.973018549747049,0.961847389558233,0.961165048543689,0.391964174648588
E02004740,Hill Head,Fareham,South East,1094,3859,527,672,422,710,6190,1077,3796,506,622,490,721,6135,890,445,608,475,693,3111,0.234457323498419,0.879446640316206,0.977491961414791,0.969387755102041,0.961165048543689,0.507090464547677
E02004741,Bridgemary North,Gosport,South East,1409,4690,467,536,332,457,6482,1325,4800,467,549,367,491,6674,1026,416,517,354,473,2786,0.21375,0.890792291220557,0.941712204007286,0.964577656675749,0.963340122199593,0.417440815103386
E02004742,Bridgemary South,Gosport,South East,1320,4485,489,456,340,431,6201,1206,4427,490,465,343,448,6173,1026,441,440,327,425,2659,0.231759656652361,0.9,0.946236559139785,0.9533527696793,0.948660714285714,0.430746800583185
E02004743,Elson,Gosport,South East,1324,4759,390,427,246,310,6132,1276,4596,397,436,310,343,6082,1035,371,413,294,326,2439,0.225195822454308,0.934508816120907,0.947247706422018,0.948387096774194,0.950437317784256,0.40101940151266
E02004744,Rowner,Gosport,South East,2756,6305,269,249,88,171,7082,2721,6062,296,253,152,206,6969,1203,250,229,133,186,2001,0.198449356647971,0.844594594594595,0.905138339920949,0.875,0.902912621359223,0.287128712871287
E02004745,Priddy's Hard & Brockhurst East,Gosport,South East,1674,6031,394,434,236,274,7369,1613,5605,411,425,270,306,7017,1207,360,389,251,295,2502,0.215343443354148,0.875912408759124,0.915294117647059,0.92962962962963,0.964052287581699,0.356562633604104
E02004746,Lee-on-the-Solent,Gosport,South East,1971,6226,722,895,581,844,9268,1881,6218,733,897,644,898,9390,1501,653,852,620,863,4489,0.24139594724992,0.890859481582537,0.949832775919733,0.962732919254658,0.961024498886414,0.478061767838126
E02004747,Brockhurst,Gosport,South East,1165,4400,341,358,229,345,5673,1049,5084,382,349,253,370,6438,935,349,342,246,357,2229,0.183910306845004,0.913612565445026,0.979942693409742,0.972332015810277,0.964864864864865,0.346225535880708
E02004748,Gosport Town,Gosport,South East,1761,6554,476,494,315,454,8293,1598,6060,471,489,367,465,7852,1203,402,454,343,428,2830,0.198514851485149,0.853503184713376,0.928425357873211,0.934604904632153,0.920430107526882,0.360417727967397
E02004749,Alverstoke & Privett,Gosport,South East,1110,3782,525,591,395,844,6137,1120,3774,494,572,445,784,6069,902,460,546,431,745,3084,0.239003709591945,0.931174089068826,0.954545454545455,0.968539325842697,0.950255102040816,0.508156203657934
E02004750,Clayhall & Anglesey,Gosport,South East,1135,4661,503,497,315,600,6576,1115,4413,526,495,373,571,6378,887,490,464,360,543,2744,0.200997054158169,0.931558935361217,0.937373737373737,0.96514745308311,0.950963222416813,0.430228911884603
E02004751,Yateley East,Hart,South East,1380,4730,459,542,408,532,6671,1369,5209,505,532,479,596,7321,1109,477,516,466,582,3150,0.212900748704166,0.944554455445545,0.969924812030075,0.97286012526096,0.976510067114094,0.430269088922278
E02004752,Yateley West & Eversley,Hart,South East,1541,4845,509,542,310,315,6521,1444,5083,528,551,352,362,6876,1081,498,533,342,350,2804,0.212669683257919,0.943181818181818,0.967332123411978,0.971590909090909,0.966850828729282,0.407795229784759
E02004753,"Blackwater, Frogmore & Minley",Hart,South East,1894,6541,563,603,483,535,8725,1954,7837,537,613,503,585,10075,1440,495,582,488,568,3573,0.183743779507465,0.921787709497207,0.949429037520392,0.970178926441352,0.970940170940171,0.354640198511166
E02004754,Hartley Wintney & Heckfield,Hart,South East,1481,4026,388,493,338,457,5702,1388,4426,418,499,371,470,6184,748,354,476,360,444,2382,0.169001355625847,0.84688995215311,0.953907815631263,0.970350404312669,0.94468085106383,0.385187580853816
E02004755,"Fleet North, Elvetham Heath & Ancells Farm",Hart,South East,2687,7928,401,403,332,647,9711,2568,8292,390,385,363,663,10093,1113,341,355,341,636,2786,0.134225759768452,0.874358974358975,0.922077922077922,0.939393939393939,0.959276018099547,0.276032894085009
E02004756,Hook & Rotherwick,Hart,South East,1721,5362,459,467,242,359,6889,1913,6289,441,482,306,344,7862,1008,391,461,294,327,2481,0.160279853712832,0.886621315192744,0.95643153526971,0.96078431372549,0.950581395348837,0.315568557618927
E02004757,Fleet South & Pondtail,Hart,South East,1457,4434,452,583,420,592,6481,1431,4972,467,575,465,659,7138,740,426,551,447,639,2803,0.148833467417538,0.91220556745182,0.958260869565217,0.961290322580645,0.969650986342944,0.392687027178481
E02004758,Fleet West & Winchfield,Hart,South East,1753,5263,436,487,403,611,7200,1763,5906,464,504,401,568,7843,868,421,475,379,536,2679,0.146969183880799,0.907327586206897,0.942460317460317,0.945137157107232,0.943661971830986,0.341578477623358
E02004759,Crookham East,Hart,South East,1740,4922,411,491,388,559,6771,1539,5094,404,465,378,580,6921,865,372,443,364,556,2600,0.169807616804083,0.920792079207921,0.952688172043011,0.962962962962963,0.958620689655172,0.375668256032365
E02004760,"Crookham West, Ewshot & Crondall",Hart,South East,2483,6068,348,373,268,446,7503,2538,6708,379,381,305,497,8270,1068,345,362,293,476,2544,0.159212880143113,0.910290237467018,0.9501312335958,0.960655737704918,0.957746478873239,0.307617896009674
E02004761,Odiham & Warnborough,Hart,South East,1258,4284,304,303,266,347,5504,1229,4721,294,338,267,381,6001,636,270,329,255,367,1857,0.13471722092777,0.918367346938776,0.973372781065089,0.955056179775281,0.963254593175853,0.309448425262456
E02004764,Waterlooville North West,Havant,South East,1105,4578,558,681,524,814,7155,1084,4811,518,681,530,836,7376,1160,487,649,519,807,3622,0.241114113489919,0.94015444015444,0.953010279001468,0.979245283018868,0.965311004784689,0.491052060737527
E02004765,Waterlooville North East,Havant,South East,933,3738,370,408,293,353,5162,913,3633,405,403,314,403,5158,797,388,392,311,396,2284,0.219377924580237,0.958024691358025,0.972704714640198,0.990445859872611,0.982630272952854,0.44280728964715
E02004766,Waterlooville Central,Havant,South East,1369,4301,306,317,293,470,5687,1291,4532,359,337,284,491,6003,1055,324,321,274,468,2442,0.23278905560459,0.902506963788301,0.952522255192878,0.964788732394366,0.953156822810591,0.40679660169915
E02004767,Barncroft & Warren Park,Havant,South East,1662,3866,236,206,182,210,4700,1451,3898,257,221,170,216,4762,791,235,204,160,202,1592,0.202924576706003,0.914396887159533,0.923076923076923,0.941176470588235,0.935185185185185,0.334313313733725
E02004768,Waterlooville East,Havant,South East,1098,3491,348,278,160,235,4512,1092,3603,359,303,188,210,4663,826,330,277,180,197,1810,0.229253399944491,0.919220055710306,0.914191419141914,0.957446808510638,0.938095238095238,0.388162127385803
E02004769,Leigh Park,Havant,South East,1611,3986,231,211,134,198,4760,1656,4412,266,228,156,188,5250,831,237,210,148,169,1595,0.188349954669084,0.890977443609023,0.921052631578947,0.948717948717949,0.898936170212766,0.303809523809524
E02004770,West Leigh,Havant,South East,1639,4415,295,267,176,285,5438,1572,4598,297,274,201,310,5680,869,259,256,183,278,1845,0.188995215311005,0.872053872053872,0.934306569343066,0.91044776119403,0.896774193548387,0.324823943661972
E02004771,Stockheath Common,Havant,South East,2185,5850,378,372,238,376,7214,2108,5947,407,374,238,368,7334,1155,373,345,215,341,2429,0.194215570876072,0.916461916461916,0.922459893048128,0.903361344537815,0.926630434782609,0.331197163894191
E02004772,Purbrook & Widley,Havant,South East,1514,5899,563,607,391,606,8066,1448,5959,583,596,458,628,8224,1335,531,563,441,609,3479,0.224030877664038,0.910806174957118,0.944630872483222,0.962882096069869,0.969745222929936,0.423030155642023
E02004774,Emsworth,Havant,South East,1498,5220,750,833,595,1142,8540,1529,5521,779,803,685,1146,8934,1456,709,760,664,1103,4692,0.263720340518022,0.910141206675225,0.946450809464508,0.969343065693431,0.962478184991274,0.525184687709872
E02004775,Central Havant & Langstone,Havant,South East,1632,6031,634,677,398,726,8466,1617,6323,658,674,462,701,8818,1264,605,643,440,666,3618,0.199905108334651,0.919452887537994,0.954005934718101,0.952380952380952,0.950071326676177,0.410297119528238
E02004776,Hayling West & North,Havant,South East,745,3181,526,617,420,579,5323,707,3334,518,581,504,608,5545,949,476,548,486,576,3035,0.284643071385723,0.918918918918919,0.943201376936317,0.964285714285714,0.947368421052632,0.547339945897205
E02004777,South Hayling,Havant,South East,766,2829,419,540,420,625,4833,686,2816,401,513,447,655,4832,820,357,486,429,633,2725,0.291193181818182,0.890274314214464,0.947368421052632,0.959731543624161,0.966412213740458,0.563948675496689
E02004778,Hayling Eastoke,Havant,South East,733,3319,497,643,438,611,5508,728,3403,523,642,485,668,5721,1042,462,609,457,645,3215,0.306200411401704,0.883365200764818,0.948598130841122,0.942268041237113,0.965568862275449,0.561964691487502
E02006822,Bedhampton,Havant,South East,1487,5627,502,545,341,679,7694,1553,5848,537,598,390,655,8028,1378,497,562,373,616,3426,0.235636114911081,0.925512104283054,0.939799331103679,0.956410256410256,0.940458015267176,0.426756352765321
E02006830,Cowplain West,Havant,South East,1505,4216,345,343,205,259,5368,1442,4238,314,340,259,282,5433,895,278,324,253,266,2016,0.211184521000472,0.885350318471338,0.952941176470588,0.976833976833977,0.943262411347518,0.371065709552733
E02006831,Cowplain East,Havant,South East,898,3585,443,491,322,573,5414,933,3656,442,471,374,570,5513,812,415,452,364,557,2600,0.222100656455142,0.938914027149321,0.959660297239915,0.973262032085561,0.97719298245614,0.471612552149465
E02004779,"Fordingbridge, Rockbourne & Woodgreen",New Forest,South East,1647,5868,835,857,568,988,9116,1555,6266,836,868,656,976,9602,1534,675,830,629,941,4609,0.244813278008299,0.807416267942584,0.956221198156682,0.958841463414634,0.964139344262295,0.480004165798792
E02004780,Totton Calmore,New Forest,South East,1096,3530,361,388,245,388,4912,1090,3782,362,385,257,362,5148,860,310,355,241,349,2115,0.227392913802221,0.856353591160221,0.922077922077922,0.937743190661479,0.964088397790055,0.410839160839161
E02004781,West Totton,New Forest,South East,1564,5367,453,380,233,409,6842,1508,5473,437,422,257,338,6927,1170,402,404,250,323,2549,0.213776722090261,0.919908466819222,0.957345971563981,0.972762645914397,0.955621301775148,0.367980366681103
E02004782,Totton Town,New Forest,South East,1457,4709,444,466,328,593,6540,1362,4996,438,439,336,584,6793,1089,393,415,328,549,2774,0.217974379503603,0.897260273972603,0.945330296127563,0.976190476190476,0.940068493150685,0.408361548653025
E02004783,Totton Rushington,New Forest,South East,1387,4606,342,325,260,402,5935,1307,4757,359,335,245,398,6094,1057,325,323,232,383,2320,0.222198864830776,0.905292479108635,0.964179104477612,0.946938775510204,0.962311557788945,0.380702330160814
E02004784,Ashurst & Cadnam,New Forest,South East,746,3108,437,478,335,639,4997,732,3223,405,476,361,652,5117,730,375,458,345,630,2538,0.226497052435619,0.925925925925926,0.96218487394958,0.955678670360111,0.966257668711656,0.495993746335744
E02004785,Lyndhurst & Minstead,New Forest,South East,754,3075,450,512,329,546,4912,684,3280,460,488,363,545,5136,756,407,461,356,531,2511,0.230487804878049,0.884782608695652,0.944672131147541,0.980716253443526,0.974311926605505,0.488901869158879
E02004786,Marchwood & Dibden,New Forest,South East,1664,5446,497,435,283,311,6972,1543,5176,534,444,320,326,6800,1301,459,423,302,311,2796,0.251352395672334,0.859550561797753,0.952702702702703,0.94375,0.95398773006135,0.411176470588235
E02004787,Hythe,New Forest,South East,1037,3839,562,717,467,821,6406,980,4099,525,692,528,854,6698,1028,462,662,509,811,3472,0.250792876311295,0.88,0.956647398843931,0.964015151515152,0.949648711943794,0.518363690653927
E02004788,Ringwood North & Ibsley,New Forest,South East,1245,3993,515,549,372,497,5926,1201,4429,514,530,414,504,6391,1005,427,496,395,482,2805,0.226913524497629,0.830739299610895,0.935849056603774,0.954106280193237,0.956349206349206,0.438898450946644
E02004789,Langdown & Dibden Purlieu,New Forest,South East,1999,6097,613,628,505,851,8694,1949,6445,624,614,505,846,9034,1560,540,573,483,815,3971,0.242048099301784,0.865384615384615,0.933224755700326,0.956435643564356,0.963356973995272,0.439561655966349
E02004790,Ringwood South,New Forest,South East,1468,4534,478,472,408,739,6631,1375,4903,427,521,421,728,7000,1115,323,481,398,697,3014,0.227411788700795,0.756440281030445,0.923224568138196,0.945368171021378,0.957417582417582,0.430571428571429
E02004791,Holbury South,New Forest,South East,1241,3269,339,292,218,249,4367,1181,3483,336,318,228,260,4625,874,281,303,217,244,1919,0.250933103646282,0.836309523809524,0.952830188679245,0.951754385964912,0.938461538461539,0.414918918918919
E02004792,"Holbury North, Blackfield & Fawley",New Forest,South East,1282,4616,709,695,486,651,7157,1298,4965,706,727,503,677,7578,1216,622,689,482,648,3657,0.244914400805639,0.881019830028329,0.947730398899587,0.958250497017893,0.957163958641063,0.482581155977831
E02004793,Brockenhurst & Sway,New Forest,South East,1029,3941,610,673,509,805,6538,1061,4293,587,659,523,826,6888,764,489,638,500,779,3170,0.177964127649662,0.83304940374787,0.968133535660091,0.956022944550669,0.943099273607748,0.460220673635308
E02004794,Bransgore & Burley,New Forest,South East,1145,3778,542,615,351,532,5818,1127,3998,578,608,397,570,6151,1060,516,576,385,538,3075,0.265132566283142,0.892733564013841,0.947368421052632,0.969773299748111,0.943859649122807,0.499918712404487
E02004795,Lymington Town & Boldre,New Forest,South East,1226,5217,701,736,550,981,8185,1202,5502,680,761,587,946,8476,873,525,715,561,903,3577,0.158669574700109,0.772058823529412,0.939553219448095,0.955706984667802,0.954545454545455,0.422015101462954
E02004796,Hordle & Bashley,New Forest,South East,1269,4915,845,1029,750,1019,8558,1220,5192,805,1026,777,988,8788,1086,650,962,754,949,4401,0.209167950693374,0.807453416149068,0.937621832358674,0.97039897039897,0.960526315789474,0.500796540737369
E02004797,Lymington North & West,New Forest,South East,1455,4804,562,507,362,523,6758,1406,5160,541,529,400,545,7175,1076,401,503,384,525,2889,0.208527131782946,0.741219963031423,0.950850661625709,0.96,0.963302752293578,0.402648083623693
E02004798,New Milton West,New Forest,South East,1204,3625,327,425,285,464,5126,1106,3975,339,397,320,450,5481,896,264,368,301,431,2260,0.225408805031447,0.778761061946903,0.926952141057935,0.940625,0.957777777777778,0.412333515781792
E02004799,New Milton East,New Forest,South East,1104,4032,558,745,589,1115,7039,1063,4353,524,688,596,1072,7233,1043,412,631,564,1007,3657,0.239604870204457,0.786259541984733,0.917151162790698,0.946308724832215,0.939365671641791,0.505599336374948
E02004800,Barton on Sea,New Forest,South East,574,3181,789,994,786,1340,7090,564,3353,744,950,822,1267,7136,768,648,914,794,1211,4335,0.229048613182225,0.870967741935484,0.962105263157895,0.965936739659367,0.955801104972376,0.607483183856502
E02004801,Milford & Lymington South,New Forest,South East,848,3388,739,986,711,1302,7126,846,3566,665,954,775,1221,7181,624,518,905,745,1188,3980,0.174985978687605,0.778947368421053,0.948637316561845,0.961290322580645,0.972972972972973,0.55424035649631
E02004802,Hawley Lane & Fox Lane,Rushmoor,South East,1317,4088,325,338,206,347,5304,1251,4702,317,341,258,380,5998,929,255,311,235,352,2082,0.197575499787325,0.804416403785489,0.912023460410557,0.910852713178295,0.926315789473684,0.347115705235078
E02004803,Mayfield,Rushmoor,South East,1537,4756,291,297,210,219,5773,1561,5567,330,354,235,247,6733,1017,276,316,206,210,2025,0.182683671636429,0.836363636363636,0.892655367231638,0.876595744680851,0.850202429149798,0.300757463240755
E02004804,Pinewood,Rushmoor,South East,1315,4324,374,389,258,267,5612,1263,4717,369,432,271,279,6068,850,342,408,256,265,2121,0.180199279202883,0.926829268292683,0.944444444444444,0.944649446494465,0.949820788530466,0.349538562953197
E02004805,Farnborough Hill,Rushmoor,South East,1450,5215,421,385,293,400,6714,1470,5792,415,467,364,444,7482,873,378,439,345,428,2463,0.150725138121547,0.910843373493976,0.940042826552462,0.947802197802198,0.963963963963964,0.329190056134723
E02004806,Cove & Southwood,Rushmoor,South East,1670,5117,377,284,212,240,6230,1643,5458,385,357,223,275,6698,910,353,347,214,261,2085,0.166727739098571,0.916883116883117,0.971988795518207,0.959641255605381,0.949090909090909,0.311286951328755
E02004807,Farnborough Town,Rushmoor,South East,1833,5803,369,418,295,471,7356,1838,6344,425,410,351,504,8034,1054,382,386,333,477,2632,0.166141235813367,0.898823529411765,0.941463414634146,0.948717948717949,0.946428571428571,0.327607667413493
E02004808,South Farnborough & North Camp,Rushmoor,South East,2540,7545,333,332,216,391,8817,2352,7608,409,364,273,401,9055,1316,342,338,253,377,2626,0.172975814931651,0.836185819070905,0.928571428571429,0.926739926739927,0.940149625935162,0.290005521811154
E02004809,Aldershot Town,Rushmoor,South East,2230,6496,204,213,136,168,7217,2546,8948,255,330,251,196,9980,1325,192,279,212,163,2171,0.148077782744747,0.752941176470588,0.845454545454546,0.844621513944223,0.831632653061224,0.217535070140281
E02004810,Aldershot North Town,Rushmoor,South East,1549,5215,226,236,161,198,6036,1608,5757,302,260,200,233,6752,1280,254,237,175,221,2167,0.222338023276012,0.841059602649007,0.911538461538461,0.875,0.948497854077253,0.320941943127962
E02004811,Aldershot Rowhill,Rushmoor,South East,1192,4842,365,388,277,468,6340,1241,5661,444,438,338,477,7358,1150,359,407,295,435,2646,0.20314432079138,0.808558558558559,0.929223744292237,0.872781065088758,0.911949685534591,0.359608589290568
E02004812,Aldershot Manor Park,Rushmoor,South East,1196,4259,303,300,215,221,5298,1164,4774,357,342,237,258,5968,996,318,314,227,242,2097,0.208630079597822,0.890756302521008,0.91812865497076,0.957805907172996,0.937984496124031,0.35137399463807
E02004813,Aldershot Park,Rushmoor,South East,1187,3836,262,279,186,323,4886,1244,4423,303,275,218,330,5549,1052,257,250,197,304,2060,0.237847614741126,0.848184818481848,0.909090909090909,0.903669724770642,0.921212121212121,0.371238060911876
E02004814,Andover Charlton & Bourne Valley,Test Valley,South East,1187,4445,403,440,252,326,5866,1177,4643,387,427,305,337,6099,710,322,407,290,325,2054,0.152918371742408,0.832041343669251,0.953161592505855,0.950819672131147,0.964391691394659,0.336776520741105
E02004815,Andover Newbury Road,Test Valley,South East,1897,4948,257,253,166,147,5771,1832,5386,267,228,181,163,6225,717,195,209,170,151,1442,0.133122911251393,0.730337078651685,0.916666666666667,0.939226519337017,0.92638036809816,0.231646586345382
E02004816,Andover London Road & East Anton,Test Valley,South East,4147,10628,592,601,400,597,12818,4655,12398,597,638,499,583,14715,1930,462,597,473,553,4015,0.15567026939829,0.773869346733668,0.935736677115987,0.947895791583166,0.948542024013722,0.27285083248386
E02004817,Andover Central,Test Valley,South East,1431,5071,378,398,289,442,6578,1331,5205,377,407,264,428,6681,823,276,377,246,418,2140,0.158117195004803,0.73209549071618,0.926289926289926,0.931818181818182,0.976635514018692,0.320311330639126
E02004818,Andover West,Test Valley,South East,1795,5940,566,647,497,658,8308,1641,5939,558,679,505,690,8371,924,452,647,495,668,3186,0.155581747768985,0.810035842293907,0.952871870397644,0.98019801980198,0.968115942028986,0.380599689403894
E02004819,Andover South,Test Valley,South East,1322,4969,393,426,325,624,6737,1218,5111,425,395,362,604,6897,776,344,377,350,584,2431,0.151829387595383,0.809411764705882,0.954430379746835,0.966850828729282,0.966887417218543,0.352472089314195
E02004820,Over Wallop & Shipton Bellinger,Test Valley,South East,1312,4418,425,431,287,381,5942,1271,4496,398,464,305,400,6063,751,360,438,298,389,2236,0.167037366548043,0.904522613065327,0.943965517241379,0.977049180327869,0.9725,0.368794326241135
E02004821,"Chilbolton, Clatford & Barton Stacey",Test Valley,South East,853,2939,348,474,293,358,4412,851,2985,354,416,341,345,4441,520,326,398,332,334,1910,0.174204355108878,0.92090395480226,0.956730769230769,0.973607038123167,0.968115942028986,0.430083314568791
E02004822,"Nether Wallop, Kings Somborne & Dunbridge",Test Valley,South East,1274,4425,533,576,402,564,6500,1269,4820,572,581,414,560,6947,959,518,552,399,537,2965,0.19896265560166,0.905594405594406,0.950086058519793,0.963768115942029,0.958928571428572,0.426802936519361
E02004823,Romsey Cupernham & Halterworth,Test Valley,South East,1467,4785,637,688,445,632,7187,1410,5284,573,694,510,631,7692,1208,483,670,488,605,3454,0.228614685844058,0.842931937172775,0.965417867435158,0.956862745098039,0.958795562599049,0.449037961518461
E02004824,Romsey Town,Test Valley,South East,790,3071,385,496,395,831,5178,692,3191,341,504,411,846,5293,744,278,468,388,817,2695,0.233155750548417,0.81524926686217,0.928571428571429,0.944038929440389,0.965721040189125,0.509163045531834
E02004825,North Baddesley & Braishfield,Test Valley,South East,1894,5972,699,792,629,762,8854,1848,6447,668,820,660,822,9417,1428,575,779,633,792,4207,0.221498371335505,0.860778443113773,0.95,0.959090909090909,0.963503649635036,0.446745247955825
E02004826,Abbotswood & West Wellow,Test Valley,South East,1659,4726,520,617,390,580,6833,1824,5815,581,605,456,558,8015,1300,514,579,436,533,3362,0.223559759243336,0.884681583476764,0.95702479338843,0.956140350877193,0.955197132616487,0.419463505926388
E02004827,Valley Park,Test Valley,South East,1570,4854,357,306,170,239,5926,1558,5141,380,341,221,252,6335,1070,320,320,207,234,2151,0.208130713868897,0.842105263157895,0.93841642228739,0.936651583710407,0.928571428571429,0.339542225730071
E02004828,"Chilworth, Nursling & Rownhams",Test Valley,South East,1096,3866,504,415,300,471,5556,1172,4437,519,493,312,463,6224,1192,460,479,302,450,2883,0.268649988731125,0.886319845857418,0.971602434077079,0.967948717948718,0.971922246220302,0.463206940874036
E02004829,"South Wonston, Sutton Scotney & Micheldever",Winchester,South East,1189,3444,340,361,231,313,4689,1175,3421,337,359,254,331,4702,651,312,337,250,321,1871,0.190295235311313,0.925816023738872,0.938718662952646,0.984251968503937,0.969788519637462,0.397915780518928
E02004830,Springvale & Itchen Abbas,Winchester,South East,1346,4066,416,429,297,322,5530,1264,6039,389,395,308,356,7487,900,362,378,299,342,2281,0.14903129657228,0.930591259640103,0.956962025316456,0.970779220779221,0.960674157303371,0.304661413116068
E02004831,Winchester North & Sparsholt,Winchester,South East,1963,5294,470,570,423,985,7742,1980,6136,472,538,439,934,8519,1212,436,511,427,898,3484,0.197522816166884,0.923728813559322,0.949814126394052,0.972665148063781,0.961456102783726,0.408968188754549
E02004832,New Alresford,Winchester,South East,1375,4602,592,654,512,726,7086,1274,4972,557,645,570,813,7557,933,515,613,554,776,3391,0.187650844730491,0.9245960502693,0.950387596899225,0.971929824561404,0.954489544895449,0.448723038242689
E02004833,Winchester West,Winchester,South East,1952,6228,404,449,322,612,8015,1951,7563,425,450,370,608,9416,1349,367,426,350,577,3069,0.178368372339019,0.863529411764706,0.946666666666667,0.945945945945946,0.949013157894737,0.325934579439252
E02004834,Winchester East,Winchester,South East,1428,5322,320,376,254,446,6718,1298,5882,364,301,272,411,7230,1008,295,271,252,391,2217,0.171370282216933,0.81043956043956,0.900332225913621,0.926470588235294,0.951338199513382,0.306639004149378
E02004835,Winchester Central & South,Winchester,South East,1865,7203,409,523,341,655,9131,1730,8214,445,479,393,661,10192,1359,364,431,365,616,3135,0.165449233016801,0.817977528089888,0.899791231732777,0.928753180661578,0.931921331316188,0.307594191522763
E02004836,Winchester Stanmore,Winchester,South East,1038,4990,191,180,156,227,5744,1023,4992,205,195,154,204,5750,963,174,183,138,190,1648,0.192908653846154,0.848780487804878,0.938461538461539,0.896103896103896,0.931372549019608,0.286608695652174
E02004837,Oliver's Battery and Hursley,Winchester,South East,1576,4819,472,506,321,482,6600,1526,5299,423,522,354,501,7099,1109,391,486,342,481,2809,0.209284770711455,0.92434988179669,0.931034482758621,0.966101694915254,0.960079840319361,0.395689533737146
E02004838,Colden Common & Twyford,Winchester,South East,1957,5396,563,632,401,577,7569,1909,5854,551,651,438,609,8103,1305,500,622,425,583,3435,0.222924496071063,0.907441016333938,0.955453149001536,0.970319634703196,0.957307060755337,0.423917067752684
E02004839,"Swanmore, Hambledon & West Meon",Winchester,South East,1563,4907,626,623,430,558,7144,1605,5495,687,611,450,583,7826,940,628,573,421,561,3123,0.171064604185623,0.914119359534207,0.937806873977087,0.935555555555556,0.962264150943396,0.399054433938155
E02004840,Bishop's Waltham & Waltham Chase,Winchester,South East,1699,5496,639,669,476,696,7976,1725,6137,633,707,543,721,8741,1165,557,675,526,697,3620,0.189832165553202,0.879936808846761,0.954738330975955,0.968692449355433,0.966712898751734,0.414140258551653
E02004841,"Whiteley, Knowle & Wickham",Winchester,South East,2274,7213,611,572,391,647,9434,2117,7482,581,611,428,600,9702,1355,494,575,408,564,3396,0.181101309810211,0.85025817555938,0.941080196399345,0.953271028037383,0.94,0.350030921459493
E02004842,Denmead & Southwick,Winchester,South East,1918,6041,603,588,432,674,8338,2126,6597,633,610,446,714,9000,1555,580,591,430,687,3843,0.235713202971047,0.916271721958926,0.968852459016393,0.964125560538117,0.96218487394958,0.427
E02004996,"Wye, Chilham & Kennington",Ashford,South East,1704,4893,442,500,340,517,6692,1809,5512,489,515,412,515,7443,1019,372,466,379,485,2721,0.184869375907112,0.760736196319019,0.904854368932039,0.919902912621359,0.941747572815534,0.365578395808142
E02004997,"Charing, Pluckley & Challock",Ashford,South East,1282,4485,570,630,440,564,6689,1330,5087,578,673,464,583,7385,982,372,625,442,562,2983,0.193041085118931,0.643598615916955,0.928677563150074,0.952586206896552,0.963979416809605,0.403926878808395
E02004998,Kennington & Little Burton Farm,Ashford,South East,1286,3956,357,410,311,411,5445,1240,4342,375,418,352,441,5928,838,287,399,332,418,2274,0.192998618148319,0.765333333333333,0.954545454545455,0.943181818181818,0.947845804988662,0.383603238866397
E02004999,"Bybrook, Orchard Park & Godinton",Ashford,South East,3472,9359,690,679,503,638,11869,3508,10475,684,720,517,676,13072,1976,441,656,483,635,4191,0.188639618138425,0.644736842105263,0.911111111111111,0.934235976789168,0.939349112426035,0.320608935128519
E02005000,Ashford Central,Ashford,South East,2782,7624,417,393,284,344,9062,2544,8470,408,423,327,340,9968,1463,224,365,295,308,2655,0.172727272727273,0.549019607843137,0.862884160756501,0.902140672782875,0.905882352941176,0.266352327447833
E02005001,Highfield & Willesborough,Ashford,South East,1711,5486,505,548,340,440,7319,1827,6203,538,569,368,486,8164,1467,387,537,350,456,3197,0.236498468482992,0.719330855018587,0.943760984182777,0.951086956521739,0.938271604938272,0.391597256246938
E02005002,Beaver & Singtleton,Ashford,South East,2211,5874,423,377,289,361,7324,2236,6485,402,412,314,376,7989,1186,231,377,294,348,2436,0.182883577486507,0.574626865671642,0.91504854368932,0.936305732484076,0.925531914893617,0.304919263987983
E02005003,Washford & Stanhope,Ashford,South East,2549,6204,316,318,180,214,7232,2403,6857,331,344,234,239,8005,1219,200,309,209,218,2155,0.17777453696952,0.604229607250755,0.898255813953488,0.893162393162393,0.912133891213389,0.269206745783885
E02005004,Park Farm,Ashford,South East,2902,8240,391,350,253,289,9523,2693,8549,444,417,276,363,10049,1713,298,377,250,321,2959,0.200374312785121,0.671171171171171,0.904076738609113,0.905797101449275,0.884297520661157,0.29445715991641
E02005005,Brabourne Lees & North Romney,Ashford,South East,2056,5610,534,654,364,454,7616,2126,6278,581,631,430,479,8399,1345,442,600,419,462,3268,0.214240203886588,0.760757314974183,0.950871632329635,0.974418604651163,0.964509394572025,0.389093939754733
E02005006,"Biddenden, Smarden & High Halden",Ashford,South East,1005,3273,395,482,292,413,4855,1063,3720,386,492,371,446,5415,852,287,469,356,433,2397,0.229032258064516,0.743523316062176,0.953252032520325,0.959568733153639,0.97085201793722,0.442659279778393
E02005007,"Great Chart, Bethersden & Woodchurch",Ashford,South East,1695,5488,541,632,376,527,7564,1729,5836,590,576,462,573,8037,1036,406,544,445,544,2975,0.177518848526388,0.688135593220339,0.944444444444444,0.963203463203463,0.949389179755672,0.370162996142839
E02005008,Tenterden & Rolvenden,Ashford,South East,1156,4206,616,780,614,960,7176,1181,4579,614,780,682,995,7650,734,440,735,651,947,3507,0.160297008080367,0.716612377850163,0.942307692307692,0.954545454545455,0.951758793969849,0.45843137254902
E02005009,Hamstreet & Isle of Oxney,Ashford,South East,1051,3194,418,513,323,356,4804,1017,3598,442,499,361,399,5299,653,285,468,347,390,2143,0.181489716509172,0.644796380090498,0.937875751503006,0.961218836565097,0.977443609022556,0.404415927533497
E02005010,Herne Bay Parade,Canterbury,South East,1462,4803,481,441,299,581,6605,1321,5021,463,449,341,558,6832,1103,347,414,317,535,2716,0.219677355108544,0.749460043196544,0.922048997772828,0.929618768328446,0.958781362007169,0.397540983606557
E02005011,Beltinge & Bishopstone,Canterbury,South East,1055,3919,621,794,485,784,6603,1027,4136,640,778,588,791,6933,1020,505,740,577,747,3589,0.246615087040619,0.7890625,0.951156812339332,0.981292517006803,0.944374209860936,0.51766911870763
E02005012,Herne Bay South & Greenhill,Canterbury,South East,1621,5049,583,648,439,602,7321,1535,5406,603,649,486,596,7740,1369,490,622,464,569,3514,0.253237143914169,0.812603648424544,0.958397534668721,0.954732510288066,0.954697986577181,0.454005167958656
E02005013,"Hampton, West End & Swalecliffe",Canterbury,South East,1374,4702,563,668,451,663,7047,1305,5014,570,694,499,671,7448,1225,466,649,474,631,3445,0.244315915436777,0.817543859649123,0.935158501440922,0.949899799599198,0.940387481371088,0.462540279269603
E02005014,Chestfield & South Tankerton,Canterbury,South East,1171,4544,786,842,598,843,7613,1167,4777,736,845,624,861,7843,1015,694,820,604,831,3964,0.212476449654595,0.942934782608696,0.970414201183432,0.967948717948718,0.965156794425087,0.505418844829785
E02005015,Herne & Broomfield,Canterbury,South East,1992,5707,528,596,384,464,7679,1938,5935,560,615,418,494,8022,1431,449,592,401,481,3354,0.241112047177759,0.801785714285714,0.96260162601626,0.95933014354067,0.973684210526316,0.418100224382947
E02005016,Whitstable Central & Tankerton,Canterbury,South East,1371,4483,566,533,394,592,6568,1369,4966,540,550,423,546,7025,913,489,522,405,523,2852,0.18385018123238,0.905555555555556,0.949090909090909,0.957446808510638,0.957875457875458,0.405978647686833
E02005017,Whitstable West,Canterbury,South East,1148,4166,418,423,299,462,5768,1049,4470,419,481,336,459,6165,775,363,443,320,436,2337,0.17337807606264,0.866348448687351,0.920997920997921,0.952380952380952,0.949891067538126,0.379075425790754
E02005018,Seasalter,Canterbury,South East,1559,4958,607,710,520,617,7412,1484,5418,630,696,545,624,7913,1134,577,658,514,605,3488,0.209302325581395,0.915873015873016,0.945402298850575,0.943119266055046,0.969551282051282,0.440793630734235
E02005019,"Hoath, Hersden & Littlebourne",Canterbury,South East,1189,3820,418,400,244,439,5321,1168,4461,441,435,288,442,6067,795,375,406,272,427,2275,0.178211163416274,0.850340136054422,0.933333333333333,0.944444444444444,0.96606334841629,0.374979396736443
E02005020,Sturry and Fordwich,Canterbury,South East,1409,4414,447,438,343,465,6107,1453,4877,456,443,369,435,6580,915,395,413,358,407,2488,0.187615337297519,0.866228070175439,0.932279909706546,0.970189701897019,0.935632183908046,0.378115501519757
E02005021,"Blean Forest, Chartham Hatch & University",Canterbury,South East,1181,9084,379,538,379,430,10810,1147,11898,380,507,391,511,13687,888,326,480,373,491,2558,0.0746343923348462,0.857894736842105,0.946745562130177,0.953964194373401,0.960861056751468,0.186892671878425
E02005022,Canterbury St Stephen's,Canterbury,South East,1073,7065,263,298,158,281,8065,1104,5808,260,287,198,268,6821,684,207,263,182,256,1592,0.117768595041322,0.796153846153846,0.916376306620209,0.919191919191919,0.955223880597015,0.233396862630113
E02005023,Canterbury Barracks,Canterbury,South East,1801,7649,246,227,142,298,8562,1883,7789,272,273,162,286,8782,970,184,230,145,264,1793,0.124534600077032,0.676470588235294,0.842490842490843,0.895061728395062,0.923076923076923,0.204167615577317
E02005025,South Canterbury,Canterbury,South East,1284,8120,396,444,315,513,9788,1237,8602,440,485,316,522,10365,1040,363,449,296,501,2649,0.120902115787026,0.825,0.925773195876289,0.936708860759494,0.959770114942529,0.255571635311143
E02005026,Thanington & Chartham,Canterbury,South East,1666,4882,431,401,300,401,6415,1617,5361,476,451,322,377,6987,1120,424,424,305,353,2626,0.208916246968849,0.890756302521008,0.940133037694013,0.947204968944099,0.936339522546419,0.37584084728782
E02005027,"Bridge, Bishopsbourne & Barham",Canterbury,South East,860,3164,371,381,282,495,4693,849,3416,374,398,298,457,4943,730,344,383,291,444,2192,0.213700234192037,0.919786096256684,0.962311557788945,0.976510067114094,0.971553610503282,0.443455391462675
E02006855,Canterbury Wincheap,Canterbury,South East,1220,5210,182,191,85,182,5850,1248,5105,226,189,123,178,5821,821,160,163,114,162,1420,0.160822722820764,0.707964601769912,0.862433862433863,0.926829268292683,0.910112359550562,0.243944339460574
E02006856,Canterbury Central & Westgate,Canterbury,South East,1804,9275,401,371,289,591,10927,1821,9058,400,395,315,544,10712,925,316,358,295,511,2405,0.102119673217046,0.79,0.90632911392405,0.936507936507937,0.939338235294118,0.224514563106796
E02005028,Temple Hill & Marshes,Dartford,South East,3919,7936,270,201,170,333,8910,4256,8939,309,255,159,329,9991,1604,218,209,130,288,2449,0.179438415930194,0.705501618122977,0.819607843137255,0.817610062893082,0.875379939209726,0.245120608547693
E02005029,Ebbsfleet & Greenhithe,Dartford,South East,3171,8943,334,230,139,202,9848,3622,9170,328,290,167,204,10159,1477,259,245,152,185,2318,0.161068702290076,0.789634146341463,0.844827586206897,0.910179640718563,0.906862745098039,0.228172064179545
E02005030,Central Dartford & West Hill,Dartford,South East,2670,7601,357,273,233,328,8792,2776,8272,384,336,281,338,9611,1476,307,287,248,302,2620,0.178433268858801,0.799479166666667,0.854166666666667,0.882562277580071,0.893491124260355,0.272604307564249
E02005031,Swanscombe,Dartford,South East,1937,5763,286,225,150,247,6671,1952,5537,318,242,177,243,6517,1011,216,216,161,226,1830,0.182589850099332,0.679245283018868,0.892561983471074,0.909604519774011,0.930041152263374,0.280804050943686
E02005032,Newtown,Dartford,South East,2202,6932,294,254,188,255,7923,2218,6801,303,297,188,258,7847,1275,234,262,163,225,2159,0.187472430524923,0.772277227722772,0.882154882154882,0.867021276595745,0.872093023255814,0.275136995029948
E02005033,Stone & Crossways,Dartford,South East,1683,4944,265,261,187,185,5842,1750,5021,277,296,178,201,5973,1053,208,254,155,175,1845,0.209719179446325,0.750902527075812,0.858108108108108,0.870786516853933,0.870646766169154,0.308890005022602
E02005034,Heath,Dartford,South East,1478,4692,395,397,244,353,6081,1472,5127,377,431,275,388,6598,1132,338,412,259,358,2499,0.220791886093232,0.896551724137931,0.955916473317865,0.941818181818182,0.922680412371134,0.378751136708093
E02005035,Brent & Fleet Estate,Dartford,South East,1813,5256,344,390,245,457,6692,1901,5638,383,399,266,464,7150,1312,316,363,245,420,2656,0.232706633557999,0.825065274151436,0.909774436090226,0.921052631578947,0.905172413793103,0.371468531468532
E02005036,Tree Estate,Dartford,South East,1621,4079,244,250,178,238,4989,1590,4503,274,255,183,234,5449,970,216,232,172,199,1789,0.215411947590495,0.788321167883212,0.909803921568627,0.939890710382514,0.85042735042735,0.328317122407781
E02005037,Joydens Wood,Dartford,South East,1368,4154,332,435,298,568,5787,1331,4465,378,440,327,581,6191,1002,310,420,307,543,2582,0.22441209406495,0.82010582010582,0.954545454545455,0.938837920489297,0.934595524956971,0.417057018252302
E02005038,Wilmington & Hawley,Dartford,South East,1020,3343,379,342,272,480,4816,1043,3570,358,380,260,461,5029,840,323,348,243,416,2170,0.235294117647059,0.902234636871508,0.91578947368421,0.934615384615385,0.902386117136659,0.431497315569696
E02005039,"Bean, Darenth & Sutton at Hone",Dartford,South East,1387,4062,352,350,273,358,5395,1429,4556,401,350,281,344,5932,1061,314,314,258,320,2267,0.2328797190518,0.783042394014963,0.897142857142857,0.918149466192171,0.930232558139535,0.382164531355361
E02005040,"Longfield, New Barn & Southfleet",Dartford,South East,1102,3656,439,450,353,591,5489,1117,4074,476,473,365,627,6015,1107,420,441,354,597,2919,0.271723122238586,0.882352941176471,0.932346723044397,0.96986301369863,0.952153110047847,0.485286783042394
E02005041,Ash & Wingham,Dover,South East,1179,4182,519,526,371,434,6032,1149,4380,480,546,415,471,6292,1121,411,515,396,455,2898,0.255936073059361,0.85625,0.943223443223443,0.954216867469879,0.966029723991507,0.460584869675779
E02005042,Sandwich & Eastry,Dover,South East,1402,5089,668,788,495,752,7792,1240,5237,701,761,556,743,7998,1022,607,711,530,709,3579,0.195149894978041,0.865905848787446,0.934296977660972,0.953237410071942,0.954239569313594,0.44748687171793
E02005043,Deal North & West,Dover,South East,1099,4282,549,607,378,598,6414,1057,4327,545,577,447,611,6507,1079,463,543,421,568,3074,0.249364455743009,0.84954128440367,0.94107452339688,0.941834451901566,0.92962356792144,0.47241432303673
E02005044,Deal East,Dover,South East,756,3860,537,594,372,488,5851,678,3571,510,569,434,514,5598,888,414,523,402,475,2702,0.248669840380846,0.811764705882353,0.919156414762742,0.926267281105991,0.924124513618677,0.482672382993926
E02005045,"Mill Hill, Upper Deal & Northbourne",Dover,South East,1862,5650,554,553,347,474,7578,1918,5631,572,505,394,475,7577,1483,492,468,376,445,3264,0.263363523352868,0.86013986013986,0.926732673267327,0.954314720812183,0.936842105263158,0.430777352514188
E02005046,Aylesham & Elvington,Dover,South East,1820,4755,351,420,294,288,6108,2040,5442,373,408,303,320,6846,1367,320,372,284,304,2647,0.251194413818449,0.857908847184987,0.911764705882353,0.937293729372937,0.95,0.386649138182881
E02005047,Walmer,Dover,South East,1314,4306,523,549,413,662,6453,1330,4546,557,525,468,621,6717,1271,456,488,445,591,3251,0.279586449626045,0.818671454219031,0.92952380952381,0.950854700854701,0.951690821256039,0.483995831472384
E02005048,Eythorne & Shepherdswell,Dover,South East,997,3842,530,567,350,497,5786,931,3820,537,547,366,484,5754,1068,479,519,346,458,2870,0.279581151832461,0.891992551210428,0.948811700182815,0.945355191256831,0.946280991735537,0.498783454987835
E02005049,Kingsdown & St Margaret's-at-Cliffe,Dover,South East,855,3513,700,769,527,691,6200,814,3497,666,724,598,698,6183,1114,599,676,566,654,3609,0.318558764655419,0.899399399399399,0.933701657458563,0.946488294314381,0.936962750716332,0.583697234352256
E02005050,"Kearsney, River & Whitfield",Dover,South East,1614,5626,615,677,453,762,8133,1538,5472,607,679,511,769,8038,1678,565,649,493,735,4120,0.306652046783626,0.930807248764415,0.955817378497791,0.964774951076321,0.955786736020806,0.512565314754914
E02005051,Buckland & St Radigunds,Dover,South East,3383,8987,537,553,302,419,10798,3234,9032,561,540,322,391,10846,2357,471,490,297,338,3953,0.260961027457927,0.839572192513369,0.907407407407407,0.922360248447205,0.864450127877238,0.364466162640605
E02005052,Dover East,Dover,South East,1361,5188,432,420,290,432,6762,1684,5514,441,402,310,433,7100,1129,346,350,277,391,2493,0.204751541530649,0.784580498866213,0.870646766169154,0.893548387096774,0.903002309468822,0.35112676056338
E02005053,Dover West,Dover,South East,2132,6447,416,370,180,294,7707,2087,6499,454,359,210,295,7817,1343,381,315,191,262,2492,0.206647176488691,0.83920704845815,0.877437325905292,0.909523809523809,0.888135593220339,0.318792375591659
E02005054,Elms Vale & Capel-le-Ferne,Dover,South East,942,3899,547,575,358,422,5801,982,3904,527,595,401,454,5881,1216,473,557,375,420,3041,0.311475409836066,0.89753320683112,0.936134453781513,0.935162094763092,0.92511013215859,0.517088930454004
E02005055,Northfleet North,Gravesham,South East,2450,5539,248,258,138,183,6366,2467,5938,277,239,157,195,6806,1159,219,205,141,176,1900,0.19518356348939,0.790613718411552,0.857740585774059,0.898089171974522,0.902564102564103,0.279165442256832
E02005056,Gravesend Town,Gravesham,South East,2156,7303,404,277,264,443,8691,2228,8296,428,364,253,464,9805,1336,332,314,212,384,2578,0.161041465766635,0.775700934579439,0.862637362637363,0.837944664031621,0.827586206896552,0.262927078021418
E02005057,Milton & Chalk,Gravesham,South East,2729,7526,365,392,244,432,8959,2886,8360,414,428,261,452,9915,1755,338,388,230,386,3097,0.209928229665072,0.816425120772947,0.906542056074766,0.881226053639847,0.853982300884956,0.312355017650025
E02005058,Perry Street,Gravesham,South East,1982,5048,334,266,205,297,6150,2000,5582,345,316,191,289,6723,1269,286,292,177,255,2279,0.227337871730563,0.828985507246377,0.924050632911392,0.926701570680628,0.882352941176471,0.338985571917299
E02005059,Windmill Hill,Gravesham,South East,1812,6178,480,443,315,521,7937,1806,6515,520,441,344,554,8374,1698,470,408,314,495,3385,0.26062931696086,0.903846153846154,0.925170068027211,0.912790697674419,0.893501805054152,0.40422737043229
E02005060,Northfleet South,Gravesham,South East,1749,4812,367,365,273,518,6335,1854,5386,384,362,289,486,6907,1283,331,335,275,453,2677,0.23821017452655,0.861979166666667,0.925414364640884,0.951557093425606,0.932098765432099,0.387577819603301
E02005061,Westcourt,Gravesham,South East,1692,4356,316,346,240,320,5578,1795,4989,333,341,268,381,6312,1205,282,293,241,328,2349,0.241531369011826,0.846846846846847,0.859237536656891,0.899253731343284,0.860892388451444,0.372148288973384
E02005062,Riverview Park,Gravesham,South East,1503,4032,386,370,278,417,5483,1518,4505,357,368,293,425,5948,1243,327,344,278,399,2591,0.275915649278579,0.915966386554622,0.934782608695652,0.948805460750853,0.938823529411765,0.435608607935441
E02005063,Gravesend South & Coldharbour,Gravesham,South East,1421,4168,320,339,239,374,5440,1513,4662,348,345,255,369,5979,1323,319,326,240,340,2548,0.283783783783784,0.916666666666667,0.944927536231884,0.941176470588235,0.921409214092141,0.4261582204382
E02005064,Higham & Shorne,Gravesham,South East,1072,3873,446,485,350,461,5615,1088,4115,458,491,386,492,5942,1095,412,474,369,463,2813,0.266099635479951,0.899563318777293,0.965376782077393,0.955958549222798,0.941056910569106,0.473409626388421
E02005065,Singlewell,Gravesham,South East,2052,5058,321,297,208,369,6253,2079,5509,306,300,233,338,6686,1400,248,275,214,305,2442,0.254129606099111,0.810457516339869,0.916666666666667,0.918454935622318,0.902366863905325,0.365240801675142
E02005066,Istead Rise & Meopham,Gravesham,South East,1236,4243,505,626,464,618,6456,1281,4644,518,601,512,665,6940,1429,472,580,494,642,3617,0.30770887166236,0.911196911196911,0.965058236272879,0.96484375,0.965413533834587,0.521181556195965
E02005067,Sole Street & Vigo,Gravesham,South East,1029,3365,363,436,300,329,4793,1040,3748,396,446,301,354,5245,1132,351,418,283,330,2514,0.302027748132337,0.886363636363636,0.937219730941704,0.940199335548173,0.932203389830508,0.479313632030505
E02005068,Boxley & Detling,Maidstone,South East,1272,4601,369,394,202,268,5834,1294,4696,383,399,221,243,5942,954,329,381,210,230,2104,0.203151618398637,0.859007832898172,0.954887218045113,0.950226244343891,0.946502057613169,0.354089532144059
E02005069,Penenden Heath,Maidstone,South East,1827,5477,458,536,287,519,7277,1731,5641,458,545,343,496,7483,887,410,522,318,469,2606,0.157241623825563,0.895196506550218,0.957798165137615,0.927113702623907,0.945564516129032,0.348256047039957
E02005070,Allington,Maidstone,South East,1554,5043,562,706,550,891,7752,1606,5374,532,707,543,913,8069,1157,478,666,520,879,3700,0.215295868998884,0.898496240601504,0.942008486562942,0.957642725598527,0.96276013143483,0.458545048952782
E02005071,Ringlestone & Central Maidstone,Maidstone,South East,2299,8522,330,302,150,378,9682,2068,8742,386,322,203,370,10023,1049,310,281,188,342,2170,0.119995424388012,0.803108808290156,0.872670807453416,0.926108374384236,0.924324324324324,0.21650204529582
E02005072,Grove Green,Maidstone,South East,1507,4331,514,573,341,376,6135,1509,4706,521,596,387,438,6648,1171,483,560,374,421,3009,0.24883127921802,0.927063339731286,0.939597315436242,0.96640826873385,0.961187214611872,0.452617328519856
E02005073,Maidstone West,Maidstone,South East,2332,8745,407,332,233,441,10158,2250,8772,411,410,233,452,10278,1379,324,372,217,411,2703,0.157204742362061,0.788321167883212,0.907317073170732,0.931330472103004,0.90929203539823,0.262988908347928
E02005074,Bearsted & Downswood,Maidstone,South East,1508,4526,513,611,410,608,6668,1463,4804,475,604,439,640,6962,1483,443,575,421,622,3544,0.308701082431307,0.932631578947368,0.951986754966887,0.958997722095672,0.971875,0.509049123814996
E02005075,Barming,Maidstone,South East,2489,6853,390,382,272,401,8298,2403,7390,434,364,286,371,8845,1852,375,339,265,353,3184,0.250608930987821,0.864055299539171,0.931318681318681,0.926573426573426,0.951482479784367,0.359977388355003
E02005076,Tovil,Maidstone,South East,2346,6646,289,265,186,344,7730,2203,6802,305,286,190,343,7926,1145,247,250,174,315,2131,0.168332843281388,0.809836065573771,0.874125874125874,0.91578947368421,0.918367346938776,0.268861973252586
E02005077,Mote Park,Maidstone,South East,1774,4858,416,435,288,422,6419,1687,5250,400,456,322,400,6828,892,308,416,298,373,2287,0.169904761904762,0.77,0.912280701754386,0.925465838509317,0.9325,0.334944346807264
E02005078,"Harrietsham, Hollingbourne & Lenham",Maidstone,South East,1559,5218,615,679,442,652,7606,1668,5922,652,720,494,623,8411,1749,602,682,474,597,4104,0.295339412360689,0.923312883435583,0.947222222222222,0.959514170040486,0.958266452648475,0.487932469385329
E02005079,Loose Valley & Boughton Monchelsea,Maidstone,South East,1798,4948,499,593,439,601,7080,1743,5190,480,599,473,587,7329,1072,391,562,464,563,3052,0.206551059730251,0.814583333333333,0.938230383973289,0.980972515856237,0.959114139693356,0.416427889207259
E02005080,Parkwood & Senacre,Maidstone,South East,3395,7240,406,527,384,557,9114,3145,7682,445,511,404,531,9573,1247,335,458,372,495,2907,0.162327518875293,0.752808988764045,0.896281800391389,0.920792079207921,0.932203389830508,0.303666562206205
E02005081,Yalding & Farleigh,Maidstone,South East,1076,3583,487,530,416,520,5536,1121,4135,521,552,429,561,6198,940,467,505,408,545,2865,0.2273276904474,0.896353166986564,0.914855072463768,0.951048951048951,0.971479500891266,0.462245885769603
E02005082,"Kingswood, Langley Heath & Chart Sutton",Maidstone,South East,2270,7151,536,609,368,507,9171,2542,7778,583,612,430,538,9941,2104,515,584,420,515,4138,0.270506556955516,0.88336192109777,0.954248366013072,0.976744186046512,0.95724907063197,0.416255909868223
E02005083,Loose & Coxheath,Maidstone,South East,1266,4257,458,509,379,485,6088,1432,4564,445,477,403,502,6391,1080,400,448,395,485,2808,0.236634531113059,0.898876404494382,0.939203354297694,0.98014888337469,0.966135458167331,0.439367861054608
E02005084,Headcorn & Sutton Valence,Maidstone,South East,1404,4409,393,470,312,431,6015,1445,4720,412,451,372,458,6413,1692,370,427,355,441,3285,0.358474576271186,0.898058252427185,0.946784922394679,0.954301075268817,0.962882096069869,0.512240760954312
E02005085,Marden,Maidstone,South East,1413,4528,417,344,282,364,5935,1646,5378,431,398,282,367,6856,1153,388,368,269,353,2531,0.21439196727408,0.900232018561485,0.924623115577889,0.953900709219858,0.961852861035422,0.36916569428238
E02005086,Staplehurst,Maidstone,South East,1196,3597,422,404,255,365,5043,1187,3987,410,415,320,375,5507,905,343,390,304,358,2300,0.226987710057688,0.836585365853659,0.939759036144578,0.95,0.954666666666667,0.417650263301253
E02005087,Swanley East & Hextable,Sevenoaks,South East,1298,4268,423,511,275,417,5894,1340,4540,429,498,323,483,6273,982,387,461,304,438,2572,0.216299559471366,0.902097902097902,0.92570281124498,0.941176470588235,0.906832298136646,0.410011158935119
E02005088,Swanley West,Sevenoaks,South East,2089,5845,479,431,297,530,7582,2252,6389,443,475,295,526,8128,1475,367,429,266,462,2999,0.230865550164345,0.828442437923251,0.903157894736842,0.901694915254237,0.878326996197719,0.368971456692913
E02005089,Swanley South & Crockenhill,Sevenoaks,South East,1200,3960,305,388,295,429,5377,1317,4291,343,362,310,408,5714,948,305,335,291,377,2256,0.220927522721976,0.889212827988338,0.925414364640884,0.938709677419355,0.924019607843137,0.394819740987049
E02005090,Hartley & Hodsoll Street,Sevenoaks,South East,892,3160,377,556,398,559,5050,904,3375,375,467,435,631,5283,860,332,439,418,597,2646,0.254814814814815,0.885333333333333,0.940042826552462,0.960919540229885,0.946117274167987,0.500851788756388
E02005091,Darenth Valley,Sevenoaks,South East,1222,4125,408,421,316,491,5761,1179,4172,443,424,327,488,5854,873,396,401,308,449,2427,0.209252157238734,0.893905191873589,0.945754716981132,0.941896024464832,0.920081967213115,0.414588315681585
E02005093,West Kingsdown,Sevenoaks,South East,893,3218,481,521,382,481,5083,918,3541,437,517,395,471,5361,810,385,468,365,394,2422,0.228748940977125,0.881006864988559,0.905222437137331,0.924050632911392,0.83651804670913,0.451781384070136
E02005094,"Knockholt, Shoreham & Dunton Green",Sevenoaks,South East,1995,5725,479,459,347,476,7486,1998,6029,503,494,369,532,7927,981,443,459,349,504,2736,0.162713551169348,0.880715705765408,0.92914979757085,0.94579945799458,0.947368421052632,0.345149489087927
E02005095,Kemsing & Otford,Sevenoaks,South East,1588,4118,427,477,347,545,5914,1578,4547,413,435,371,544,6310,773,356,413,354,530,2426,0.170002199252254,0.861985472154964,0.949425287356322,0.954177897574124,0.974264705882353,0.384469096671949
E02005096,Sevenoaks North,Sevenoaks,South East,2373,5961,480,443,294,581,7759,2319,6414,412,471,315,536,8148,988,352,440,294,509,2583,0.154038041783598,0.854368932038835,0.934182590233546,0.933333333333333,0.949626865671642,0.317010309278351
E02005097,Sevenoaks West & Chevening,Sevenoaks,South East,2546,5669,466,485,316,585,7521,2426,6032,442,472,367,575,7888,805,400,444,345,551,2545,0.133454907161804,0.904977375565611,0.940677966101695,0.940054495912807,0.958260869565217,0.322641987829615
E02005098,Sevenoaks Town & Weald,Sevenoaks,South East,2150,6101,483,486,368,863,8301,2092,6663,455,508,416,846,8888,879,404,457,390,796,2926,0.131922557406574,0.887912087912088,0.899606299212598,0.9375,0.940898345153664,0.329207920792079
E02005099,Westerham & Brasted,Sevenoaks,South East,1503,4648,496,495,335,411,6385,1470,4819,513,488,378,458,6656,682,461,464,366,448,2421,0.141523137580411,0.898635477582846,0.950819672131147,0.968253968253968,0.978165938864629,0.363731971153846
E02005100,Edenbridge,Sevenoaks,South East,2028,5778,492,530,368,569,7737,2009,6059,471,531,426,578,8065,1072,411,511,414,560,2968,0.176926885624691,0.872611464968153,0.962335216572505,0.971830985915493,0.968858131487889,0.368009919404836
E02005101,"Hever, Leigh & Penshurst",Sevenoaks,South East,1388,4176,466,420,283,346,5691,1391,4491,447,460,301,360,6059,775,385,442,274,345,2221,0.172567356936094,0.861297539149888,0.960869565217391,0.910299003322259,0.958333333333333,0.366562138966826
E02006832,New Ash Green,Sevenoaks,South East,1254,3481,447,440,217,205,4790,1244,3580,421,450,293,225,4969,888,356,421,279,210,2154,0.24804469273743,0.845605700712589,0.935555555555556,0.95221843003413,0.933333333333333,0.433487623264238
E02005102,"Lyminge, Densole & Elham",Folkestone and Hythe,South East,790,3533,548,663,331,529,5604,789,3631,538,620,414,520,5723,1020,468,591,391,494,2964,0.28091434866428,0.869888475836431,0.953225806451613,0.944444444444444,0.95,0.517910186964879
E02005103,Hawkinge,Folkestone and Hythe,South East,2190,6431,415,577,316,393,8132,2122,6495,421,571,398,453,8338,1604,363,536,371,427,3301,0.246959199384142,0.862232779097387,0.938704028021016,0.9321608040201,0.942604856512141,0.395898296953706
E02005104,Folkestone North East,Folkestone and Hythe,South East,1654,4855,484,482,308,372,6501,1595,5154,454,506,303,414,6831,1547,411,480,282,385,3105,0.300155219247187,0.905286343612335,0.948616600790514,0.930693069306931,0.929951690821256,0.454545454545455
E02005105,Folkestone Foord,Folkestone and Hythe,South East,1904,5063,349,261,159,226,6058,1908,5207,342,286,180,198,6213,1310,283,259,171,185,2208,0.251584405607836,0.827485380116959,0.905594405594406,0.95,0.934343434343434,0.35538387252535
E02005106,Cheriton & Horn Street,Folkestone and Hythe,South East,2026,5998,527,503,317,376,7721,2063,6418,490,528,326,402,8164,1797,420,475,303,375,3370,0.279993767528825,0.857142857142857,0.899621212121212,0.929447852760736,0.932835820895522,0.412787849093582
E02005107,Folkestone Morehall & Sandgate,Folkestone and Hythe,South East,2353,7693,831,934,561,764,10783,2258,9066,801,908,608,830,12213,2303,707,853,581,788,5232,0.254026031325833,0.882646691635456,0.93942731277533,0.955592105263158,0.949397590361446,0.428395971505773
E02005109,"Saltwood, Seabrook & Etchinghill",Folkestone and Hythe,South East,842,3366,587,705,503,818,5979,847,3520,553,676,541,836,6126,1178,499,641,523,796,3637,0.334659090909091,0.902350813743219,0.948224852071006,0.966728280961183,0.952153110047847,0.59369898792034
E02005110,Lympne & Palmarsh,Folkestone and Hythe,South East,1008,3945,534,608,426,506,6019,1074,4146,530,571,450,504,6201,1300,484,532,433,484,3233,0.313555233960444,0.913207547169811,0.93169877408056,0.962222222222222,0.96031746031746,0.521367521367521
E02005111,Hythe,Folkestone and Hythe,South East,955,3806,657,708,506,858,6535,914,3933,592,684,530,775,6514,1300,547,642,499,739,3727,0.330536486142894,0.923986486486486,0.93859649122807,0.941509433962264,0.953548387096774,0.572152287381026
E02005112,"Dymchurch, St Mary's Bay & Brookland",Folkestone and Hythe,South East,935,3827,641,746,457,570,6241,936,4031,623,694,501,578,6427,1109,515,650,465,537,3276,0.275117836765071,0.826645264847512,0.936599423631124,0.92814371257485,0.929065743944637,0.509724599346507
E02005113,New Romney,Folkestone and Hythe,South East,1084,3903,583,679,466,667,6298,1053,3996,569,676,513,678,6432,1033,490,646,478,628,3275,0.258508508508509,0.86115992970123,0.955621301775148,0.9317738791423,0.926253687315634,0.509172885572139
E02005114,Lydd & Dungeness,Folkestone and Hythe,South East,1173,3737,465,513,343,399,5457,1075,3696,443,510,370,419,5438,889,351,483,340,377,2440,0.240530303030303,0.792325056433409,0.947058823529412,0.918918918918919,0.899761336515513,0.448694372931225
E02006879,Folkestone Harbour,Folkestone and Hythe,South East,1316,5175,305,288,181,324,6273,1313,4699,304,266,196,274,5739,1008,247,224,168,241,1888,0.21451372632475,0.8125,0.842105263157895,0.857142857142857,0.87956204379562,0.328977173723645
E02006880,Folkestone Central,Folkestone and Hythe,South East,886,4517,432,395,314,621,6279,875,4303,399,413,317,531,5963,1103,344,344,290,475,2556,0.256332791075994,0.862155388471178,0.832929782082324,0.914826498422713,0.894538606403013,0.428643300352172
E02005115,Sheerness East,Swale,South East,1824,4153,239,200,111,150,4853,1800,4383,251,200,136,159,5129,477,161,181,121,140,1080,0.108829568788501,0.641434262948207,0.905,0.889705882352941,0.880503144654088,0.210567362058881
E02005116,Sheerness West,Swale,South East,1783,3913,269,294,215,267,4958,1613,4285,315,281,216,257,5354,530,211,247,200,236,1424,0.123687281213536,0.66984126984127,0.879003558718861,0.925925925925926,0.918287937743191,0.265969368696302
E02005117,Minster North,Swale,South East,932,3592,483,611,382,388,5456,1020,4006,489,574,410,425,5904,708,353,543,392,406,2402,0.17673489765352,0.721881390593047,0.945993031358885,0.95609756097561,0.955294117647059,0.406842818428184
E02005118,Minster South,Swale,South East,2379,6600,497,531,357,433,8418,2273,6935,470,531,359,491,8786,1054,364,494,347,469,2728,0.151982696467195,0.774468085106383,0.930320150659134,0.966573816155989,0.955193482688391,0.310493967675848
E02005119,Queenborough,Swale,South East,1287,3611,382,435,261,329,5018,1322,4008,400,422,305,304,5439,490,281,402,293,292,1758,0.122255489021956,0.7025,0.95260663507109,0.960655737704918,0.960526315789474,0.323221180364038
E02005120,Sheppey East,Swale,South East,1239,5409,631,617,385,375,7417,1326,6614,612,674,404,380,8684,796,459,626,383,346,2610,0.120350771091624,0.75,0.928783382789318,0.948019801980198,0.910526315789474,0.300552740672501
E02005121,Iwade & Kemsley,Swale,South East,3477,9131,522,479,285,319,10736,3269,9569,567,559,299,298,11292,1871,472,511,281,273,3408,0.195527223325321,0.832451499118166,0.914132379248658,0.939799331103679,0.916107382550335,0.301806588735388
E02005122,"Newington, Halstow & Upchurch",Swale,South East,1211,4396,482,498,310,451,6137,1383,4769,437,522,352,426,6506,965,342,491,336,397,2531,0.202348500733907,0.782608695652174,0.940613026819923,0.954545454545455,0.931924882629108,0.389025514909314
E02005123,Borden & The Meads,Swale,South East,2728,7905,595,606,378,496,9980,2762,8197,564,613,427,522,10323,1456,462,570,399,492,3379,0.177625960717336,0.819148936170213,0.929853181076672,0.934426229508197,0.942528735632184,0.327327327327327
E02005124,Sittingbourne Central & Milton Regis,Swale,South East,2031,5486,355,413,246,430,6930,1960,5704,369,389,258,406,7126,1008,262,343,246,378,2237,0.17671809256662,0.710027100271003,0.881748071979435,0.953488372093023,0.931034482758621,0.313920853213584
E02005125,Sittingbourne East,Swale,South East,1882,5245,428,390,250,305,6618,1918,5322,402,394,250,326,6694,943,334,351,235,305,2168,0.177189026681699,0.830845771144279,0.890862944162437,0.94,0.93558282208589,0.323872124290409
E02005126,Sittingbourne West,Swale,South East,1573,4624,473,573,391,571,6632,1530,4707,375,555,436,604,6677,953,306,527,422,573,2781,0.202464414701508,0.816,0.94954954954955,0.967889908256881,0.948675496688742,0.416504418151865
E02005127,"Sittingbourne South, Bapchild & Bredgar",Swale,South East,1616,5219,529,574,414,569,7305,1576,5479,501,559,471,549,7559,1102,448,539,464,519,3072,0.201131593356452,0.894211576846307,0.964221824686941,0.985138004246284,0.945355191256831,0.406402963354941
E02005128,Faversham West,Swale,South East,1685,5089,461,558,393,465,6966,1631,5589,470,552,387,507,7505,1236,416,516,372,481,3021,0.221148684916801,0.885106382978723,0.934782608695652,0.961240310077519,0.948717948717949,0.40253164556962
E02005129,Faversham East,Swale,South East,2143,6798,672,690,485,666,9311,2069,7250,667,694,496,723,9830,1595,556,657,467,688,3963,0.22,0.833583208395802,0.946685878962536,0.941532258064516,0.951590594744122,0.403153611393693
E02005130,Teynham & Badlesmere,Swale,South East,1678,5392,516,507,378,467,7260,1721,5895,557,531,399,509,7891,1233,478,501,379,486,3077,0.209160305343511,0.858168761220826,0.943502824858757,0.949874686716792,0.954813359528487,0.389937903941199
E02005131,Boughton & Selling,Swale,South East,1023,4184,387,440,272,313,5596,997,6092,384,436,313,332,7557,803,338,409,303,319,2172,0.131812212738017,0.880208333333333,0.938073394495413,0.968051118210863,0.960843373493976,0.287415641127432
E02005132,Cliftonville West,Thanet,South East,2803,6980,470,384,294,513,8641,2700,7957,460,422,287,484,9610,1354,320,348,249,448,2719,0.170164634912656,0.695652173913044,0.824644549763033,0.867595818815331,0.925619834710744,0.282934443288241
E02005133,Cliftonville East & Kingsgate,Thanet,South East,1235,4354,737,841,598,839,7369,1232,4806,676,873,638,833,7826,1449,608,828,600,790,4275,0.301498127340824,0.899408284023669,0.948453608247423,0.940438871473354,0.948379351740696,0.546256069511883
E02005134,Margate Town,Thanet,South East,1873,5149,312,331,161,225,6178,1773,5558,326,315,186,188,6573,1450,246,283,169,172,2320,0.260885210507377,0.754601226993865,0.898412698412698,0.908602150537634,0.914893617021277,0.352959075003803
E02005135,Salmestone,Thanet,South East,1718,4969,382,380,251,366,6348,1722,5118,398,352,276,346,6490,1430,332,322,254,327,2665,0.279406017975772,0.834170854271357,0.914772727272727,0.920289855072464,0.945086705202312,0.410631741140216
E02005136,Westbrook & Garlinge,Thanet,South East,1407,4608,523,505,359,458,6453,1441,4807,533,520,385,484,6729,1380,441,486,363,440,3110,0.287081339712919,0.827392120075047,0.934615384615385,0.942857142857143,0.909090909090909,0.462178629811265
E02005137,Dane Valley & Northdown Hill,Thanet,South East,2032,4619,429,402,297,315,6062,1989,5170,430,404,261,329,6594,1389,350,364,249,311,2663,0.268665377176015,0.813953488372093,0.900990099009901,0.954022988505747,0.945288753799392,0.403851986654534
E02005138,Westgate,Thanet,South East,1531,5248,604,729,449,703,7733,1524,5374,606,663,516,736,7895,1328,422,625,486,691,3552,0.247115742463714,0.696369636963696,0.942684766214178,0.941860465116279,0.938858695652174,0.449905003166561
E02005139,Birchington,Thanet,South East,1068,4052,862,961,727,1055,7657,1094,4234,769,967,775,1111,7856,1134,602,928,744,1048,4456,0.267831837505905,0.782834850455137,0.959669079627714,0.96,0.943294329432943,0.567209775967413
E02005140,Broadstairs North,Thanet,South East,1156,3875,555,762,501,763,6456,1095,4114,513,706,540,751,6624,1141,416,673,526,722,3478,0.277345649003403,0.810916179337232,0.953257790368272,0.974074074074074,0.96138482023968,0.52506038647343
E02005141,Broadstairs South,Thanet,South East,1139,4083,554,639,370,582,6228,1146,4138,530,615,401,536,6220,933,412,576,375,504,2800,0.225471242145964,0.777358490566038,0.936585365853659,0.935162094763092,0.940298507462687,0.45016077170418
E02005142,"Westwood, Northwood & Bromstone",Thanet,South East,1183,4119,545,545,429,575,6213,1177,4364,519,585,436,595,6499,1054,400,547,412,565,2978,0.241521539871677,0.770712909441233,0.935042735042735,0.944954128440367,0.949579831932773,0.458224342206493
E02005143,Dumpton,Thanet,South East,1761,4908,445,450,325,464,6592,1684,5317,470,473,343,438,7041,1033,341,435,328,412,2549,0.194282490126011,0.725531914893617,0.919661733615222,0.956268221574344,0.940639269406393,0.362022439994319
E02005144,Newington,Thanet,South East,2121,5325,444,393,263,355,6780,2193,5967,414,420,275,320,7396,1117,280,382,245,300,2324,0.187196246019775,0.676328502415459,0.909523809523809,0.890909090909091,0.9375,0.314223904813413
E02005145,Minster & St-Nicholas-at-Wade,Thanet,South East,1248,4354,547,613,373,456,6343,1315,4716,572,583,461,447,6779,1151,431,552,438,425,2997,0.244062765055131,0.753496503496504,0.946826758147513,0.950108459869848,0.950782997762864,0.442100604808969
E02005146,Ramsgate Ellington,Thanet,South East,1918,5132,404,335,212,226,6309,1828,5384,378,353,205,241,6561,895,231,324,187,222,1859,0.166233283803863,0.611111111111111,0.917847025495751,0.91219512195122,0.921161825726141,0.283340954122847
E02005147,Ramsgate Harbour,Thanet,South East,1549,5431,563,501,324,402,7221,1551,5781,516,532,353,434,7616,851,318,467,319,387,2342,0.147206365680678,0.616279069767442,0.877819548872181,0.903682719546742,0.891705069124424,0.307510504201681
E02005148,"Nethercourt, Pegwell & Cliffsend",Thanet,South East,1088,4066,639,699,483,622,6509,1130,4457,622,670,557,669,6975,971,470,624,537,648,3250,0.217859546780346,0.755627009646302,0.93134328358209,0.964093357271095,0.968609865470852,0.465949820788531
E02005149,"Aylesford, Wouldham & Blue Bell Hill",Tonbridge and Malling,South East,2092,6961,517,575,418,481,8952,2166,7281,556,569,463,496,9365,1443,459,545,432,477,3356,0.198187062216728,0.825539568345324,0.957820738137083,0.93304535637149,0.961693548387097,0.35835557928457
E02005150,Snodland,Tonbridge and Malling,South East,2459,7609,541,487,333,444,9414,2480,7413,554,515,360,453,9295,1078,445,486,334,427,2770,0.145420207743154,0.803249097472924,0.943689320388349,0.927777777777778,0.942604856512141,0.298009682625067
E02005151,Larkfield & New Hythe,Tonbridge and Malling,South East,2635,7754,657,705,530,544,10190,2618,8155,697,689,557,633,10731,1177,564,651,537,610,3539,0.14432863274065,0.809182209469154,0.944847605224964,0.964093357271095,0.963665086887836,0.329792190848942
E02005153,Ditton,Tonbridge and Malling,South East,1955,5610,500,565,406,566,7647,1962,5674,466,550,405,624,7719,946,376,516,381,597,2816,0.166725414169898,0.8068669527897,0.938181818181818,0.940740740740741,0.956730769230769,0.364814095090038
E02005154,"Borough Green, Wrotham & Shipbourne",Tonbridge and Malling,South East,2469,6993,659,683,452,705,9492,2440,7520,637,700,535,741,10133,1229,567,663,513,698,3670,0.16343085106383,0.89010989010989,0.947142857142857,0.958878504672897,0.941970310391363,0.362182966544952
E02005155,Kings Hill & Wateringbury,Tonbridge and Malling,South East,3284,7854,460,529,346,353,9542,3053,8087,498,568,383,392,9928,1223,438,530,353,366,2910,0.151230369729195,0.879518072289157,0.933098591549296,0.921671018276762,0.933673469387755,0.293110394842869
E02005156,Hadlow & East Peckham,Tonbridge and Malling,South East,1237,4335,439,460,355,446,6035,1185,4393,461,494,375,476,6199,882,424,468,361,467,2602,0.200773958570453,0.919739696312364,0.947368421052632,0.962666666666667,0.98109243697479,0.419745120180674
E02005157,Tonbridge Trench Wood,Tonbridge and Malling,South East,1435,3905,392,395,333,478,5503,1339,4021,349,410,342,508,5630,945,318,392,324,492,2471,0.235016165133052,0.911174785100286,0.95609756097561,0.947368421052632,0.968503937007874,0.438898756660746
E02005158,Hildenborough,Tonbridge and Malling,South East,1363,3910,386,397,293,459,5445,1279,4112,387,430,308,460,5697,883,361,402,301,441,2388,0.214737354085603,0.9328165374677,0.934883720930232,0.977272727272727,0.958695652173913,0.419167983149026
E02005159,Tonbridge Higham Wood,Tonbridge and Malling,South East,1561,4270,421,486,450,639,6266,1507,4653,403,497,422,681,6656,1088,365,470,412,646,2981,0.233827638082957,0.905707196029777,0.945674044265593,0.976303317535545,0.948604992657856,0.447866586538462
E02005160,Tonbridge Town,Tonbridge and Malling,South East,2602,8124,374,475,347,638,9958,2654,8386,427,485,372,660,10330,1538,375,438,347,637,3335,0.183400906272359,0.878220140515223,0.903092783505155,0.932795698924731,0.965151515151515,0.322846079380445
E02005161,Tonbridge South & Haysden,Tonbridge and Malling,South East,1742,5726,326,337,170,330,6889,1746,5864,341,343,208,352,7108,1107,301,326,198,332,2264,0.188778990450205,0.882697947214076,0.950437317784256,0.951923076923077,0.943181818181818,0.318514350028137
E02006833,"East Malling, West Malling & Trottiscliffe",Tonbridge and Malling,South East,2228,7137,742,689,500,690,9758,2430,7776,723,750,525,671,10445,1123,608,697,505,638,3571,0.144418724279835,0.840940525587829,0.929333333333333,0.961904761904762,0.950819672131147,0.341886069889899
E02005162,Paddock Wood & Five Oak Green,Tunbridge Wells,South East,1949,6229,628,660,434,586,8537,1886,6701,603,653,476,604,9037,1359,563,625,458,589,3594,0.202805551410237,0.933665008291874,0.957120980091884,0.96218487394958,0.975165562913907,0.397698351222751
E02005163,Southborough West,Tunbridge Wells,South East,1802,5085,332,423,247,366,6453,1764,5300,346,397,270,370,6683,1151,307,371,253,348,2430,0.217169811320755,0.88728323699422,0.934508816120907,0.937037037037037,0.940540540540541,0.363609157563968
E02005164,Southborough East & Longfield Road,Tunbridge Wells,South East,1820,5311,354,349,298,398,6710,1885,5716,336,370,290,424,7136,1231,299,345,276,394,2545,0.215360391882435,0.889880952380952,0.932432432432432,0.951724137931035,0.929245283018868,0.356642376681614
E02005165,Pembury & Matfield,Tunbridge Wells,South East,1374,4406,477,545,353,557,6338,1334,4692,450,516,400,512,6570,1162,407,486,386,482,2923,0.24765558397272,0.904444444444444,0.941860465116279,0.965,0.94140625,0.444901065449011
E02005166,High Brooms & Sherwood,Tunbridge Wells,South East,1762,4529,287,256,191,257,5520,1572,4704,273,257,183,249,5666,1075,223,233,170,225,1926,0.228528911564626,0.816849816849817,0.906614785992218,0.92896174863388,0.903614457831325,0.339922343805154
E02005167,"Langton Green, Speldhurst & Bidborough",Tunbridge Wells,South East,1639,4343,492,501,329,558,6223,1615,4636,459,514,348,536,6493,939,423,494,338,512,2706,0.202545297670406,0.92156862745098,0.961089494163424,0.971264367816092,0.955223880597015,0.416756507007547
E02005168,Tunbridge Wells West,Tunbridge Wells,South East,1702,4840,316,313,221,515,6205,1612,5089,320,314,248,534,6505,1018,288,283,227,510,2326,0.200039300451955,0.9,0.901273885350319,0.915322580645161,0.955056179775281,0.357571099154497
E02005169,Tunbridge Wells Central,Tunbridge Wells,South East,1640,7145,343,283,210,318,8299,1585,7124,324,346,209,308,8311,1151,251,297,189,279,2167,0.161566535654127,0.774691358024691,0.858381502890173,0.904306220095694,0.905844155844156,0.260738779930213
E02005170,Ferndale & Hawkenbury,Tunbridge Wells,South East,2120,6200,431,412,318,713,8074,2051,6407,394,414,345,700,8260,1266,338,381,328,662,2975,0.197596378960512,0.857868020304569,0.920289855072464,0.950724637681159,0.945714285714286,0.360169491525424
E02005171,Ramslye & Rusthall,Tunbridge Wells,South East,1406,3903,275,293,223,376,5070,1331,4159,269,295,225,345,5293,845,230,263,208,325,1871,0.203173839865352,0.855018587360595,0.891525423728814,0.924444444444444,0.942028985507246,0.353485735877574
E02005172,"Goudhurst, Horsmonden & Lamberhurst",Tunbridge Wells,South East,1788,5223,447,529,325,421,6945,1669,5530,497,493,412,424,7356,1104,442,458,379,401,2784,0.199638336347197,0.88933601609658,0.929006085192698,0.919902912621359,0.945754716981132,0.378466557911909
E02005173,Tunbridge Wells South,Tunbridge Wells,South East,1586,5213,446,473,385,591,7108,1597,5497,461,475,395,588,7416,1044,400,429,370,556,2799,0.189921775513917,0.86767895878525,0.903157894736842,0.936708860759494,0.945578231292517,0.377427184466019
E02005174,"Cranbrook, Sissinghurst & Frittenden",Tunbridge Wells,South East,1480,4304,463,490,339,603,6199,1583,4938,442,494,392,587,6853,923,385,456,361,562,2687,0.186917780477926,0.871040723981901,0.923076923076923,0.920918367346939,0.957410562180579,0.392091055012403
E02005175,"Hawkhurst, Benenden & Sandhurst",Tunbridge Wells,South East,1881,4988,491,579,413,623,7094,1819,5366,534,575,426,567,7468,1083,467,536,406,545,3037,0.201826313827805,0.874531835205993,0.932173913043478,0.953051643192488,0.961199294532628,0.406668452062132
E02005921,"Cropredy, Wroxton & Shennington",Cherwell,South East,901,3378,406,389,278,400,4851,1103,4180,443,399,323,403,5748,860,390,376,305,383,2314,0.205741626794258,0.880361173814898,0.942355889724311,0.944272445820434,0.950372208436725,0.402574808629088
E02005922,Banbury Hardwick,Cherwell,South East,1804,5439,311,292,204,191,6437,1794,6131,333,319,223,211,7217,1059,240,299,209,190,1997,0.172728755504812,0.720720720720721,0.93730407523511,0.937219730941704,0.900473933649289,0.276707773313011
E02005923,Banbury Neithrop,Cherwell,South East,1386,3582,240,230,154,289,4495,1367,4352,251,231,175,247,5256,651,163,213,165,219,1411,0.149586397058824,0.649402390438247,0.922077922077922,0.942857142857143,0.88663967611336,0.268455098934551
E02005924,Banbury Grimsbury,Cherwell,South East,2360,8124,352,291,248,488,9503,2397,9623,404,347,264,496,11134,1248,268,296,230,452,2494,0.12968928608542,0.663366336633663,0.853025936599424,0.871212121212121,0.911290322580645,0.223998562960302
E02005925,Banbury Ruscote,Cherwell,South East,2213,5051,344,341,248,255,6239,2264,6193,363,383,244,311,7494,1009,182,335,214,291,2031,0.162925884062651,0.50137741046832,0.87467362924282,0.877049180327869,0.935691318327974,0.271016813450761
E02005926,Banbury Easington,Cherwell,South East,1392,4802,480,568,462,696,7008,1433,5641,509,596,469,752,7967,984,354,558,447,711,3054,0.17443715653253,0.695481335952849,0.936241610738255,0.953091684434968,0.945478723404255,0.383331241370654
E02005927,Banbury Calthorpe,Cherwell,South East,909,3035,294,335,225,282,4171,964,3692,276,374,250,245,4837,723,182,350,241,232,1728,0.195828819068256,0.659420289855073,0.935828877005348,0.964,0.946938775510204,0.357246227000207
E02005928,"Bodicote, Adderbury & Bloxham",Cherwell,South East,2108,5466,510,601,434,608,7619,2359,6736,528,640,485,594,8983,1190,410,606,468,572,3246,0.17666270783848,0.776515151515152,0.946875,0.964948453608247,0.962962962962963,0.361349215184237
E02005929,"Sibford, Hook Norton & Milcombe",Cherwell,South East,1293,3916,489,544,318,408,5675,1328,4652,514,551,355,429,6501,842,393,517,343,415,2510,0.180997420464316,0.764591439688716,0.938294010889292,0.966197183098592,0.967365967365967,0.386094447008153
E02005930,"Deddington, Steeple Aston & Heyfords",Cherwell,South East,1705,4920,499,561,334,458,6772,1784,5720,539,553,354,510,7676,1066,449,526,337,495,2873,0.186363636363636,0.833024118738404,0.951175406871609,0.951977401129944,0.970588235294118,0.374283480979677
E02005931,"Caversfield, Ambrosden & Fringford",Cherwell,South East,2194,6412,444,433,243,432,7964,2259,6932,482,455,282,423,8574,1039,429,429,265,401,2563,0.149884593190998,0.890041493775934,0.942857142857143,0.939716312056738,0.947990543735225,0.298926988570096
E02005932,Bicester North,Cherwell,South East,1381,4491,272,187,130,93,5173,1369,4996,259,209,134,108,5706,664,228,194,125,101,1312,0.132906325060048,0.88030888030888,0.92822966507177,0.932835820895522,0.935185185185185,0.229933403434981
E02005933,Bicester East,Cherwell,South East,1427,4743,347,336,212,291,5929,1417,5516,394,354,247,295,6806,819,342,338,236,275,2010,0.148477157360406,0.868020304568528,0.954802259887006,0.955465587044534,0.932203389830508,0.295327652071701
E02005934,Bicester West,Cherwell,South East,1693,5429,444,454,339,451,7117,1621,6138,508,462,339,500,7947,945,453,423,320,459,2600,0.153958944281525,0.891732283464567,0.915584415584416,0.943952802359882,0.918,0.327167484585378
E02005935,Bicester South,Cherwell,South East,1536,5343,258,232,178,354,6365,1627,6282,305,244,208,394,7433,851,248,220,187,364,1870,0.13546641197071,0.813114754098361,0.901639344262295,0.899038461538462,0.923857868020305,0.25158078837616
E02005936,"Islip, Arncott & Chesterton",Cherwell,South East,2568,7273,558,540,409,499,9279,2560,9987,626,572,430,531,12146,1540,537,532,403,502,3514,0.154200460598778,0.857827476038339,0.93006993006993,0.937209302325581,0.945386064030132,0.28931335419068
E02005937,Kidlington North,Cherwell,South East,1148,3905,395,404,345,621,5670,1058,4591,405,443,330,607,6376,827,356,420,316,586,2505,0.180135046830756,0.879012345679012,0.948081264108352,0.957575757575757,0.965403624382208,0.392879548306148
E02005938,Kidlington South,Cherwell,South East,1080,3387,299,230,176,376,4468,1063,4033,328,286,186,356,5189,776,277,266,181,345,1845,0.192412596082321,0.844512195121951,0.93006993006993,0.973118279569892,0.969101123595506,0.355559838119098
E02005939,"Begbroke, Yarnton & Water Eaton",Cherwell,South East,1120,4096,392,328,252,482,5550,1205,5015,411,399,258,474,6557,828,358,375,248,467,2276,0.165104685942173,0.871046228710462,0.93984962406015,0.961240310077519,0.985232067510549,0.347109958822632
E02005940,Wolvercote & Cutteslowe,Oxford,South East,1189,3079,344,344,232,417,4416,1258,4347,341,365,265,435,5753,791,278,330,245,402,2046,0.181964573268921,0.81524926686217,0.904109589041096,0.924528301886792,0.924137931034483,0.355640535372849
E02005941,Summertown,Oxford,South East,1722,3950,367,340,217,419,5293,1811,6038,356,386,267,384,7431,792,267,330,244,358,1991,0.131169261344816,0.75,0.854922279792746,0.913857677902622,0.932291666666667,0.267931637733818
E02005942,North Central Oxford,Oxford,South East,1124,4339,261,320,223,313,5456,1268,6881,314,330,276,341,8142,612,240,286,246,318,1702,0.088940560964976,0.764331210191083,0.866666666666667,0.891304347826087,0.932551319648094,0.209039548022599
E02005943,Marston,Oxford,South East,1337,3609,270,300,217,409,4805,1416,5212,286,305,234,411,6448,923,224,261,209,386,2003,0.177091327705295,0.783216783216783,0.855737704918033,0.893162393162393,0.939172749391727,0.310638957816377
E02005944,Barton,Oxford,South East,1856,4139,261,244,187,244,5075,1944,6537,285,258,180,243,7503,1440,208,225,163,216,2252,0.220284534189995,0.729824561403509,0.872093023255814,0.905555555555556,0.888888888888889,0.300146608023457
E02005945,Headington,Oxford,South East,1767,11673,391,325,292,525,13206,1923,18151,396,393,312,468,19720,2012,296,337,285,432,3362,0.110847887168751,0.747474747474748,0.857506361323155,0.913461538461539,0.923076923076923,0.170486815415822
E02005946,Risinghurst & Sandhills,Oxford,South East,1650,4539,343,333,252,334,5801,1708,6596,395,374,292,364,8021,1455,313,335,269,336,2708,0.220588235294118,0.792405063291139,0.89572192513369,0.921232876712329,0.923076923076923,0.337613763869842
E02005947,Oxford Central,Oxford,South East,1193,16259,227,165,151,194,16996,919,33474,302,213,183,189,34361,1402,207,165,151,158,2083,0.0418832526737169,0.685430463576159,0.774647887323944,0.825136612021858,0.835978835978836,0.0606210529379238
E02005948,"Osney, Jericho & Port Meadow",Oxford,South East,946,5266,229,234,161,159,6049,909,6322,258,209,162,188,7139,640,182,185,144,170,1321,0.101233786776337,0.705426356589147,0.885167464114833,0.888888888888889,0.904255319148936,0.185039921557641
E02005949,Churchill,Oxford,South East,1280,5090,234,167,132,243,5866,1308,7170,212,181,120,212,7895,1407,155,153,106,193,2014,0.196234309623431,0.731132075471698,0.845303867403315,0.883333333333333,0.910377358490566,0.255098163394554
E02005950,East Central Oxford,Oxford,South East,971,8677,300,293,178,184,9632,1052,9999,338,336,175,220,11068,1074,256,276,145,190,1941,0.107410741074107,0.757396449704142,0.821428571428571,0.828571428571429,0.863636363636364,0.175370437296711
E02005951,Grandpont & New Hinksey,Oxford,South East,974,3729,214,201,144,262,4550,948,4740,245,222,149,240,5596,604,189,195,132,217,1337,0.127426160337553,0.771428571428571,0.878378378378378,0.885906040268456,0.904166666666667,0.23892065761258
E02005952,Cowley North,Oxford,South East,2647,9390,417,356,224,397,10784,2777,14008,493,368,254,407,15530,2054,367,314,215,358,3308,0.146630496858938,0.744421906693712,0.853260869565217,0.846456692913386,0.87960687960688,0.213007083065035
E02005953,Iffley Fields,Oxford,South East,929,3469,196,158,96,142,4061,951,4840,235,201,112,129,5517,676,188,176,95,117,1252,0.139669421487603,0.8,0.875621890547264,0.848214285714286,0.906976744186047,0.226934928403118
E02005954,Cowley South & Iffley,Oxford,South East,1845,5704,403,352,275,582,7316,1865,8366,432,392,307,534,10031,1080,339,341,281,500,2541,0.1290939517093,0.784722222222222,0.869897959183674,0.915309446254072,0.936329588014981,0.253314724354501
E02005955,Littlemore & Rose Hill,Oxford,South East,2488,6041,380,303,210,361,7295,2473,8290,396,358,243,357,9644,1325,307,312,212,319,2475,0.159831121833534,0.775252525252525,0.871508379888268,0.872427983539095,0.893557422969188,0.256636250518457
E02005956,Blackbird Leys,Oxford,South East,1474,3458,201,184,154,251,4248,1446,5021,244,206,166,257,5894,977,176,189,142,237,1721,0.194582752439753,0.721311475409836,0.91747572815534,0.855421686746988,0.922178988326848,0.291991856124873
E02005957,Greater Leys,Oxford,South East,1779,3833,183,131,108,182,4437,1709,5197,222,140,119,196,5874,985,165,120,102,175,1547,0.189532422551472,0.743243243243243,0.857142857142857,0.857142857142857,0.892857142857143,0.263363976847123
E02005958,Thame North,South Oxfordshire,South East,952,3302,355,274,185,260,4376,900,3571,345,306,223,258,4703,747,284,277,214,240,1762,0.209185102212265,0.823188405797101,0.905228758169935,0.959641255605381,0.930232558139535,0.374654475866468
E02005959,Beckley & Horspath,South Oxfordshire,South East,892,3426,381,391,253,324,4775,943,3923,391,381,283,340,5318,863,324,369,267,318,2141,0.219984705582462,0.828644501278772,0.968503937007874,0.943462897526502,0.935294117647059,0.402594960511471
E02005960,Thame South,South Oxfordshire,South East,1546,4047,355,414,337,528,5681,1657,4723,360,463,339,576,6461,913,300,447,330,536,2526,0.193309337285624,0.833333333333333,0.965442764578834,0.973451327433628,0.930555555555556,0.390961151524532
E02005961,Wheatley & Great Haseley,South Oxfordshire,South East,1131,3946,414,427,302,452,5541,1142,4598,437,450,345,495,6325,968,348,421,331,472,2540,0.210526315789474,0.796338672768879,0.935555555555556,0.959420289855072,0.953535353535354,0.401581027667984
E02005962,Chinnor & Tetsworth,South Oxfordshire,South East,1703,5298,592,617,384,484,7375,1877,6178,613,629,470,510,8400,1238,510,602,458,494,3302,0.200388475234704,0.831973898858075,0.957074721780604,0.974468085106383,0.968627450980392,0.393095238095238
E02005963,Berinsfield & Wittenham,South Oxfordshire,South East,1437,4818,506,473,371,473,6641,1401,5286,560,463,393,508,7210,1055,492,435,377,488,2847,0.199583806280742,0.878571428571429,0.939524838012959,0.959287531806616,0.960629921259842,0.394868238557559
E02005964,"Chalgrove, Stadhampton & Dorchester",South Oxfordshire,South East,1201,4116,427,484,349,484,5860,1146,4543,448,483,378,512,6364,733,378,451,359,483,2404,0.161347127448822,0.84375,0.933747412008282,0.94973544973545,0.943359375,0.377749842866122
E02005965,Watlington & Nettlebed,South Oxfordshire,South East,1001,3112,321,362,304,356,4455,996,3547,320,346,296,365,4874,597,264,325,268,338,1792,0.168311248942769,0.825,0.939306358381503,0.905405405405405,0.926027397260274,0.36766516208453
E02005966,Didcot Ladygrove,South Oxfordshire,South East,1637,5641,206,194,70,105,6216,1604,5911,243,191,101,119,6565,708,198,181,92,112,1291,0.119776687531721,0.814814814814815,0.947643979057592,0.910891089108911,0.941176470588235,0.196648895658797
E02005967,Didcot West,South Oxfordshire,South East,2119,5399,275,303,239,350,6566,2052,6067,304,307,257,354,7289,741,229,293,255,345,1863,0.122136146365584,0.753289473684211,0.954397394136808,0.992217898832685,0.974576271186441,0.255590615996707
E02005968,Benson & Crowmarsh Gifford,South Oxfordshire,South East,1509,5058,292,400,288,390,6428,1483,5278,339,372,313,393,6695,820,279,359,305,383,2146,0.155361879499811,0.823008849557522,0.96505376344086,0.97444089456869,0.974554707379135,0.320537714712472
E02005969,Wallingford & Brightwell,South Oxfordshire,South East,1824,5521,482,516,404,685,7608,1788,6134,522,514,443,689,8302,1218,415,484,430,671,3218,0.198565373328986,0.795019157088123,0.941634241245136,0.970654627539503,0.973875181422351,0.387617441580342
E02005970,Didcot South East,South Oxfordshire,South East,1056,3711,217,165,96,146,4335,957,4122,244,176,130,135,4807,565,173,170,127,126,1161,0.137069383794275,0.709016393442623,0.965909090909091,0.976923076923077,0.933333333333333,0.241522779280216
E02005971,Didcot South West,South Oxfordshire,South East,1206,3763,286,282,243,396,4970,1170,4105,308,279,247,363,5302,633,248,263,240,348,1732,0.154202192448234,0.805194805194805,0.942652329749104,0.97165991902834,0.958677685950413,0.326669181440966
E02005972,"Hagbourne, Moreton & Cholsey",South Oxfordshire,South East,2215,5666,512,517,432,578,7705,2476,7057,542,543,428,603,9173,1205,430,509,413,579,3136,0.170752444381465,0.793357933579336,0.937384898710866,0.964953271028037,0.960199004975124,0.341872887822959
E02005973,Henley North,South Oxfordshire,South East,923,3146,277,377,353,568,4721,945,3912,308,392,364,591,5567,716,221,368,337,576,2218,0.183026584867076,0.717532467532468,0.938775510204082,0.925824175824176,0.974619289340102,0.398419256331956
E02005974,Henley South,South Oxfordshire,South East,1177,3622,303,365,296,456,5042,1147,4318,313,343,341,497,5812,737,245,307,311,480,2080,0.170680870773506,0.782747603833866,0.895043731778426,0.912023460410557,0.96579476861167,0.357880247763248
E02005975,"Goring, Woodcote & Whitchurch",South Oxfordshire,South East,1603,4464,512,579,427,559,6541,1573,5133,497,596,438,596,7260,1016,416,573,423,575,3003,0.197934930839665,0.837022132796781,0.961409395973154,0.965753424657534,0.964765100671141,0.413636363636364
E02005976,Shiplake & Binfield Heath,South Oxfordshire,South East,1129,3487,362,473,295,457,5074,1121,4212,397,425,340,413,5787,748,335,398,324,404,2209,0.177587844254511,0.843828715365239,0.936470588235294,0.952941176470588,0.978208232445521,0.381717642992915
E02005977,Sonning Common & Kidmore End,South Oxfordshire,South East,1047,3220,346,393,292,588,4839,1106,3670,364,390,324,565,5313,753,298,381,316,550,2298,0.205177111716621,0.818681318681319,0.976923076923077,0.975308641975309,0.973451327433628,0.432523997741389
E02005978,"Dean Court, Cumnor & Appleton",Vale of White Horse,South East,1324,4459,435,475,293,651,6313,1353,5063,471,490,358,610,6992,1017,416,465,328,580,2806,0.200869049970373,0.883227176220807,0.948979591836735,0.916201117318436,0.950819672131147,0.401315789473684
E02005979,Botley & Kennington,Vale of White Horse,South East,1827,6228,493,491,389,695,8296,1809,7142,496,487,382,693,9200,1383,405,452,353,654,3247,0.193643237188463,0.816532258064516,0.928131416837782,0.924083769633508,0.943722943722944,0.352934782608696
E02005980,"Radley, Wootton & Marcham",Vale of White Horse,South East,2534,7093,605,658,482,655,9493,2519,7257,610,640,512,706,9725,1227,551,593,494,678,3543,0.169078131459281,0.90327868852459,0.9265625,0.96484375,0.960339943342776,0.364318766066838
E02005981,Abingdon Northcourt & Peachcroft,Vale of White Horse,South East,1608,5619,542,514,296,322,7293,1534,5915,560,541,342,351,7709,1012,514,513,334,334,2707,0.171090448013525,0.917857142857143,0.948243992606285,0.976608187134503,0.951566951566952,0.351148008820859
E02005982,Abingdon Audlett Drive & Farm Road,Vale of White Horse,South East,1165,3635,297,331,251,316,4830,1110,3922,314,322,262,330,5150,599,282,305,258,319,1763,0.152728199898011,0.898089171974522,0.947204968944099,0.984732824427481,0.966666666666667,0.342330097087379
E02005983,Abingdon Town & West,Vale of White Horse,South East,2079,7523,475,465,396,706,9565,1936,8116,476,519,385,734,10230,1198,414,475,359,692,3138,0.147609659931001,0.869747899159664,0.915221579961464,0.932467532467532,0.942779291553134,0.306744868035191
E02005984,Kingston Bagpuize & East Hanney,Vale of White Horse,South East,1569,5048,525,482,369,429,6853,1594,5530,514,529,388,430,7391,871,453,509,382,414,2629,0.15750452079566,0.881322957198444,0.962192816635161,0.984536082474227,0.962790697674419,0.355702881883372
E02005985,Abingdon South,Vale of White Horse,South East,1480,4812,442,482,350,445,6531,1514,5370,442,459,361,478,7110,883,397,437,351,455,2523,0.164432029795158,0.898190045248869,0.952069716775599,0.972299168975069,0.951882845188284,0.354852320675106
E02005986,Faringdon & Stanford,Vale of White Horse,South East,1956,6016,499,533,359,546,7953,1825,6045,489,572,389,576,8071,925,431,542,371,552,2821,0.153019023986766,0.881390593047035,0.947552447552448,0.953727506426735,0.958333333333333,0.349522983521249
E02005987,"Sutton Courtenay, Drayton & Steventon",Vale of White Horse,South East,1944,5740,500,517,307,496,7560,2139,6498,524,483,346,490,8341,990,456,461,336,469,2712,0.152354570637119,0.870229007633588,0.954451345755693,0.971098265895954,0.957142857142857,0.325140870399233
E02005988,Grove,Vale of White Horse,South East,1610,4714,415,421,322,381,6253,1803,5459,460,443,333,419,7114,991,317,416,323,403,2450,0.181535079684924,0.689130434782609,0.939051918735892,0.96996996996997,0.9618138424821,0.344391341017712
E02005991,Wantage Town,Vale of White Horse,South East,1653,5954,554,583,420,741,8252,1655,6279,521,587,413,747,8547,1132,369,556,400,725,3182,0.180283484631311,0.708253358925144,0.947189097103918,0.968523002421307,0.970548862115127,0.372294372294372
E02005992,"South Wantage, Harwell & Blewbury",Vale of White Horse,South East,2783,7590,591,670,453,736,10040,3113,8783,637,651,503,718,11292,1280,528,624,482,691,3605,0.145736081065695,0.828885400313972,0.95852534562212,0.958250497017893,0.962395543175487,0.319252568189869
E02006886,"Shrivenham, Watchfield & Uffington",Vale of White Horse,South East,2712,7878,683,719,531,720,10531,3082,9380,717,745,599,752,12193,1407,607,708,574,726,4022,0.15,0.846582984658298,0.950335570469799,0.958263772954925,0.965425531914894,0.329861395882884
E02005993,Chipping Norton,West Oxfordshire,South East,1216,4039,431,457,348,427,5702,1270,4492,412,493,391,580,6368,900,306,460,381,553,2600,0.200356188780053,0.742718446601942,0.933062880324544,0.974424552429667,0.953448275862069,0.408291457286432
E02005994,"Kingham, Enstone & Middle Barton",West Oxfordshire,South East,1198,3763,406,384,279,479,5311,1156,4044,386,410,289,347,5476,723,303,391,281,339,2037,0.178783382789318,0.784974093264249,0.953658536585366,0.972318339100346,0.976945244956772,0.371986851716581
E02005995,Chadlington & Wychwoods,West Oxfordshire,South East,1005,3352,452,476,284,452,5016,1061,3942,487,504,369,520,5822,693,383,479,360,496,2411,0.175799086757991,0.786447638603696,0.950396825396825,0.975609756097561,0.953846153846154,0.414118859498454
E02005996,"Woodstock, Stonesfield & Tackley",West Oxfordshire,South East,1640,4739,532,520,411,651,6853,1595,5433,522,510,443,629,7537,976,427,481,418,609,2911,0.179642922878704,0.818007662835249,0.943137254901961,0.943566591422122,0.968203497615262,0.38622794215205
E02005997,Charlbury & North Leigh,West Oxfordshire,South East,927,3128,447,425,252,394,4646,934,3573,451,448,303,418,5193,779,402,424,299,395,2299,0.21802406940946,0.891352549889135,0.946428571428571,0.986798679867987,0.944976076555024,0.442711342191411
E02005998,Hanborough & Cassington,West Oxfordshire,South East,1130,3468,416,465,346,466,5161,1235,4078,431,473,370,530,5882,862,384,449,347,515,2557,0.211378126532614,0.890951276102088,0.949260042283298,0.937837837837838,0.971698113207547,0.434716082964978
E02005999,"Leafield, Minster Lovell & Duckington",West Oxfordshire,South East,1072,3611,441,405,335,431,5223,1042,4023,407,458,336,453,5677,817,363,434,318,436,2368,0.20308227690778,0.891891891891892,0.947598253275109,0.946428571428571,0.962472406181016,0.417121719217897
E02006000,Witney East,West Oxfordshire,South East,2387,7388,540,631,397,635,9591,2201,7747,595,618,485,644,10089,1465,548,587,464,620,3684,0.189105460178133,0.921008403361344,0.949838187702265,0.956701030927835,0.962732919254658,0.365150163544454
E02006001,Witney West,West Oxfordshire,South East,1364,3798,259,261,166,378,4862,1450,4461,279,275,176,399,5590,796,265,260,164,393,1878,0.178435328401704,0.949820788530466,0.945454545454546,0.931818181818182,0.984962406015038,0.335957066189624
E02006002,Witney Central,West Oxfordshire,South East,1810,6537,548,594,444,840,8963,1725,7156,552,586,481,813,9588,1304,502,543,454,791,3594,0.182224706539966,0.909420289855072,0.926621160409556,0.943866943866944,0.972939729397294,0.374843554443054
E02006003,Eynsham & Stanton Harcourt,West Oxfordshire,South East,956,3205,300,349,310,369,4533,1020,3686,356,332,334,384,5092,754,314,317,324,365,2074,0.204557786218123,0.882022471910112,0.954819277108434,0.970059880239521,0.950520833333333,0.407305577376277
E02006004,Burford & Brize Norton,West Oxfordshire,South East,969,3523,447,441,313,408,5132,1112,6613,397,447,319,404,8180,654,309,424,302,386,2075,0.0988961137154091,0.778337531486146,0.948545861297539,0.946708463949843,0.955445544554455,0.253667481662592
E02006005,Carterton North,West Oxfordshire,South East,2445,6476,233,248,183,236,7376,2360,5870,283,262,207,252,6874,1145,207,252,203,244,2051,0.195059625212947,0.731448763250883,0.961832061068702,0.980676328502416,0.968253968253968,0.29837067209776
E02006006,Carterton South,West Oxfordshire,South East,1026,4980,295,263,237,316,6091,992,3309,338,259,233,321,4460,723,241,254,229,311,1758,0.218495013599275,0.71301775147929,0.980694980694981,0.982832618025751,0.968847352024922,0.394170403587444
E02006007,"Bampton, Clanfield & Standlake",West Oxfordshire,South East,1287,4053,438,477,304,479,5751,1297,4451,453,502,353,498,6257,790,368,470,339,485,2452,0.177488204897776,0.812362030905077,0.936254980079681,0.960339943342776,0.973895582329317,0.391881093175643
E02006317,West Molesey North,Elmbridge,South East,1250,3350,350,328,237,331,4596,1303,4167,364,360,248,385,5524,896,294,322,230,359,2101,0.215022798176146,0.807692307692308,0.894444444444445,0.92741935483871,0.932467532467532,0.380340333091962
E02006318,East Molesey,Elmbridge,South East,1225,3893,361,356,260,370,5240,1373,4846,418,391,300,377,6332,811,329,345,271,340,2096,0.167354519191085,0.787081339712919,0.882352941176471,0.903333333333333,0.90185676392573,0.331017056222363
E02006319,West Molesey South,Elmbridge,South East,1514,4076,325,325,189,356,5271,1668,5031,330,326,223,333,6243,1015,242,290,203,303,2053,0.201749155237527,0.733333333333333,0.889570552147239,0.910313901345291,0.90990990990991,0.32884831010732
E02006320,Walton North & Molesey Heath,Elmbridge,South East,1575,4232,262,259,171,230,5154,1683,4895,292,259,187,249,5882,773,246,226,176,232,1653,0.157916241062308,0.842465753424658,0.872586872586873,0.941176470588235,0.931726907630522,0.281026861611697
E02006321,Thames Ditton,Elmbridge,South East,1574,3699,290,304,189,403,4885,1640,4547,321,294,225,386,5773,828,271,270,200,363,1932,0.182098086650539,0.844236760124611,0.918367346938776,0.888888888888889,0.940414507772021,0.334661354581673
E02006322,Long Ditton,Elmbridge,South East,1522,4028,297,252,176,280,5033,1555,4710,314,283,196,284,5787,857,260,263,182,261,1823,0.181953290870488,0.828025477707007,0.929328621908127,0.928571428571429,0.919014084507042,0.315016416105063
E02006323,Walton Central,Elmbridge,South East,1551,4387,313,365,235,493,5793,1548,4942,357,366,267,533,6465,707,304,340,240,503,2094,0.143059490084986,0.851540616246499,0.92896174863388,0.898876404494382,0.943714821763602,0.323897911832947
E02006324,Walton East,Elmbridge,South East,1875,4742,333,260,189,348,5872,1984,5497,326,263,221,314,6621,867,296,249,207,279,1898,0.157722394033109,0.907975460122699,0.946768060836502,0.936651583710407,0.888535031847134,0.286663645974928
E02006325,Hinchley Wood & Weston Green,Elmbridge,South East,2356,5576,367,425,275,505,7148,2395,6683,418,421,307,472,8301,1200,363,386,285,438,2672,0.179560077809367,0.868421052631579,0.916864608076009,0.928338762214984,0.927966101694915,0.321888929044693
E02006326,Walton Hersham Road,Elmbridge,South East,1563,4101,321,345,208,366,5341,1718,4996,331,350,239,373,6289,707,283,330,223,351,1894,0.141513210568455,0.854984894259819,0.942857142857143,0.933054393305439,0.941018766756032,0.301160756877087
E02006327,Oatlands,Elmbridge,South East,1519,3743,316,357,274,441,5131,1576,4413,294,354,312,513,5886,667,249,306,281,463,1966,0.151144346249717,0.846938775510204,0.864406779661017,0.900641025641026,0.902534113060429,0.334012911994563
E02006328,Weybridge Riverside,Elmbridge,South East,1968,5727,420,429,266,534,7376,2114,6982,434,424,331,511,8682,1077,345,369,303,458,2552,0.154253795474076,0.794930875576037,0.870283018867925,0.915407854984894,0.896281800391389,0.293941488136374
E02006329,Esher,Elmbridge,South East,1604,4394,331,372,298,492,5887,1671,5572,358,423,301,472,7126,879,293,381,268,440,2261,0.157753050969131,0.818435754189944,0.900709219858156,0.890365448504983,0.932203389830508,0.317288801571709
E02006330,Hersham,Elmbridge,South East,2148,5548,440,534,382,672,7576,2171,6545,454,477,414,674,8564,1074,388,437,386,631,2916,0.164094728800611,0.854625550660793,0.916142557651992,0.932367149758454,0.93620178041543,0.34049509574965
E02006331,Claygate,Elmbridge,South East,1547,4008,396,370,286,444,5504,1623,4938,406,411,294,470,6519,1025,353,381,276,450,2485,0.207573916565411,0.869458128078818,0.927007299270073,0.938775510204082,0.957446808510638,0.381193434575855
E02006332,Weybridge St George's Hill,Elmbridge,South East,1328,3874,273,311,190,450,5098,1377,4834,326,337,227,461,6185,709,257,277,199,402,1844,0.146669424906909,0.788343558282209,0.821958456973294,0.876651982378855,0.872017353579176,0.298140662894099
E02006333,Cobham,Elmbridge,South East,2396,6179,506,493,370,665,8213,2332,7485,514,484,376,615,9474,1172,408,428,336,565,2909,0.156579826319305,0.793774319066148,0.884297520661157,0.893617021276596,0.91869918699187,0.307050876081908
E02006334,Oxshott & Stoke D'Abernon,Elmbridge,South East,2111,5252,498,393,320,588,7051,2024,6144,503,456,341,537,7981,1082,435,405,309,501,2732,0.176106770833333,0.864811133200795,0.888157894736842,0.906158357771261,0.932960893854749,0.342312993359228
E02006335,Worcester Park West,Epsom and Ewell,South East,1372,4883,451,461,354,490,6639,1460,5293,447,473,385,507,7105,1036,397,434,357,462,2686,0.195730209710939,0.888143176733781,0.917547568710359,0.927272727272727,0.911242603550296,0.378043631245602
E02006336,Ruxley Lane,Epsom and Ewell,South East,1684,4421,282,272,160,296,5431,1602,4986,300,341,185,273,6085,1124,248,316,170,252,2110,0.225431207380666,0.826666666666667,0.926686217008798,0.918918918918919,0.923076923076923,0.346754313886606
E02006337,Stoneleigh & Auriol,Epsom and Ewell,South East,1738,5301,504,506,373,532,7216,1740,5806,497,539,378,561,7781,1152,430,500,355,529,2966,0.198415432311402,0.865191146881288,0.927643784786642,0.939153439153439,0.942959001782531,0.38118493766868
E02006338,West Ewell,Epsom and Ewell,South East,1436,4193,377,404,263,350,5587,1360,4544,379,417,290,354,5984,1039,348,386,269,325,2367,0.228653169014085,0.91820580474934,0.925659472422062,0.927586206896552,0.918079096045198,0.395554812834225
E02006339,Horton & Manor Park,Epsom and Ewell,South East,2780,6872,421,359,252,252,8156,2708,7588,412,402,266,289,8957,1703,346,356,233,248,2886,0.224433315761729,0.839805825242718,0.885572139303483,0.87593984962406,0.858131487889273,0.322206095791001
E02006341,Epsom North,Epsom and Ewell,South East,2119,6286,410,442,316,506,7960,2064,7155,442,449,342,557,8945,1554,371,402,323,516,3166,0.217190775681342,0.839366515837104,0.89532293986637,0.944444444444444,0.926391382405745,0.3539407490218
E02006342,Epsom Town,Epsom and Ewell,South East,1587,5451,315,358,276,576,6976,1503,5988,313,388,291,600,7580,1112,253,339,266,564,2534,0.185704742818971,0.808306709265176,0.873711340206186,0.914089347079038,0.94,0.334300791556728
E02006343,Epsom Downs & Common,Epsom and Ewell,South East,1982,5146,446,448,325,460,6825,1998,6051,466,461,334,495,7807,1278,428,432,317,464,2919,0.211204759543877,0.918454935622318,0.937093275488069,0.949101796407186,0.937373737373737,0.373895222236454
E02006837,Ewell East,Epsom and Ewell,South East,2147,6499,577,658,484,774,8992,2181,7647,567,664,524,725,10127,1723,505,620,496,676,4020,0.225317117823983,0.890652557319224,0.933734939759036,0.946564885496183,0.932413793103448,0.3969586254567
E02006344,West Clandon & Send,Guildford,South East,1579,5018,511,621,398,577,7125,1402,5316,534,547,444,592,7433,966,486,508,426,548,2934,0.181715575620767,0.910112359550562,0.928702010968921,0.959459459459459,0.925675675675676,0.394726220906767
E02006345,Pirbright & Normandy,Guildford,South East,1368,4662,306,355,215,326,5864,1274,5630,339,350,275,352,6946,634,309,328,262,337,1870,0.112611012433393,0.911504424778761,0.937142857142857,0.952727272727273,0.957386363636364,0.269219694788367
E02006346,Horsley & Effingham,Guildford,South East,2043,5828,567,669,440,726,8230,1908,6557,559,691,503,777,9087,1270,518,649,484,734,3655,0.193686136952875,0.926654740608229,0.939218523878437,0.962226640159046,0.944658944658945,0.402222955871025
E02006347,Ash Vale,Guildford,South East,1406,4723,408,365,274,359,6129,1291,4653,367,409,278,410,6117,586,312,376,269,383,1926,0.125940253599828,0.850136239782016,0.919315403422983,0.967625899280575,0.934146341463415,0.314860225600785
E02006348,"Worplesdon, Jacobs Well & Wood Street",Guildford,South East,1577,5427,443,464,347,568,7249,1573,5673,438,491,394,623,7619,1163,400,475,379,584,3001,0.205006169575181,0.91324200913242,0.967413441955193,0.961928934010152,0.937399678972713,0.393883711773199
E02006349,Stoughton,Guildford,South East,1594,6133,308,272,199,337,7249,1600,5782,345,331,193,321,6972,1046,297,300,175,297,2115,0.180906260809409,0.860869565217391,0.906344410876133,0.906735751295337,0.925233644859813,0.303356282271945
E02006350,"Bellfields, Slyfield & Weyfield",Guildford,South East,1314,4428,246,219,149,236,5278,1278,4845,248,264,152,222,5731,875,209,238,143,207,1672,0.180598555211558,0.842741935483871,0.901515151515152,0.94078947368421,0.932432432432432,0.291746641074856
E02006351,Burpham North & Merrow East,Guildford,South East,1989,5466,347,379,215,348,6755,1860,5773,368,397,209,400,7147,1176,340,371,190,384,2461,0.203706911484497,0.923913043478261,0.934508816120907,0.909090909090909,0.96,0.344340282636071
E02006352,Woodbridge Hill,Guildford,South East,1093,5106,230,274,153,214,5977,1030,4328,264,251,186,226,5255,768,229,232,172,207,1608,0.177449168207024,0.867424242424242,0.924302788844621,0.924731182795699,0.915929203539823,0.305994291151285
E02006353,Ash Wharf,Guildford,South East,1207,3974,286,332,237,333,5162,1161,4037,289,317,249,337,5229,598,250,305,228,318,1699,0.148129799355957,0.865051903114187,0.962145110410095,0.91566265060241,0.943620178041543,0.324918722509084
E02006354,"Burpham, Boxgrove & Merrow West",Guildford,South East,2092,5769,465,454,352,649,7689,1988,6360,460,471,392,695,8378,1120,423,450,362,659,3014,0.176100628930818,0.919565217391304,0.955414012738854,0.923469387755102,0.948201438848921,0.359751730723323
E02006355,Park Barn & Royal Surrey,Guildford,South East,1234,8461,192,185,114,238,9190,1163,6929,226,174,122,221,7672,1270,192,154,112,205,1933,0.183287631692885,0.849557522123894,0.885057471264368,0.918032786885246,0.927601809954751,0.251955161626694
E02006356,Guildford Town Centre,Guildford,South East,1737,9467,349,268,184,367,10635,1760,9733,368,296,255,411,11063,1228,294,259,235,383,2399,0.126168704407685,0.798913043478261,0.875,0.92156862745098,0.931873479318735,0.216848955979391
E02006357,Tongham,Guildford,South East,1105,3967,358,363,271,275,5234,1228,4465,434,381,266,322,5868,725,394,356,259,307,2041,0.162374020156775,0.907834101382488,0.934383202099738,0.973684210526316,0.953416149068323,0.347818677573279
E02006358,Onslow Village and University,Guildford,South East,1151,7483,229,248,152,265,8377,1128,8393,257,247,165,243,9305,830,221,225,152,226,1654,0.0988919337543191,0.859922178988327,0.910931174089069,0.921212121212121,0.930041152263374,0.17775389575497
E02006359,Pewley Down & The Mount,Guildford,South East,1176,4008,331,325,229,326,5219,1061,4238,333,354,218,341,5484,642,290,322,205,324,1783,0.151486550259556,0.870870870870871,0.909604519774011,0.940366972477064,0.950146627565982,0.325127644055434
E02006360,Shalford & Wanborough,Guildford,South East,1559,4750,434,426,367,730,6707,1506,5213,456,427,384,715,7195,992,410,404,361,670,2837,0.190293497026664,0.899122807017544,0.946135831381733,0.940104166666667,0.937062937062937,0.394301598332175
E02006361,"Gomshall, Shere & Albury",Guildford,South East,1005,3318,354,400,264,364,4700,933,3702,417,431,306,376,5232,494,372,410,290,355,1921,0.133441383036197,0.892086330935252,0.951276102088167,0.947712418300654,0.944148936170213,0.367163608562691
E02006362,Ashtead East,Mole Valley,South East,1309,3768,371,424,306,513,5382,1359,4452,394,427,339,551,6163,783,359,398,317,514,2371,0.175876010781671,0.911167512690355,0.93208430913349,0.935103244837758,0.932849364791289,0.384715236086322
E02006363,Ashtead West,Mole Valley,South East,1266,3513,317,351,278,496,4955,1230,3869,365,353,287,440,5314,763,346,325,268,415,2117,0.19720858102869,0.947945205479452,0.920679886685553,0.933797909407665,0.943181818181818,0.398381633421152
E02006364,Leatherhead North,Mole Valley,South East,1579,4946,313,281,193,315,6048,1521,5408,313,319,209,352,6601,936,248,274,187,313,1958,0.173076923076923,0.792332268370607,0.858934169278997,0.894736842105263,0.889204545454545,0.296621723981215
E02006365,Leatherhead South & Ashtead South,Mole Valley,South East,1001,3583,370,397,334,547,5231,976,4067,399,373,325,595,5759,710,358,337,305,551,2261,0.174575854438161,0.897243107769424,0.903485254691689,0.938461538461539,0.926050420168067,0.392602882444869
E02006366,Fetcham,Mole Valley,South East,1430,4552,509,534,356,605,6556,1412,5034,537,541,411,595,7118,1122,494,509,389,564,3078,0.222884386174017,0.919925512104283,0.940850277264325,0.94647201946472,0.947899159663866,0.432424838437763
E02006367,Bookham North,Mole Valley,South East,972,3163,341,445,337,579,4865,977,3525,360,400,376,576,5237,866,322,380,358,546,2472,0.245673758865248,0.894444444444445,0.95,0.952127659574468,0.947916666666667,0.472025969066259
E02006368,Bookham South,Mole Valley,South East,982,2920,369,422,285,559,4555,956,3410,399,386,324,551,5070,875,354,362,316,522,2429,0.256598240469208,0.887218045112782,0.937823834196891,0.975308641975309,0.947368421052632,0.479092702169625
E02006369,Box Hill & Brockham,Mole Valley,South East,834,3447,455,522,371,590,5385,852,3859,512,495,422,596,5884,893,455,464,405,567,2784,0.231407100285048,0.888671875,0.937373737373737,0.959715639810426,0.951342281879195,0.473147518694765
E02006370,Dorking North & Westhumble,Mole Valley,South East,1043,3915,365,336,242,372,5230,1068,4425,353,377,287,400,5842,862,316,363,278,384,2203,0.194802259887006,0.895184135977337,0.962864721485411,0.968641114982578,0.96,0.377096884628552
E02006371,Dorking South,Mole Valley,South East,1290,4432,355,383,280,589,6039,1284,4967,449,403,328,565,6712,1021,403,375,315,512,2626,0.205556674048722,0.897550111358575,0.930521091811414,0.960365853658537,0.906194690265487,0.391239570917759
E02006372,Holmwoods,Mole Valley,South East,1298,3928,333,304,249,396,5210,1285,4359,331,295,240,367,5592,1005,299,276,229,348,2157,0.230557467309016,0.903323262839879,0.935593220338983,0.954166666666667,0.948228882833788,0.385729613733906
E02006373,"Westcott, Ockley & Capel",Mole Valley,South East,1409,4583,424,487,303,456,6253,1267,5134,457,470,351,490,6902,1016,406,432,330,461,2645,0.197896377093884,0.888402625820569,0.919148936170213,0.94017094017094,0.940816326530612,0.383222254419009
E02006374,"Charlwood, Newdigate & Beare Green",Mole Valley,South East,1115,4326,505,486,330,361,6008,1115,4772,484,498,363,444,6561,974,454,460,345,416,2649,0.204107292539816,0.93801652892562,0.923694779116466,0.950413223140496,0.936936936936937,0.403749428440787
E02006375,Nork,Reigate and Banstead,South East,1281,3984,397,401,277,380,5439,1340,4324,375,404,291,431,5825,1010,339,376,282,400,2407,0.233580018501388,0.904,0.930693069306931,0.969072164948454,0.928074245939675,0.413218884120172
E02006376,Banstead,Reigate and Banstead,South East,1381,5455,463,556,390,919,7783,1397,5845,479,537,413,854,8128,1201,438,505,383,794,3321,0.205474764756202,0.914405010438413,0.940409683426443,0.927360774818402,0.929742388758782,0.408587598425197
E02006377,Tattenham North,Reigate and Banstead,South East,1069,3488,405,400,288,462,5043,1070,3912,386,444,318,472,5532,821,356,430,307,428,2342,0.209867075664622,0.922279792746114,0.968468468468468,0.965408805031447,0.906779661016949,0.423355025307303
E02006378,Chipstead & Netherne,Reigate and Banstead,South East,1746,5627,436,444,279,490,7276,1702,5758,455,449,321,449,7432,1197,394,421,292,412,2716,0.207884682181313,0.865934065934066,0.937639198218263,0.909657320872274,0.917594654788419,0.365446716899892
E02006379,Tattenham South,Reigate and Banstead,South East,1646,4082,261,265,148,229,4985,1758,4558,270,251,165,233,5477,1079,220,219,150,206,1874,0.236726634488811,0.814814814814815,0.872509960159363,0.909090909090909,0.88412017167382,0.342158115756801
E02006380,Tadworth & Walton,Reigate and Banstead,South East,1180,3959,461,466,371,640,5897,1217,4462,476,512,415,607,6472,1098,439,477,393,568,2975,0.246077991931869,0.922268907563025,0.931640625,0.946987951807229,0.935749588138385,0.459672435105068
E02006381,Kingswood,Reigate and Banstead,South East,1221,4259,383,468,352,521,5983,1227,4616,419,476,354,499,6364,1096,381,443,334,466,2720,0.237435008665511,0.909307875894988,0.930672268907563,0.943502824858757,0.933867735470942,0.427404148334381
E02006382,Merstham,Reigate and Banstead,South East,1522,4160,276,283,146,259,5124,1630,4836,278,292,175,258,5839,1044,238,261,154,243,1940,0.215880893300248,0.856115107913669,0.893835616438356,0.88,0.941860465116279,0.332248672717931
E02006383,Reigate Hill & Gatton,Reigate and Banstead,South East,2234,6057,413,447,387,803,8107,2192,6557,465,465,409,785,8681,1138,403,434,377,735,3087,0.173554979411316,0.866666666666667,0.933333333333333,0.921760391198044,0.936305732484076,0.355604193065315
E02006384,Redhill West,Reigate and Banstead,South East,2355,7108,443,447,288,506,8792,2431,7946,420,444,334,524,9668,1309,321,386,309,480,2805,0.164736974578404,0.764285714285714,0.869369369369369,0.925149700598802,0.916030534351145,0.290132395531651
E02006385,Redhill East,Reigate and Banstead,South East,2584,8055,292,280,202,325,9154,2544,8561,343,316,223,334,9777,1426,261,280,208,300,2475,0.166569326013316,0.760932944606414,0.886075949367089,0.932735426008969,0.898203592814371,0.253145136544952
E02006386,Reigate Central & Redhill Common,Reigate and Banstead,South East,2083,5023,341,345,258,399,6366,1937,5497,359,367,265,396,6884,959,321,341,247,367,2235,0.174458795706749,0.894150417827298,0.929155313351499,0.932075471698113,0.926767676767677,0.3246658919233
E02006387,Reigate South Park,Reigate and Banstead,South East,1598,3859,271,359,215,321,5025,1525,4410,286,334,214,274,5518,867,258,307,202,267,1901,0.196598639455782,0.902097902097902,0.919161676646707,0.94392523364486,0.974452554744525,0.344508880028996
E02006388,Earlswood & Whitebushes,Reigate and Banstead,South East,1908,5832,424,382,260,305,7203,1886,6691,391,431,261,347,8121,1513,312,389,247,329,2790,0.226124645045584,0.797953964194373,0.902552204176334,0.946360153256705,0.948126801152738,0.343553749538234
E02006389,Salfords & Woodhatch,Reigate and Banstead,South East,1484,4101,394,375,253,386,5509,1504,4643,373,395,268,380,6059,1016,339,377,257,361,2350,0.218824036183502,0.908847184986595,0.954430379746835,0.958955223880597,0.95,0.387852780986962
E02006390,Horley West,Reigate and Banstead,South East,1947,5232,481,426,278,436,6853,2245,6490,455,459,313,429,8146,1242,400,425,290,408,2765,0.191371340523883,0.879120879120879,0.925925925925926,0.926517571884984,0.951048951048951,0.33943039528603
E02006391,Horley East,Reigate and Banstead,South East,1810,4864,366,318,182,252,5982,1781,5286,387,343,217,280,6513,975,347,321,205,264,2112,0.184449489216799,0.896640826873385,0.935860058309038,0.944700460829493,0.942857142857143,0.324274527867342
E02006392,Horley Central,Reigate and Banstead,South East,1689,5797,457,436,292,507,7489,1727,6379,473,438,299,573,8162,1183,405,391,282,540,2801,0.185452265245336,0.856236786469345,0.892694063926941,0.94314381270903,0.942408376963351,0.343175692232296
E02006393,Egham Town,Runnymede,South East,955,4984,199,187,184,304,5858,927,4917,230,189,165,370,5871,524,184,171,155,335,1369,0.106569046166362,0.8,0.904761904761905,0.939393939393939,0.905405405405405,0.233180037472322
E02006394,Englefield Green & University,Runnymede,South East,1469,10321,360,359,251,431,11722,1529,10295,358,367,266,470,11756,789,311,325,244,434,2103,0.0766391452161243,0.868715083798883,0.885558583106267,0.917293233082707,0.923404255319149,0.178887376658727
E02006395,Egham Hythe & Pooley Green,Runnymede,South East,1849,6471,426,342,224,421,7884,1943,6997,459,415,229,423,8523,1079,396,376,214,389,2454,0.154208946691439,0.862745098039216,0.906024096385542,0.934497816593886,0.919621749408983,0.287926786342837
E02006396,Thorpe,Runnymede,South East,917,3726,389,452,256,399,5222,1006,4182,403,427,324,413,5749,866,342,399,296,378,2281,0.207077953132473,0.84863523573201,0.934426229508197,0.91358024691358,0.915254237288136,0.39676465472256
E02006397,Virginia Water,Runnymede,South East,1350,4079,295,315,221,468,5378,1339,4758,360,321,285,468,6192,781,303,277,272,439,2072,0.164144598570828,0.841666666666667,0.862928348909657,0.954385964912281,0.938034188034188,0.334625322997416
E02006398,Chertsey,Runnymede,South East,1688,5437,329,351,240,408,6765,1716,6048,352,361,280,387,7428,1368,310,319,258,338,2593,0.226190476190476,0.880681818181818,0.883656509695291,0.921428571428571,0.873385012919897,0.349084544964997
E02006399,Addlestone North,Runnymede,South East,2354,7499,523,519,407,629,9577,2512,8352,574,537,452,681,10596,1942,483,492,421,634,3972,0.232519157088123,0.841463414634146,0.916201117318436,0.93141592920354,0.930983847283407,0.374858437146093
E02006400,Ottershaw & Lyne,Runnymede,South East,972,3665,305,335,246,392,4943,1079,4113,356,367,269,415,5520,1093,306,328,246,384,2357,0.265742766836859,0.859550561797753,0.893732970027248,0.91449814126394,0.925301204819277,0.426992753623188
E02006401,Addlestone South,Runnymede,South East,2194,6488,444,464,378,616,8390,2113,6948,471,470,412,609,8910,1657,403,439,379,566,3444,0.238485895221647,0.855626326963907,0.934042553191489,0.919902912621359,0.929392446633826,0.386531986531987
E02006402,New Haw & Woodham,Runnymede,South East,1813,6062,489,571,397,605,8124,1900,6733,508,576,417,608,8842,1433,448,534,389,569,3373,0.212832318431606,0.881889763779528,0.927083333333333,0.932853717026379,0.935855263157895,0.38147477946166
E02006403,Stanwell North & Stanwell Moor,Spelthorne,South East,1301,4248,266,270,163,219,5166,1355,4813,277,269,180,258,5797,785,216,229,166,228,1624,0.163099937668814,0.779783393501805,0.851301115241636,0.922222222222222,0.883720930232558,0.280144902535794
E02006404,Stanwell South,Spelthorne,South East,1891,4909,242,223,203,308,5885,1916,5698,290,228,192,316,6724,971,211,177,160,280,1799,0.17041067041067,0.727586206896552,0.776315789473684,0.833333333333333,0.886075949367089,0.267549077929804
E02006405,Ashford West,Spelthorne,South East,2023,6939,492,588,329,533,8881,2205,8239,506,571,367,572,10255,1345,431,515,344,535,3170,0.163247966986285,0.851778656126482,0.901926444833625,0.93732970027248,0.935314685314685,0.309117503656753
E02006406,Staines Town,Spelthorne,South East,1672,5967,309,281,185,347,7089,1684,7067,329,315,231,350,8292,718,268,281,219,317,1803,0.101598981180133,0.814589665653496,0.892063492063492,0.948051948051948,0.905714285714286,0.217438494934877
E02006407,Ashford East,Spelthorne,South East,1689,5332,437,422,378,544,7113,1800,6283,441,458,397,578,8157,1179,388,422,370,526,2885,0.187649212159796,0.879818594104308,0.921397379912664,0.931989924433249,0.910034602076125,0.353683952433493
E02006408,Ashford Common,Spelthorne,South East,1748,5292,365,353,304,489,6803,1733,5855,391,338,321,475,7380,1042,335,310,298,439,2424,0.17796754910333,0.856777493606138,0.917159763313609,0.928348909657321,0.924210526315789,0.328455284552846
E02006409,Staines South East,Spelthorne,South East,1423,4223,319,316,220,323,5401,1391,4702,338,335,240,320,5935,754,278,303,222,294,1851,0.160357294768184,0.822485207100592,0.904477611940299,0.925,0.91875,0.311878685762426
E02006410,Sunbury Common,Spelthorne,South East,1880,5275,338,304,232,357,6506,1886,5809,352,331,206,347,7045,947,276,295,188,305,2011,0.163022895506972,0.784090909090909,0.891238670694864,0.912621359223301,0.878962536023055,0.285450674237048
E02006411,Staines South West,Spelthorne,South East,1244,4257,381,387,337,494,5856,1265,4813,407,394,339,577,6530,653,356,357,319,543,2228,0.135674215665905,0.874692874692875,0.906091370558376,0.941002949852507,0.94107452339688,0.341194486983155
E02006412,Sunbury East,Spelthorne,South East,1513,4268,408,423,349,470,5918,1514,4833,410,451,337,512,6543,836,359,417,316,473,2401,0.172977446720463,0.875609756097561,0.924611973392461,0.937685459940653,0.923828125,0.366957053339447
E02006413,Halliford & Sunbury West,Spelthorne,South East,1132,3489,383,371,254,457,4954,1183,4154,373,370,267,513,5677,778,324,350,245,472,2169,0.187289359653346,0.868632707774799,0.945945945945946,0.917602996254682,0.920077972709552,0.382067993658622
E02006414,Littleton & Shepperton Green,Spelthorne,South East,1143,3720,336,349,244,405,5054,1171,4008,363,354,264,403,5392,918,316,334,252,371,2191,0.229041916167665,0.870523415977961,0.943502824858757,0.954545454545455,0.920595533498759,0.406342729970326
E02006415,Shepperton Town,Spelthorne,South East,1060,3661,373,477,385,603,5499,1036,4109,424,475,433,705,6146,908,380,453,427,651,2819,0.220978340228766,0.89622641509434,0.953684210526316,0.986143187066975,0.923404255319149,0.458672307191669
E02006416,Chobham & Windlesham,Surrey Heath,South East,1562,4877,527,482,396,535,6817,1500,5544,521,518,397,558,7538,904,470,489,374,527,2764,0.163059163059163,0.9021113243762,0.944015444015444,0.942065491183879,0.944444444444444,0.366675510745556
E02006417,Bagshot,Surrey Heath,South East,1234,3675,283,357,185,331,4831,1249,4237,319,347,231,338,5472,672,280,325,226,310,1813,0.158602784989379,0.877742946708464,0.936599423631124,0.978354978354978,0.917159763313609,0.331323099415205
E02006418,Lightwater,Surrey Heath,South East,1072,4015,400,407,315,511,5648,1018,4286,399,399,339,501,5924,784,365,384,325,488,2346,0.182921138590761,0.914786967418546,0.962406015037594,0.958702064896755,0.974051896207585,0.396016205266712
E02006419,Camberley North,Surrey Heath,South East,1695,5272,316,261,217,379,6445,1643,5761,349,269,203,448,7030,907,299,238,188,411,2043,0.15743794480125,0.856733524355301,0.884758364312268,0.926108374384236,0.917410714285714,0.290611664295875
E02006420,Camberley Town,Surrey Heath,South East,1344,4614,401,436,358,622,6431,1266,5324,433,473,382,629,7241,842,376,440,367,596,2621,0.158151765589782,0.868360277136259,0.930232558139535,0.960732984293194,0.947535771065183,0.361966579201768
E02006421,West End & Bisley,Surrey Heath,South East,1857,5600,386,380,347,459,7172,2099,6570,416,459,326,552,8323,1147,364,433,311,507,2762,0.174581430745814,0.875,0.943355119825708,0.95398773006135,0.918478260869565,0.33185149585486
E02006422,Camberley Heatherside,Surrey Heath,South East,1318,3635,306,358,237,277,4813,1287,4109,334,367,277,302,5389,738,295,350,266,286,1935,0.1796057434899,0.883233532934132,0.953678474114441,0.96028880866426,0.947019867549669,0.359064761551308
E02006423,Camberley West,Surrey Heath,South East,2045,7189,443,482,365,672,9151,2039,8291,514,485,405,638,10333,1380,423,439,374,579,3195,0.16644554336027,0.82295719844358,0.905154639175258,0.923456790123457,0.907523510971787,0.30920352269428
E02006424,Camberley Parkside,Surrey Heath,South East,1237,3629,371,362,320,429,5111,1243,4170,378,418,314,444,5724,814,337,394,304,423,2272,0.195203836930456,0.891534391534391,0.942583732057416,0.968152866242038,0.952702702702703,0.396925227113906
E02006425,Frimley,Surrey Heath,South East,1316,4082,254,315,243,351,5245,1232,4529,312,322,266,346,5775,1036,283,308,254,326,2207,0.228748068006182,0.907051282051282,0.956521739130435,0.954887218045113,0.942196531791908,0.382164502164502
E02006426,Frimley Green,Surrey Heath,South East,1076,3449,301,312,198,209,4469,1080,3723,335,334,265,347,5004,535,296,316,255,332,1734,0.143701316142896,0.883582089552239,0.946107784431138,0.962264150943396,0.956772334293948,0.34652278177458
E02006427,Mytchett & Frith Hill,Surrey Heath,South East,1401,4539,285,381,263,547,6015,1321,4321,336,323,267,346,5593,567,287,307,253,329,1743,0.131219625086785,0.854166666666667,0.95046439628483,0.947565543071161,0.950867052023121,0.311639549436796
E02006429,Warlingham West & Whyteleafe,Tandridge,South East,1434,5059,345,426,248,367,6445,1539,5376,385,385,320,365,6831,1090,324,348,303,341,2406,0.202752976190476,0.841558441558442,0.903896103896104,0.946875,0.934246575342466,0.3522178304787
E02006430,Caterham North,Tandridge,South East,2180,6082,389,414,286,407,7578,2126,6390,430,409,300,443,7972,1434,373,383,276,408,2874,0.224413145539906,0.867441860465116,0.936430317848411,0.92,0.920993227990971,0.360511791269443
E02006431,Caterham Valley,Tandridge,South East,2413,7026,564,531,352,584,9057,2369,7585,591,553,400,610,9739,1535,460,512,369,567,3443,0.202373104812129,0.77834179357022,0.925858951175407,0.9225,0.929508196721311,0.353527056165931
E02006432,Caterham West,Tandridge,South East,1082,3403,306,370,246,443,4768,1044,3676,335,356,283,407,5057,843,291,334,266,385,2119,0.229325353645267,0.86865671641791,0.938202247191011,0.939929328621908,0.945945945945946,0.419023136246787
E02006433,Oxted North,Tandridge,South East,1834,5355,508,551,437,830,7681,1834,5855,521,571,468,776,8191,1615,473,526,450,748,3812,0.275832621690863,0.907869481765835,0.921190893169877,0.961538461538461,0.963917525773196,0.465388841411305
E02006434,Oxted South,Tandridge,South East,1445,3811,330,328,224,383,5076,1433,4171,328,328,238,386,5451,1178,309,310,233,368,2398,0.282426276672261,0.942073170731707,0.945121951219512,0.978991596638655,0.953367875647668,0.439919280865896
E02006435,Nutfield & Bletchingley,Tandridge,South East,1170,3775,386,356,246,305,5068,1181,3977,385,365,249,322,5298,758,310,338,230,289,1925,0.190595926577823,0.805194805194805,0.926027397260274,0.923694779116466,0.897515527950311,0.363344658361646
E02006436,Godstone,Tandridge,South East,1253,3576,311,338,251,369,4845,1273,4059,333,315,256,383,5346,792,268,299,241,355,1955,0.195121951219512,0.804804804804805,0.949206349206349,0.94140625,0.926892950391645,0.365693976805088
E02006437,Lingfield & Dormansland,Tandridge,South East,1478,5105,495,580,449,649,7278,1482,5249,529,530,440,662,7410,809,473,502,414,619,2817,0.154124595160983,0.89413988657845,0.947169811320755,0.940909090909091,0.935045317220544,0.380161943319838
E02006438,Smallfield & Felbridge,Tandridge,South East,1374,4854,531,563,387,477,6812,1411,5547,560,582,445,526,7660,1177,482,528,418,504,3109,0.212186767622138,0.860714285714286,0.907216494845361,0.939325842696629,0.958174904942966,0.405874673629243
E02006790,Warlingham East & Tatsfield,Tandridge,South East,1452,4517,437,498,345,609,6406,1435,4820,453,499,378,630,6780,1126,404,478,360,595,2963,0.233609958506224,0.891832229580574,0.957915831663327,0.952380952380952,0.944444444444444,0.437020648967552
E02006439,Farnham Weybourne & Badshot Lea,Waverley,South East,1122,3471,347,345,282,368,4813,1111,3972,328,366,277,384,5327,695,299,341,268,371,1974,0.174974823766365,0.911585365853659,0.931693989071038,0.967509025270758,0.966145833333333,0.370565045992116
E02006440,Farnham Upper Hale,Waverley,South East,1394,4111,394,442,277,370,5594,1343,4690,402,426,317,402,6237,761,368,411,297,385,2222,0.16226012793177,0.915422885572139,0.964788732394366,0.936908517350158,0.95771144278607,0.35626102292769
E02006441,Farnham Town,Waverley,South East,1375,5385,331,413,283,665,7077,1360,5948,372,374,351,667,7712,727,333,355,326,640,2381,0.122225958305313,0.895161290322581,0.949197860962567,0.928774928774929,0.95952023988006,0.308739626556017
E02006442,Farnham Moor Park & Bourne,Waverley,South East,1387,3388,354,370,269,511,4892,1384,3944,340,382,280,491,5437,573,312,366,272,477,2000,0.145283975659229,0.917647058823529,0.958115183246073,0.971428571428571,0.971486761710794,0.367849917233769
E02006443,Farncombe,Waverley,South East,1420,4324,393,370,303,528,5918,1457,4842,396,350,318,468,6374,1097,337,324,310,441,2509,0.226559273027675,0.851010101010101,0.925714285714286,0.974842767295597,0.942307692307692,0.393630373391905
E02006444,Farnham Shortheath,Waverley,South East,1717,4103,300,358,244,399,5404,1650,4510,326,367,258,394,5855,653,303,355,242,379,1932,0.144789356984479,0.929447852760736,0.967302452316076,0.937984496124031,0.961928934010152,0.32997438087105
E02006445,Godalming North,Waverley,South East,1786,4954,376,343,271,381,6325,1735,5675,328,368,297,439,7107,975,287,336,278,416,2292,0.171806167400881,0.875,0.91304347826087,0.936026936026936,0.947608200455581,0.322498944702406
E02006446,"Blackheath, Wonersh & Shamley Green",Waverley,South East,1416,3915,378,420,293,492,5498,1376,4467,389,401,351,500,6108,829,345,372,334,468,2348,0.185583165435415,0.886889460154242,0.927680798004987,0.951566951566952,0.936,0.384413883431565
E02006447,Farnham Wrecclesham,Waverley,South East,1388,3619,339,343,291,413,5005,1411,4144,374,376,310,400,5604,643,334,362,298,388,2025,0.155164092664093,0.893048128342246,0.962765957446809,0.961290322580645,0.97,0.36134903640257
E02006448,Godalming South,Waverley,South East,1644,4358,350,384,245,399,5736,1563,4757,349,380,266,393,6145,1008,320,359,253,367,2307,0.211898255202859,0.916905444126075,0.944736842105263,0.951127819548872,0.933842239185751,0.375427176566314
E02006449,Elstead & Milford,Waverley,South East,1312,3906,373,415,322,657,5673,1315,4444,362,426,340,626,6198,874,318,406,321,592,2511,0.196669666966697,0.878453038674033,0.953051643192488,0.944117647058824,0.945686900958466,0.40513068731849
E02006450,"Wheelerstreet, Wormley & Hambledon",Waverley,South East,1528,4288,355,348,327,417,5735,1440,5020,426,406,322,428,6602,873,369,380,305,402,2329,0.17390438247012,0.866197183098592,0.935960591133005,0.947204968944099,0.939252336448598,0.352771887306877
E02006451,Cranleigh,Waverley,South East,2168,6226,687,838,636,848,9235,2212,7309,730,848,707,910,10504,1612,686,814,682,877,4671,0.220550006840881,0.93972602739726,0.959905660377358,0.964639321074965,0.963736263736264,0.44468773800457
E02006453,Ewhurst & Chiddingfold,Waverley,South East,1345,4553,469,569,474,706,6771,1511,5719,522,591,501,765,8098,871,459,555,486,730,3101,0.152299353033747,0.879310344827586,0.939086294416244,0.970059880239521,0.954248366013072,0.382934057792047
E02006454,Haslemere East,Waverley,South East,1370,3725,351,368,279,613,5336,1367,4128,370,374,267,614,5753,793,335,342,251,578,2299,0.192102713178295,0.905405405405405,0.914438502673797,0.940074906367041,0.941368078175896,0.39961759082218
E02006455,Haslemere West,Waverley,South East,1257,3736,288,279,192,430,4925,1213,3989,301,277,238,395,5200,827,274,262,221,367,1951,0.207320130358486,0.910299003322259,0.945848375451263,0.928571428571429,0.929113924050633,0.375192307692308
E02006839,"Hindhead, Beacon Hill & Frensham",Waverley,South East,1543,4959,515,572,391,782,7219,1462,5278,529,531,431,774,7543,992,461,506,403,736,3098,0.187949981053429,0.871455576559546,0.952919020715631,0.935034802784223,0.950904392764858,0.41071191833488
E02006456,Byfleet,Woking,South East,1652,4519,346,359,279,440,5943,1638,5363,368,366,287,476,6860,1024,324,334,274,438,2394,0.190937907887376,0.880434782608696,0.912568306010929,0.954703832752613,0.920168067226891,0.348979591836735
E02006457,West Byfleet & Pyrford North,Woking,South East,1739,5008,502,539,462,754,7265,1811,6184,506,555,451,770,8466,1077,441,520,431,724,3193,0.174159120310479,0.871541501976285,0.936936936936937,0.955654101995565,0.94025974025974,0.377155681549728
E02006458,Horsell,Woking,South East,1833,5202,474,495,345,650,7166,1901,6055,496,505,383,624,8063,1046,451,475,364,572,2908,0.172749793559042,0.909274193548387,0.940594059405941,0.950391644908616,0.916666666666667,0.36065980404316
E02006459,Sheerwater,Woking,South East,2475,6976,359,212,161,252,7960,2639,8964,391,262,158,336,10111,1293,286,213,131,263,2186,0.144243641231593,0.731457800511509,0.812977099236641,0.829113924050633,0.782738095238095,0.216200178023934
E02006460,Goldsworth Park,Woking,South East,1999,5546,485,406,220,337,6994,1990,6293,506,461,268,327,7855,1203,421,418,250,302,2594,0.191164786270459,0.83201581027668,0.906724511930586,0.932835820895522,0.923547400611621,0.330235518777849
E02006461,Maybury Hill & Pyrford South,Woking,South East,1315,3961,367,344,259,572,5503,1333,4817,410,353,295,448,6323,849,348,321,262,408,2188,0.176250778492838,0.848780487804878,0.909348441926346,0.888135593220339,0.910714285714286,0.346038272971691
E02006462,Knaphill,Woking,South East,1751,4997,355,341,244,323,6260,1773,5825,360,380,258,342,7165,1133,303,357,237,318,2348,0.19450643776824,0.841666666666667,0.939473684210526,0.918604651162791,0.929824561403509,0.327704117236567
E02006463,Woking Central,Woking,South East,2209,7260,350,340,236,455,8641,2136,8556,353,347,260,444,9960,1151,268,302,231,402,2354,0.134525479195886,0.759206798866856,0.870317002881844,0.888461538461538,0.905405405405405,0.236345381526104
E02006464,St John's,Woking,South East,1312,3930,339,356,246,406,5277,1325,4522,337,344,260,407,5870,860,290,319,245,383,2097,0.190181335692172,0.86053412462908,0.927325581395349,0.942307692307692,0.941031941031941,0.357240204429302
E02006465,Hook Heath,Woking,South East,1153,3548,352,327,208,357,4792,1224,4175,341,347,226,371,5460,736,307,325,208,343,1919,0.176287425149701,0.900293255131965,0.936599423631124,0.920353982300885,0.924528301886792,0.351465201465201
E02006466,Old Woking & Westfield,Woking,South East,2798,6506,363,348,243,410,7870,2760,7705,380,375,263,391,9114,1490,307,330,239,349,2715,0.193380921479559,0.807894736842105,0.88,0.908745247148289,0.892583120204604,0.297893350888743
E02006467,Mayford & Brookwood,Woking,South East,1500,4122,350,353,239,322,5386,1626,4996,345,344,272,338,6295,900,315,324,257,318,2114,0.180144115292234,0.91304347826087,0.941860465116279,0.944852941176471,0.940828402366864,0.33582208101668
E02006534,Hillside,Adur,South East,1719,5244,478,491,365,576,7154,1684,5801,503,494,402,601,7801,1262,403,457,384,577,3083,0.217548698500259,0.801192842942346,0.925101214574899,0.955223880597015,0.960066555740433,0.39520574285348
E02006535,Buckingham,Adur,South East,1454,4009,445,553,340,508,5855,1433,4403,427,567,407,536,6340,976,334,540,389,521,2760,0.221667045196457,0.782201405152225,0.952380952380952,0.955773955773956,0.972014925373134,0.435331230283912
E02006536,North Lancing,Adur,South East,1408,4341,435,446,303,475,6000,1440,4640,450,459,340,470,6359,1238,364,442,324,440,2808,0.266810344827586,0.808888888888889,0.962962962962963,0.952941176470588,0.936170212765957,0.441578864601352
E02006537,Kingston & Southwick,Adur,South East,2228,6435,494,460,420,644,8453,2157,6871,497,533,381,673,8955,1580,372,506,361,643,3462,0.229951972056469,0.748490945674044,0.949343339587242,0.94750656167979,0.955423476968796,0.386599664991625
E02006538,Shoreham Central & Beach,Adur,South East,1637,5399,557,587,385,608,7536,1546,5580,571,623,436,611,7821,1180,445,577,411,583,3196,0.211469534050179,0.779334500875657,0.926163723916533,0.942660550458715,0.95417348608838,0.408643395985168
E02006539,Cokeham & Sompting,Adur,South East,1278,4168,421,503,415,463,5970,1217,4464,422,468,409,531,6294,1239,338,443,389,511,2920,0.27755376344086,0.800947867298578,0.946581196581197,0.951100244498777,0.962335216572505,0.463933905306641
E02006540,Marsh Barn & Widewater,Adur,South East,982,3206,376,458,309,425,4774,943,3512,356,407,349,449,5073,1018,282,384,331,421,2436,0.289863325740319,0.792134831460674,0.943488943488943,0.948424068767908,0.937639198218263,0.480189237137788
E02006541,South Lancing,Adur,South East,1188,4469,483,581,425,707,6665,1195,4555,447,568,416,737,6723,1306,367,530,395,681,3279,0.286717892425906,0.821029082774049,0.933098591549296,0.949519230769231,0.924016282225237,0.48772869254797
E02006542,Arundel,Arun,South East,784,3070,452,506,365,472,4865,724,3397,457,493,409,518,5274,628,402,453,379,486,2348,0.184869002060642,0.87964989059081,0.918864097363083,0.926650366748166,0.938223938223938,0.44520288206295
E02006543,"Angmering North, Patching & Findon",Arun,South East,840,3092,403,460,311,431,4697,793,3326,424,444,383,448,5025,984,345,421,372,433,2555,0.29585087191822,0.813679245283019,0.948198198198198,0.971279373368146,0.966517857142857,0.508457711442786
E02006544,"Westergate, Eastergate & Walberton",Arun,South East,1901,5996,744,810,545,760,8855,1923,6849,771,834,576,877,9907,1521,687,789,550,814,4361,0.222076215505913,0.891050583657588,0.946043165467626,0.954861111111111,0.928164196123147,0.440193802361966
E02006545,Wick & Toddington,Arun,South East,2629,6376,479,478,311,371,8015,2796,7344,533,509,355,388,9129,1872,360,469,328,366,3395,0.254901960784314,0.675422138836773,0.921414538310412,0.923943661971831,0.943298969072165,0.371891773469164
E02006546,Angmering South,Arun,South East,1870,5629,649,799,604,880,8561,1854,6389,629,826,644,960,9448,1740,446,791,622,932,4531,0.272343089685397,0.70906200317965,0.957627118644068,0.96583850931677,0.970833333333333,0.479572396274344
E02006547,Yapton & Climping,Arun,South East,1187,3853,451,421,268,368,5361,1199,4355,492,461,323,382,6013,875,421,424,300,369,2389,0.200918484500574,0.855691056910569,0.919739696312364,0.928792569659443,0.965968586387435,0.397305837352403
E02006548,Rustington North,Arun,South East,1738,5445,541,587,482,716,7771,1744,6026,558,612,507,764,8467,1556,359,575,490,726,3706,0.258214404248258,0.64336917562724,0.939542483660131,0.96646942800789,0.950261780104712,0.43769930317704
E02006549,Ferring & Kingston Gorse,Arun,South East,539,2617,586,748,606,870,5427,563,2752,543,759,645,930,5629,862,463,736,631,895,3587,0.313226744186047,0.852670349907919,0.96969696969697,0.978294573643411,0.96236559139785,0.637235743471309
E02006550,Littlehampton East,Arun,South East,1384,4779,711,830,609,938,7867,1348,5382,726,845,647,982,8582,1383,488,804,626,942,4243,0.256967670011148,0.672176308539945,0.951479289940828,0.967542503863988,0.959266802443992,0.494406898158937
E02006551,East Preston & Rustington East,Arun,South East,641,3148,834,1198,781,1460,7421,563,3247,779,1090,893,1370,7379,833,586,1058,866,1316,4659,0.256544502617801,0.752246469833119,0.970642201834862,0.96976483762598,0.960583941605839,0.631386366716357
E02006552,Littlehampton West and River,Arun,South East,1158,4552,427,414,289,460,6142,1182,5095,446,442,298,503,6784,1168,256,389,273,465,2551,0.229244357212954,0.573991031390135,0.880090497737557,0.916107382550335,0.924453280318092,0.376031839622642
E02006553,North Bersted,Arun,South East,1658,5351,520,552,366,528,7317,1812,6084,568,593,378,550,8173,1268,495,552,364,527,3206,0.208415516107824,0.871478873239437,0.930860033726813,0.962962962962963,0.958181818181818,0.392267221338554
E02006554,Middleton-on-Sea,Arun,South East,946,3293,562,698,441,690,5684,853,3732,552,653,501,663,6101,806,490,623,477,637,3033,0.215969989281886,0.88768115942029,0.954058192955589,0.952095808383234,0.96078431372549,0.497131617767579
E02006555,South Bersted,Arun,South East,1410,5034,399,354,265,459,6511,1423,5331,419,353,284,460,6847,978,345,320,265,438,2346,0.183455261676984,0.823389021479714,0.906515580736544,0.933098591549296,0.952173913043478,0.342631809551629
E02006556,Felpham,Arun,South East,1824,5031,686,925,613,917,8172,1838,5915,690,908,718,962,9193,1216,623,860,680,904,4283,0.205579036348267,0.902898550724638,0.947136563876652,0.947075208913649,0.93970893970894,0.465897965843577
E02006557,Hawthorn Road,Arun,South East,1677,5090,310,346,239,419,6404,1529,5686,321,354,245,333,6939,958,249,316,221,309,2053,0.168483995779107,0.775700934579439,0.892655367231638,0.902040816326531,0.927927927927928,0.295863957342557
E02006558,Bognor Regis Central,Arun,South East,1540,7844,579,621,454,815,10313,1486,7779,587,603,491,908,10368,1078,443,527,439,834,3321,0.138578223422034,0.754684838160136,0.873963515754561,0.894093686354379,0.918502202643172,0.3203125
E02006559,Aldwick,Arun,South East,883,3615,814,1033,771,1201,7434,865,3926,717,1032,793,1185,7653,886,649,981,769,1134,4419,0.225674987264391,0.905160390516039,0.950581395348837,0.969735182849937,0.956962025316456,0.577420619364955
E02006560,Nyetimber & Pagham,Arun,South East,1337,4613,786,938,672,986,7995,1316,5089,713,930,769,1015,8516,1215,637,891,728,968,4439,0.238750245627825,0.893408134642356,0.958064516129032,0.946684005201561,0.953694581280788,0.521254109910756
E02006561,Fernhurst & Northchapel,Chichester,South East,1499,3829,380,442,305,359,5315,1302,4088,376,454,349,386,5653,801,332,424,325,370,2252,0.195939334637965,0.882978723404255,0.933920704845815,0.931232091690544,0.958549222797927,0.398372545551035
E02006562,Ifold & Wisborough Green,Chichester,South East,1107,3356,425,434,347,374,4936,1029,3820,444,446,354,401,5465,873,393,432,344,384,2426,0.228534031413613,0.885135135135135,0.968609865470852,0.971751412429379,0.957605985037407,0.44391582799634
E02006563,Millland & South Harting,Chichester,South East,956,3228,427,416,313,470,4854,910,3677,446,418,341,434,5316,729,406,396,330,416,2277,0.198259450639108,0.910313901345291,0.947368421052632,0.967741935483871,0.95852534562212,0.428329571106095
E02006564,Midhurst & Cocking,Chichester,South East,1366,4161,602,597,463,729,6552,1263,4651,592,651,475,753,7122,1534,540,618,456,723,3871,0.329821543754031,0.912162162162162,0.949308755760369,0.96,0.960159362549801,0.543527099129458
E02006565,Easebourne & Petworth,Chichester,South East,1258,4275,583,663,484,728,6733,1174,4716,578,664,520,726,7204,1193,514,630,499,689,3525,0.252968617472434,0.889273356401384,0.948795180722892,0.959615384615385,0.949035812672176,0.489311493614659
E02006566,"Dean, Lavant & Summersdale",Chichester,South East,1265,4217,571,613,489,784,6674,1204,4603,556,641,500,854,7154,1244,513,613,486,820,3676,0.270258527047578,0.922661870503597,0.956318252730109,0.972,0.960187353629976,0.51383841207716
E02006567,Westbourne & Funtington,Chichester,South East,1308,3997,519,547,375,567,6005,1310,4670,526,561,436,609,6802,1195,459,536,425,586,3201,0.255888650963597,0.872623574144487,0.955436720142603,0.974770642201835,0.962233169129721,0.470596883269627
E02006568,College Lane & Oaklands,Chichester,South East,1967,7561,546,586,439,805,9937,1948,8262,623,577,443,779,10684,2129,516,509,401,739,4294,0.257685790365529,0.828250401284109,0.882149046793761,0.905191873589165,0.948652118100128,0.401909397229502
E02006569,"Southbourne, Bosham & Thorney",Chichester,South East,1493,4649,570,663,501,710,7093,1562,5436,599,652,531,742,7960,1366,533,615,508,697,3719,0.251287711552612,0.889816360601002,0.943251533742331,0.95668549905838,0.939353099730458,0.467211055276382
E02006570,Central Chichester,Chichester,South East,1089,5970,456,502,440,810,8178,1047,6202,469,567,459,827,8524,1404,378,514,432,757,3485,0.226378587552402,0.805970149253731,0.90652557319224,0.941176470588235,0.915356711003628,0.40884561238855
E02006571,Stockbridge & Fishbourne,Chichester,South East,1546,5158,522,541,459,666,7346,1449,5806,554,589,455,714,8118,1325,493,559,437,679,3493,0.228212194281777,0.889891696750903,0.949066213921902,0.96043956043956,0.950980392156863,0.430278393693028
E02006572,"Tangmere, Mundham & Hunston",Chichester,South East,2101,6502,592,575,403,511,8583,2116,7671,606,621,453,557,9908,1881,509,578,422,514,3904,0.245209229565898,0.83993399339934,0.930756843800322,0.931567328918322,0.922800718132855,0.394025030278563
E02006573,Wittering & Birdham,Chichester,South East,1660,5642,830,1038,799,1238,9547,1803,6396,889,1017,882,1189,10373,1999,805,967,852,1140,5763,0.312539086929331,0.905511811023622,0.950835791543756,0.965986394557823,0.95878889823381,0.555576978694688
E02006574,Selsey,Chichester,South East,1425,5343,960,1152,702,1179,9336,1463,6173,966,1100,872,1218,10329,2189,901,1043,829,1165,6127,0.354608780171716,0.932712215320911,0.948181818181818,0.950688073394496,0.956486042692939,0.593184238551651
E02006575,Langley Green & Gatwick Airport,Crawley,South East,2047,5640,294,248,170,266,6618,2100,6770,340,279,185,283,7857,1220,249,253,166,263,2151,0.180206794682422,0.732352941176471,0.906810035842294,0.897297297297297,0.929328621908127,0.2737686139748
E02006576,Pound Hill,Crawley,South East,1976,5531,420,410,229,367,6957,2198,6574,434,427,264,383,8082,1230,384,401,254,364,2633,0.187100699726194,0.884792626728111,0.939110070257611,0.962121212121212,0.950391644908616,0.32578569660975
E02006577,Ewhurst & West Green,Crawley,South East,1836,5288,308,335,208,527,6666,1971,5997,372,319,236,457,7381,1245,308,301,217,420,2491,0.20760380190095,0.827956989247312,0.943573667711599,0.919491525423729,0.919037199124726,0.337488145237773
E02006578,Manor Royal & Northgate,Crawley,South East,2390,7574,358,341,215,487,8975,2591,9022,405,356,234,435,10452,1456,325,324,218,397,2720,0.161383285302594,0.802469135802469,0.910112359550562,0.931623931623932,0.91264367816092,0.260237275162648
E02006579,Three Bridges,Crawley,South East,1723,5125,348,295,223,368,6359,1666,6036,349,338,217,378,7318,1007,299,310,205,352,2173,0.166832339297548,0.856733524355301,0.917159763313609,0.944700460829493,0.931216931216931,0.296939054386444
E02006580,Ifield & Gossops Green,Crawley,South East,1709,5117,350,308,242,505,6522,1662,5600,413,359,232,512,7116,1278,364,326,217,480,2665,0.228214285714286,0.88135593220339,0.908077994428969,0.935344827586207,0.9375,0.374508150646431
E02006581,Southgate,Crawley,South East,1937,5986,337,344,219,414,7300,2101,6887,417,360,224,458,8346,1391,361,331,202,427,2712,0.201974735007986,0.865707434052758,0.919444444444444,0.901785714285714,0.932314410480349,0.324946081955428
E02006582,Maidenbower East & Worth,Crawley,South East,1697,5156,292,279,145,180,6052,1620,5400,335,340,184,204,6463,912,299,318,173,189,1891,0.168888888888889,0.892537313432836,0.935294117647059,0.940217391304348,0.926470588235294,0.292588581154263
E02006583,Maidenbower West & Furnace Green,Crawley,South East,1843,5842,398,419,246,455,7360,1813,6403,454,437,323,466,8083,1241,393,413,303,439,2789,0.193815399031704,0.865638766519824,0.945080091533181,0.938080495356037,0.94206008583691,0.345045156501299
E02006584,Bewbush,Crawley,South East,1834,5064,310,216,133,130,5853,1805,5755,321,246,133,146,6601,1225,264,219,120,126,1954,0.212858384013901,0.822429906542056,0.890243902439024,0.902255639097744,0.863013698630137,0.296015755188608
E02006585,Tilgate,Crawley,South East,1772,4684,304,253,229,466,5936,1800,5666,319,285,224,437,6931,1052,261,265,215,412,2205,0.185668902223791,0.818181818181818,0.929824561403509,0.959821428571429,0.94279176201373,0.318135911123936
E02006586,Broadfield West,Crawley,South East,1950,5464,320,199,67,67,6117,1913,6236,336,251,107,93,7023,1294,286,226,92,78,1976,0.207504810776139,0.851190476190476,0.900398406374502,0.85981308411215,0.838709677419355,0.281361241634629
E02006587,Broadfield East,Crawley,South East,2035,5914,414,295,164,158,6945,1849,6339,384,316,178,148,7365,1276,332,279,157,131,2175,0.201293579428932,0.864583333333333,0.882911392405063,0.882022471910112,0.885135135135135,0.295315682281059
E02006588,"Rusper, Faygate & Leechpool",Horsham,South East,1686,5880,432,485,286,350,7433,1910,6758,430,513,356,443,8500,1469,372,482,338,419,3080,0.217372003551347,0.865116279069767,0.939571150097466,0.949438202247191,0.945823927765237,0.362352941176471
E02006589,Littlehaven,Horsham,South East,2045,6985,646,700,379,605,9315,2062,7620,671,710,498,600,10099,1911,592,678,480,581,4242,0.250787401574803,0.882265275707899,0.954929577464789,0.963855421686747,0.968333333333333,0.420041588276067
E02006590,Broadbridge Heath & Warnham,Horsham,South East,1730,5575,454,498,324,523,7374,1587,5803,449,509,357,543,7661,1473,406,475,344,516,3214,0.253834223677408,0.904231625835189,0.933202357563851,0.963585434173669,0.950276243093923,0.419527476830701
E02006591,Horsham East & Roffey,Horsham,South East,1539,5260,418,361,293,544,6876,1496,5451,410,379,320,540,7100,1245,359,352,306,521,2783,0.228398458998349,0.875609756097561,0.928759894459103,0.95625,0.964814814814815,0.391971830985916
E02006592,"Rudgwick, Slinfold & Barns Green",Horsham,South East,1180,3991,420,413,279,415,5518,1244,4567,410,452,316,418,6163,1057,373,423,301,400,2554,0.231442960367856,0.909756097560976,0.935840707964602,0.95253164556962,0.956937799043062,0.414408567256206
E02006593,Horsham Central,Horsham,South East,2093,7086,511,455,381,935,9368,2036,7629,511,469,416,926,9951,1696,428,439,385,879,3827,0.222309608074453,0.837573385518591,0.936034115138593,0.925480769230769,0.949244060475162,0.384584463872978
E02006594,Horsham West,Horsham,South East,2346,6380,528,422,307,445,8082,2344,6778,515,500,325,488,8606,1705,475,465,313,451,3409,0.251549129536737,0.922330097087379,0.93,0.963076923076923,0.924180327868853,0.396118986753428
E02006595,"Horsham South, Mannings Heath & Nuthurst",Horsham,South East,1721,5112,494,545,412,517,7080,1818,5507,520,581,415,583,7606,1168,475,550,401,559,3153,0.212093698928636,0.913461538461539,0.946643717728055,0.966265060240964,0.958833619210978,0.414541151722325
E02006596,Southwater,Horsham,South East,1884,5990,470,386,254,329,7429,1816,6339,495,441,291,364,7930,1688,448,425,276,350,3187,0.266288058053321,0.905050505050505,0.963718820861678,0.948453608247423,0.961538461538461,0.401891551071879
E02006597,Billingshurst,Horsham,South East,2226,6431,576,604,446,628,8685,2384,7511,605,648,475,648,9887,1571,555,614,457,618,3815,0.209159898815071,0.917355371900826,0.947530864197531,0.962105263157895,0.953703703703704,0.385860220491555
E02006598,Cowfold & Partridge Green,Horsham,South East,890,3333,354,362,258,331,4638,849,3548,392,390,269,364,4963,997,350,362,256,346,2311,0.281003382187148,0.892857142857143,0.928205128205128,0.951672862453531,0.950549450549451,0.465645778762845
E02006599,West Chiltington Common,Horsham,South East,795,3329,691,778,523,754,6075,795,3618,663,763,592,725,6361,814,630,733,576,708,3461,0.224986180210061,0.950226244343891,0.960681520314548,0.972972972972973,0.976551724137931,0.544096840119478
E02006600,"Amberley, Pulborough & Storrington",Horsham,South East,1578,5264,713,789,641,910,8317,1493,5547,717,800,626,968,8658,1344,633,759,601,945,4282,0.242293131422391,0.882845188284519,0.94875,0.960063897763578,0.976239669421488,0.494571494571495
E02006601,Henfield & Small Dole,Horsham,South East,1548,4828,563,594,508,797,7290,1478,5247,577,623,536,777,7760,1561,525,586,516,748,3936,0.297503335239184,0.909878682842288,0.940609951845907,0.962686567164179,0.962676962676963,0.507216494845361
E02006602,Ashington & Washington,Horsham,South East,1640,4734,570,576,418,495,6793,1630,5302,556,615,448,490,7411,1164,498,590,437,472,3161,0.219539796303282,0.89568345323741,0.959349593495935,0.975446428571429,0.963265306122449,0.42652813385508
E02006603,Steyning & Upper Beeding,Horsham,South East,1298,4632,641,743,549,754,7319,1363,5156,632,719,597,831,7935,1177,582,672,572,795,3798,0.228277734678045,0.920886075949367,0.934631432545202,0.958123953098827,0.956678700361011,0.478638941398866
E02006604,East Grinstead Central & North,Mid Sussex,South East,2433,8021,679,627,476,811,10614,2381,8410,673,655,539,781,11058,1833,519,589,511,738,4190,0.2179548156956,0.771173848439822,0.899236641221374,0.948051948051948,0.9449423815621,0.37891119551456
E02006605,Copthorne & Turners Hill,Mid Sussex,South East,1219,3977,322,393,250,358,5300,1171,4258,362,377,256,378,5631,797,320,352,246,363,2078,0.187177078440582,0.883977900552486,0.93368700265252,0.9609375,0.96031746031746,0.369028591724383
E02006606,East Grinstead East,Mid Sussex,South East,1709,5165,473,544,304,394,6880,1604,5231,490,510,394,405,7030,1109,417,478,368,385,2757,0.212005352705028,0.851020408163265,0.937254901960784,0.934010152284264,0.950617283950617,0.392176386913229
E02006607,East Grinstead West & South,Mid Sussex,South East,1469,4699,466,547,360,561,6633,1436,4773,477,550,420,577,6797,1027,396,512,400,555,2890,0.215168657029122,0.830188679245283,0.930909090909091,0.952380952380952,0.961871750433276,0.425187582757099
E02006608,Crawley Down,Mid Sussex,South East,1197,3526,461,495,304,368,5154,1164,3751,464,482,340,390,5427,907,419,455,320,374,2475,0.241802186083711,0.90301724137931,0.943983402489627,0.941176470588235,0.958974358974359,0.456053067993367
E02006609,"Horsted Keynes, Ardingly & Sharpthorne",Mid Sussex,South East,1285,4173,419,426,315,364,5697,1215,4420,453,416,333,413,6035,686,396,383,316,397,2178,0.155203619909502,0.874172185430464,0.920673076923077,0.948948948948949,0.961259079903148,0.36089478044739
E02006610,Balcombe & Handcross,Mid Sussex,South East,1546,4483,378,354,303,462,5980,1577,5023,395,381,324,442,6565,730,360,361,316,418,2185,0.145331475214016,0.911392405063291,0.94750656167979,0.975308641975309,0.945701357466063,0.332825590251333
E02006611,Haywards Heath North East,Mid Sussex,South East,2457,6108,647,760,565,804,8884,2456,6779,652,709,640,847,9627,1095,604,684,616,814,3813,0.161528249004278,0.92638036809816,0.964739069111425,0.9625,0.961038961038961,0.396073543159863
E02006612,Haywards Heath West,Mid Sussex,South East,2301,7607,484,532,391,738,9752,2226,7829,479,559,443,829,10139,1309,409,506,416,783,3423,0.167198875973943,0.853862212943633,0.905187835420394,0.939051918735892,0.944511459589867,0.33760725909853
E02006613,Haywards Heath East,Mid Sussex,South East,1765,4871,369,346,224,351,6161,1623,5172,352,366,253,333,6476,1086,308,342,242,313,2291,0.209976798143852,0.875,0.934426229508197,0.956521739130435,0.93993993993994,0.353767757875232
E02006614,Haywards Heath South & Cuckfield,Mid Sussex,South East,2546,7279,584,585,412,566,9426,2684,8152,558,615,452,576,10353,1558,511,584,434,551,3638,0.191118743866536,0.915770609318997,0.949593495934959,0.960176991150442,0.956597222222222,0.351395730706076
E02006615,Burgess Hill West,Mid Sussex,South East,1461,4602,315,277,166,235,5595,1413,4797,331,293,204,205,5830,898,286,281,190,195,1850,0.187200333541797,0.86404833836858,0.959044368600683,0.931372549019608,0.951219512195122,0.317324185248714
E02006616,Burgess Hill East,Mid Sussex,South East,1810,5437,452,523,330,498,7240,1974,6192,473,524,358,505,8052,1172,416,499,337,492,2916,0.189276485788114,0.879492600422833,0.952290076335878,0.941340782122905,0.974257425742574,0.362146050670641
E02006617,Burgess Hill Central,Mid Sussex,South East,1686,5823,461,484,316,552,7636,1705,6389,462,457,398,596,8302,1185,383,434,376,574,2952,0.185475035216779,0.829004329004329,0.949671772428884,0.944723618090452,0.963087248322148,0.355576969404963
E02006618,Burgess Hill South,Mid Sussex,South East,1049,3630,417,376,294,533,5250,1026,3844,404,385,331,569,5533,693,368,369,320,547,2297,0.180280957336108,0.910891089108911,0.958441558441558,0.966767371601209,0.961335676625659,0.41514549069221
E02006619,Hurstpierpoint & Bolney,Mid Sussex,South East,1919,5370,490,460,264,427,7011,1914,5690,510,471,323,427,7421,990,450,450,310,405,2605,0.173989455184534,0.882352941176471,0.955414012738854,0.959752321981424,0.94847775175644,0.351030858374882
E02006620,"Hassocks, Keymer & East Hurstpierpoint",Mid Sussex,South East,1836,5522,545,612,496,946,8121,1871,5731,565,627,518,922,8363,1002,503,595,501,883,3484,0.174838597103472,0.890265486725664,0.94896331738437,0.967181467181467,0.957700650759219,0.416596914982662
E02006621,High Salvington & Findon Valley,Worthing,South East,953,3924,669,769,550,783,6695,931,4255,654,784,595,792,7080,1201,604,757,578,761,3901,0.282256169212691,0.923547400611621,0.965561224489796,0.971428571428571,0.960858585858586,0.550988700564972
E02006622,Salvington,Worthing,South East,1405,4466,514,549,389,652,6570,1357,4826,500,574,388,598,6886,1284,409,541,368,563,3165,0.26605884790717,0.818,0.942508710801394,0.948453608247423,0.941471571906355,0.459628231193726
E02006623,Durrington North,Worthing,South East,1722,4676,475,480,337,425,6393,1626,5030,462,506,386,474,6858,1442,365,485,366,447,3105,0.286679920477137,0.79004329004329,0.958498023715415,0.948186528497409,0.943037974683544,0.452755905511811
E02006624,Broadwater West,Worthing,South East,1506,4480,390,399,260,446,5975,1358,4840,375,436,311,463,6425,1257,327,418,294,442,2738,0.259710743801653,0.872,0.958715596330275,0.945337620578778,0.954643628509719,0.426147859922179
E02006625,Broadwater East,Worthing,South East,1680,5198,326,306,219,321,6370,1601,5423,329,344,208,335,6639,1343,251,320,190,310,2414,0.247648902821317,0.762917933130699,0.930232558139535,0.913461538461539,0.925373134328358,0.363608977255611
E02006626,Northbrook,Worthing,South East,2352,5728,429,351,210,298,7016,2520,6671,411,372,241,291,7986,1609,299,350,225,274,2757,0.241193224404137,0.727493917274939,0.940860215053764,0.933609958506224,0.941580756013746,0.345229151014275
E02006627,Durrington South,Worthing,South East,1710,5443,486,596,383,611,7519,1760,6107,501,558,437,622,8225,1553,387,524,410,585,3459,0.254298346160144,0.772455089820359,0.939068100358423,0.938215102974828,0.940514469453376,0.420547112462006
E02006628,Broadwater South,Worthing,South East,1990,6077,327,315,222,356,7297,1859,6366,358,304,216,349,7593,1634,276,266,197,319,2692,0.256676091737355,0.770949720670391,0.875,0.912037037037037,0.91404011461318,0.35453707362044
E02006629,East Worthing,Worthing,South East,1583,4911,380,388,271,453,6403,1484,5271,372,418,273,452,6786,1321,248,375,251,416,2611,0.250616581293872,0.666666666666667,0.897129186602871,0.919413919413919,0.920353982300885,0.384762746831712
E02006630,Heene,Worthing,South East,1060,5249,450,562,420,1012,7693,1097,5344,467,558,466,1024,7859,1473,329,502,431,950,3685,0.27563622754491,0.704496788008565,0.899641577060932,0.924892703862661,0.927734375,0.468889171650337
E02006631,Worthing Central,Worthing,South East,1433,7015,383,465,314,678,8855,1393,7285,408,441,361,696,9191,1702,271,390,326,654,3343,0.23363074811256,0.66421568627451,0.884353741496599,0.903047091412742,0.939655172413793,0.363725383527364
E02006632,West Worthing,Worthing,South East,1265,4713,492,629,407,802,7043,1188,4912,521,614,466,797,7310,1400,404,573,438,752,3567,0.285016286644951,0.775431861804223,0.933224755700326,0.939914163090129,0.943538268506901,0.48796169630643
E02006633,Goring-by-Sea,Worthing,South East,1013,4054,614,864,592,945,7069,1110,4425,626,798,621,953,7423,1197,533,763,592,919,4004,0.270508474576271,0.851437699680511,0.956140350877193,0.953301127214171,0.964323189926548,0.539404553415061
E02002985,Keynsham North,Bath and North East Somerset,South West,1134,3861,282,383,252,497,5275,1255,4052,313,365,272,531,5533,965,272,347,259,485,2328,0.238153998025666,0.869009584664537,0.950684931506849,0.952205882352941,0.913370998116761,0.420748237845653
E02002986,Keynsham South,Bath and North East Somerset,South West,1294,3710,280,349,254,418,5011,1391,4278,300,342,288,435,5643,1062,259,330,274,423,2348,0.248246844319776,0.863333333333333,0.964912280701754,0.951388888888889,0.972413793103448,0.416090731880206
E02002987,Keynsham East,Bath and North East Somerset,South West,940,3147,343,450,249,518,4707,907,3388,325,458,328,482,4981,767,286,443,323,463,2282,0.226387249114522,0.88,0.967248908296943,0.984756097560976,0.960580912863071,0.458140935555109
E02002988,Lambridge & Fairfield Park,Bath and North East Somerset,South West,1074,3397,290,321,215,400,4623,1024,3657,302,328,224,402,4913,627,261,306,210,378,1782,0.171452009844135,0.864238410596026,0.932926829268293,0.9375,0.940298507462687,0.362711174435172
E02002989,Weston,Bath and North East Somerset,South West,1134,3364,252,282,206,503,4607,1125,3698,262,263,234,484,4941,988,238,238,220,457,2141,0.267171444023797,0.908396946564885,0.904942965779468,0.94017094017094,0.944214876033058,0.43331309451528
E02002990,Walcot,Bath and North East Somerset,South West,863,4327,287,281,166,174,5235,905,4785,290,257,179,200,5711,696,226,242,168,187,1519,0.145454545454545,0.779310344827586,0.941634241245136,0.93854748603352,0.935,0.265977937313956
E02002991,Central Bath & Lansdown,Bath and North East Somerset,South West,1228,8079,500,529,345,637,10090,1379,8927,569,596,403,675,11170,1178,458,505,363,617,3121,0.131959224823569,0.804920913884007,0.847315436241611,0.900744416873449,0.914074074074074,0.279409131602507
E02002992,Newbridge,Bath and North East Somerset,South West,1087,3762,294,284,197,356,4893,1000,3989,290,316,219,362,5176,966,266,296,210,337,2075,0.242165956380045,0.917241379310345,0.936708860759494,0.958904109589041,0.930939226519337,0.400888717156105
E02002993,Kingsmead,Bath and North East Somerset,South West,572,5359,243,195,110,218,6125,568,5636,242,209,149,229,6465,710,201,178,122,202,1413,0.12597586941093,0.830578512396694,0.851674641148325,0.818791946308725,0.882096069868996,0.218561484918794
E02002994,Bathavon North & South,Bath and North East Somerset,South West,1955,5996,642,663,506,783,8590,1930,6756,692,706,507,821,9482,1136,608,658,493,780,3675,0.168146832445234,0.878612716763006,0.932011331444759,0.972386587771203,0.950060901339829,0.387576460662308
E02002995,Twerton,Bath and North East Somerset,South West,1201,3926,165,180,143,167,4581,1145,4272,202,193,148,202,5017,995,169,181,142,188,1675,0.232911985018727,0.836633663366337,0.937823834196891,0.959459459459459,0.930693069306931,0.333864859477776
E02002996,"Widcombe, Bathwick Hill & Claverton Down",Bath and North East Somerset,South West,1208,10516,456,417,326,446,12161,1234,12406,467,480,339,540,14232,968,396,434,319,500,2617,0.0780267612445591,0.84796573875803,0.904166666666667,0.941002949852507,0.925925925925926,0.183881394041596
E02002997,Oldfield Park West,Bath and North East Somerset,South West,726,6239,217,221,165,239,7081,769,6086,242,224,186,239,6977,868,204,208,172,214,1666,0.142622412093329,0.84297520661157,0.928571428571429,0.924731182795699,0.895397489539749,0.23878457789881
E02002998,Oldfield Park East,Bath and North East Somerset,South West,826,4285,188,192,155,273,5093,753,4150,199,203,138,277,4967,790,170,184,129,255,1528,0.190361445783133,0.85427135678392,0.906403940886699,0.934782608695652,0.92057761732852,0.307630360378498
E02002999,Southdown,Bath and North East Somerset,South West,1004,3456,277,310,197,333,4573,1022,3898,288,315,214,298,5013,878,266,288,203,280,1915,0.2252437147255,0.923611111111111,0.914285714285714,0.948598130841122,0.939597315436242,0.382006782365849
E02003000,"Saltford, Farmborough & Timsbury",Bath and North East Somerset,South West,1612,5367,722,690,550,718,8047,1547,5601,735,759,613,752,8460,1245,669,728,600,736,3978,0.222281735404392,0.910204081632653,0.959156785243742,0.978792822185971,0.978723404255319,0.470212765957447
E02003001,Bloomfield,Bath and North East Somerset,South West,1002,3365,308,287,204,395,4559,1006,3688,346,305,209,374,4922,705,300,292,199,347,1843,0.191160520607375,0.867052023121387,0.957377049180328,0.952153110047847,0.927807486631016,0.374441284030882
E02003002,Combe Down,Bath and North East Somerset,South West,1265,3547,318,273,207,327,4672,1399,4113,318,308,244,340,5323,814,275,288,226,317,1920,0.197909068806224,0.864779874213837,0.935064935064935,0.926229508196721,0.932352941176471,0.360698854029683
E02003003,Odd Down,Bath and North East Somerset,South West,1136,3885,243,260,186,330,4904,1084,4258,259,261,207,308,5293,945,236,242,190,285,1898,0.221935180836073,0.911196911196911,0.9272030651341,0.917874396135266,0.925324675324675,0.358586812771585
E02003004,"Pensford, Clutton & Temple Cloud",Bath and North East Somerset,South West,1210,4101,413,447,242,368,5571,1333,4565,423,439,309,422,6158,835,387,420,298,405,2345,0.182913472070099,0.914893617021277,0.956719817767654,0.964401294498382,0.959715639810426,0.380805456316986
E02003005,"Chew, Bishop Sutton & East Harptree",Bath and North East Somerset,South West,1205,3713,421,465,331,367,5297,1248,4023,410,483,374,434,5724,765,375,459,369,430,2398,0.190156599552573,0.914634146341463,0.950310559006211,0.986631016042781,0.990783410138249,0.418937805730259
E02003006,Peasedown & Bathavon West,Bath and North East Somerset,South West,1733,6352,457,443,345,435,8032,1617,6734,496,465,380,434,8509,1223,463,437,366,415,2904,0.181615681615682,0.933467741935484,0.939784946236559,0.963157894736842,0.956221198156682,0.341285697496768
E02003007,High Littleton & Paulton,Bath and North East Somerset,South West,1895,5529,519,526,333,488,7395,1880,5714,551,568,393,576,7802,1178,519,542,381,560,3180,0.206160308015401,0.941923774954628,0.954225352112676,0.969465648854962,0.972222222222222,0.407587798000513
E02003008,Radstock,Bath and North East Somerset,South West,1333,3829,287,250,179,273,4818,1318,3919,294,258,188,258,4917,771,278,246,184,248,1727,0.196733860678745,0.945578231292517,0.953488372093023,0.978723404255319,0.961240310077519,0.351230425055928
E02003009,Midsomer Norton North,Bath and North East Somerset,South West,1142,3773,328,322,252,421,5096,1110,3911,312,344,276,410,5253,753,290,328,267,398,2036,0.192533878803375,0.92948717948718,0.953488372093023,0.967391304347826,0.970731707317073,0.387588044926709
E02003010,Westfield,Bath and North East Somerset,South West,1439,4226,345,276,202,281,5330,1327,4177,359,318,216,305,5375,854,329,305,211,290,1989,0.204452956667465,0.916434540389972,0.959119496855346,0.976851851851852,0.950819672131147,0.370046511627907
E02003011,Midsomer Norton Redfield,Bath and North East Somerset,South West,1132,3139,308,401,306,412,4566,1110,3456,325,389,333,434,4937,740,302,375,327,420,2164,0.21412037037037,0.929230769230769,0.96401028277635,0.981981981981982,0.967741935483871,0.438322868138546
E02003012,Henbury & Brentry,"Bristol, City of",South West,2545,7007,519,560,330,512,8928,2768,8525,543,556,362,484,10470,1330,443,497,336,463,3069,0.156011730205279,0.815837937384899,0.893884892086331,0.92817679558011,0.956611570247934,0.293123209169054
E02003013,Southmead,"Bristol, City of",South West,2678,7450,485,485,379,501,9300,2843,9453,518,506,372,530,11379,1786,439,445,336,489,3495,0.188934729715434,0.847490347490347,0.879446640316206,0.903225806451613,0.922641509433962,0.307144740311099
E02003014,Lawrence Weston,"Bristol, City of",South West,2204,5051,304,264,181,292,6092,2275,6039,316,317,175,269,7116,736,216,285,162,248,1647,0.12187448253022,0.683544303797468,0.899053627760252,0.925714285714286,0.921933085501859,0.231450252951096
E02003015,Monks Park,"Bristol, City of",South West,1343,4360,275,265,160,290,5350,1344,5172,295,264,196,274,6201,985,244,244,183,260,1916,0.190448569218871,0.827118644067797,0.924242424242424,0.933673469387755,0.948905109489051,0.308982422189969
E02003016,Upper Horfield,"Bristol, City of",South West,1480,5936,241,196,144,219,6736,1521,6280,255,227,147,205,7114,895,192,204,133,194,1618,0.142515923566879,0.752941176470588,0.898678414096916,0.904761904761905,0.946341463414634,0.227438852965983
E02003017,Westbury Village,"Bristol, City of",South West,1192,3348,316,397,267,560,4888,1223,3950,338,407,306,567,5568,778,304,374,294,546,2296,0.196962025316456,0.899408284023669,0.918918918918919,0.96078431372549,0.962962962962963,0.412356321839081
E02003018,Sea Mills,"Bristol, City of",South West,1267,3512,335,312,206,278,4643,1378,4275,363,352,238,261,5489,800,308,321,229,246,1904,0.187134502923977,0.848484848484848,0.911931818181818,0.96218487394958,0.942528735632184,0.346875569320459
E02003019,Shirehampton & Avonmouth,"Bristol, City of",South West,1933,6261,464,428,319,463,7935,2015,7583,492,503,327,477,9382,1031,371,451,307,464,2624,0.135962020308585,0.754065040650406,0.89662027833002,0.938837920489297,0.972746331236897,0.279684502238329
E02003020,Westbury on Trym,"Bristol, City of",South West,1378,3416,360,386,292,678,5132,1479,3823,347,415,328,668,5581,801,311,403,311,635,2461,0.209521318336385,0.896253602305476,0.971084337349398,0.948170731707317,0.95059880239521,0.440960401361763
E02003021,Horfield,"Bristol, City of",South West,1329,5433,191,217,110,274,6225,1318,5853,199,209,147,240,6648,817,172,192,139,230,1550,0.139586536818725,0.864321608040201,0.91866028708134,0.945578231292517,0.958333333333333,0.233152827918171
E02003022,Henleaze,"Bristol, City of",South West,1340,3172,325,349,238,479,4563,1379,3803,365,367,272,461,5268,900,347,355,263,446,2311,0.236655272153563,0.950684931506849,0.967302452316076,0.966911764705882,0.967462039045553,0.438686408504176
E02003023,Stapleton,"Bristol, City of",South West,1076,4384,326,294,216,368,5588,1093,4977,336,332,234,346,6225,1102,292,309,217,329,2249,0.221418525215994,0.869047619047619,0.930722891566265,0.927350427350427,0.950867052023121,0.361285140562249
E02003024,Fishponds North,"Bristol, City of",South West,1811,6329,374,360,259,567,7889,1851,7305,404,398,255,543,8905,1439,327,362,242,505,2875,0.196988364134155,0.80940594059406,0.909547738693467,0.949019607843137,0.930018416206261,0.3228523301516
E02003025,Lockleaze,"Bristol, City of",South West,1790,4782,263,232,208,326,5811,1704,5793,292,242,217,344,6888,821,199,216,196,310,1742,0.141722768858968,0.681506849315069,0.892561983471074,0.903225806451613,0.901162790697675,0.252903600464576
E02003026,Stoke Bishop,"Bristol, City of",South West,1316,5891,535,514,385,694,8019,1480,7877,565,535,400,703,10080,1199,503,492,378,673,3245,0.152215310397359,0.890265486725664,0.919626168224299,0.945,0.957325746799431,0.321924603174603
E02003027,Bishopston,"Bristol, City of",South West,2453,9107,419,322,197,245,10290,2483,10427,474,373,196,268,11738,1605,422,341,179,250,2797,0.153927304114319,0.890295358649789,0.914209115281501,0.913265306122449,0.932835820895522,0.238285909013461
E02003028,Westbury Park,"Bristol, City of",South West,1641,5649,351,309,204,377,6890,1682,6363,351,379,241,391,7725,1286,307,339,224,372,2528,0.202105924878202,0.874643874643875,0.894459102902375,0.929460580912863,0.951406649616368,0.327249190938511
E02003029,Fishponds South,"Bristol, City of",South West,1580,4028,213,198,139,215,4793,1555,4945,269,223,156,230,5823,953,225,209,145,209,1741,0.192719919110212,0.836431226765799,0.937219730941704,0.92948717948718,0.908695652173913,0.298986776575648
E02003030,Eastville,"Bristol, City of",South West,1452,5493,296,198,168,184,6339,1498,6530,326,239,194,186,7475,1029,243,212,178,164,1826,0.157580398162328,0.745398773006135,0.887029288702929,0.917525773195876,0.881720430107527,0.24428093645485
E02003031,Redland & St Andrew's,"Bristol, City of",South West,1784,7952,348,248,140,177,8865,1644,8591,419,296,155,146,9607,1452,375,272,135,130,2364,0.169014084507042,0.894988066825776,0.918918918918919,0.870967741935484,0.89041095890411,0.246070573540127
E02003032,Speedwell,"Bristol, City of",South West,1795,5327,271,265,179,290,6332,1813,6160,349,277,191,283,7260,1071,291,241,177,261,2041,0.173863636363636,0.833810888252149,0.870036101083033,0.926701570680628,0.92226148409894,0.281129476584022
E02003033,Cotham,"Bristol, City of",South West,757,7474,209,227,139,167,8216,777,7410,260,236,157,168,8231,1263,221,217,146,153,2000,0.170445344129555,0.85,0.919491525423729,0.929936305732484,0.910714285714286,0.242983841574535
E02003034,St Paul's,"Bristol, City of",South West,2403,10253,293,185,151,181,11063,2352,12971,375,248,163,211,13968,1435,215,183,116,141,2090,0.110631408526713,0.573333333333333,0.737903225806452,0.711656441717791,0.66824644549763,0.149627720504009
E02003036,Kingsdown & Stokes Croft,"Bristol, City of",South West,851,8828,200,158,82,187,9455,818,9033,230,181,93,132,9669,1142,181,162,85,119,1689,0.126425329347946,0.786956521739131,0.895027624309392,0.913978494623656,0.901515151515152,0.174681973316786
E02003037,Clifton East,"Bristol, City of",South West,721,7506,250,182,135,219,8292,796,8403,267,235,158,191,9254,1319,219,203,134,177,2052,0.156967749613233,0.820224719101124,0.863829787234043,0.848101265822785,0.926701570680628,0.221741949427275
E02003038,Two Mile Hill,"Bristol, City of",South West,1258,4314,235,259,167,279,5254,1376,5083,243,266,204,280,6076,920,191,242,191,264,1808,0.180995475113122,0.786008230452675,0.909774436090226,0.936274509803922,0.942857142857143,0.297564186965109
E02003039,St George,"Bristol, City of",South West,1711,5884,327,280,256,292,7039,1711,6669,341,322,244,332,7908,1140,265,289,221,298,2213,0.170940170940171,0.777126099706745,0.897515527950311,0.905737704918033,0.897590361445783,0.279843196762772
E02003040,Redfield,"Bristol, City of",South West,1636,7239,238,226,178,371,8252,1594,8299,260,265,200,342,9366,1324,203,234,183,325,2269,0.159537293649837,0.780769230769231,0.883018867924528,0.915,0.950292397660819,0.242259235532778
E02003041,Clifton Village,"Bristol, City of",South West,625,4602,252,268,166,239,5527,733,5524,264,305,206,251,6550,934,220,275,191,236,1856,0.16908037653874,0.833333333333333,0.901639344262295,0.927184466019417,0.940239043824701,0.283358778625954
E02003043,Bristol City Centre,"Bristol, City of",South West,835,17362,195,269,140,148,18114,938,18503,253,243,176,140,19315,1525,188,210,155,124,2202,0.0824190671782954,0.743083003952569,0.864197530864198,0.880681818181818,0.885714285714286,0.114004659590991
E02003044,Crews Hole,"Bristol, City of",South West,1097,3673,258,274,217,254,4676,1052,4308,253,284,253,287,5385,766,217,268,238,277,1766,0.177808727948004,0.857707509881423,0.943661971830986,0.940711462450593,0.965156794425087,0.32794800371402
E02003045,Hotwells,"Bristol, City of",South West,586,6054,265,259,130,133,6841,631,5928,244,277,148,134,6731,931,216,243,130,128,1648,0.157051282051282,0.885245901639344,0.877256317689531,0.878378378378378,0.955223880597015,0.244837319863319
E02003046,St Annes,"Bristol, City of",South West,1851,6896,315,317,173,286,7987,1932,7751,356,324,209,280,8920,1196,298,296,193,257,2240,0.154302670623145,0.837078651685393,0.91358024691358,0.923444976076555,0.917857142857143,0.251121076233184
E02003047,Southville,"Bristol, City of",South West,1824,8096,332,278,187,384,9277,1877,8915,393,299,212,305,10124,1740,348,278,197,282,2845,0.195176668536175,0.885496183206107,0.929765886287625,0.929245283018868,0.924590163934426,0.281015408929277
E02003048,Totterdown,"Bristol, City of",South West,1119,5426,194,134,113,116,5983,1061,5516,214,151,119,113,6113,815,183,136,110,104,1348,0.147751994198695,0.855140186915888,0.900662251655629,0.92436974789916,0.920353982300885,0.220513659414363
E02003049,Broom Hill,"Bristol, City of",South West,1515,4765,337,398,257,346,6103,1603,5472,360,370,285,339,6826,900,303,338,272,329,2142,0.164473684210526,0.841666666666667,0.913513513513514,0.954385964912281,0.970501474926254,0.313800175798418
E02003050,Bedminster,"Bristol, City of",South West,1155,7701,282,250,197,364,8794,1284,8555,305,281,204,352,9697,1538,254,259,187,332,2570,0.179777907656341,0.832786885245902,0.921708185053381,0.916666666666667,0.943181818181818,0.265030421779932
E02003051,Windmill Hill,"Bristol, City of",South West,1642,5205,171,178,95,124,5773,1648,5861,211,185,117,142,6516,1101,170,169,108,133,1681,0.187851902405733,0.805687203791469,0.913513513513514,0.923076923076923,0.936619718309859,0.257980356046654
E02003052,Ashton,"Bristol, City of",South West,1251,4605,256,256,201,274,5592,1327,5078,285,311,210,277,6161,1151,265,294,203,265,2178,0.226664040961008,0.929824561403509,0.945337620578778,0.966666666666667,0.956678700361011,0.353514039928583
E02003053,Knowle Park,"Bristol, City of",South West,1631,5261,386,325,221,371,6564,1663,5938,392,359,219,353,7261,1036,353,327,203,328,2247,0.174469518356349,0.900510204081633,0.910863509749304,0.926940639269406,0.929178470254957,0.309461506679521
E02003054,Brislington,"Bristol, City of",South West,1266,4324,283,293,178,232,5310,1286,4837,320,305,196,303,5961,910,272,292,183,291,1948,0.188133140376266,0.85,0.957377049180328,0.933673469387755,0.96039603960396,0.326790806911592
E02003055,Knowle,"Bristol, City of",South West,2197,5247,302,259,161,252,6221,2364,6438,326,285,200,247,7496,1327,281,263,185,228,2284,0.206119913016465,0.861963190184049,0.92280701754386,0.925,0.923076923076923,0.304695837780149
E02003056,Knowle West,"Bristol, City of",South West,1942,4602,321,267,176,228,5594,1959,5465,338,303,182,235,6523,1249,279,277,164,218,2187,0.228545288197621,0.825443786982249,0.914191419141914,0.901098901098901,0.927659574468085,0.335275180131841
E02003057,Bishopsworth,"Bristol, City of",South West,1113,3678,270,327,187,357,4819,1199,4184,295,331,209,368,5387,892,273,313,206,360,2044,0.213193116634799,0.925423728813559,0.945619335347432,0.985645933014354,0.978260869565217,0.379431965843698
E02003058,Hengrove,"Bristol, City of",South West,1898,5466,434,429,312,512,7153,2014,6058,489,464,374,494,7879,1235,427,437,349,460,2908,0.203862660944206,0.87321063394683,0.941810344827586,0.933155080213904,0.931174089068826,0.369082370859246
E02003059,Headley Park,"Bristol, City of",South West,1394,3707,285,202,176,380,4750,1446,4383,328,235,203,347,5496,843,295,230,199,328,1895,0.19233401779603,0.899390243902439,0.978723404255319,0.980295566502463,0.945244956772334,0.344796215429403
E02003060,Stockwood,"Bristol, City of",South West,1948,6257,556,528,502,768,8611,2062,7293,609,588,542,804,9836,1367,491,557,519,776,3710,0.187440010969423,0.80623973727422,0.947278911564626,0.957564575645756,0.965174129353234,0.377185847905653
E02003061,Highridge,"Bristol, City of",South West,1590,3564,264,202,165,269,4464,1630,4257,275,233,171,256,5192,800,236,208,160,246,1650,0.187925769321118,0.858181818181818,0.892703862660944,0.935672514619883,0.9609375,0.317796610169492
E02003062,Withywood,"Bristol, City of",South West,1466,3526,231,174,155,337,4423,1514,4192,241,200,154,285,5072,807,213,186,141,273,1620,0.192509541984733,0.883817427385892,0.93,0.915584415584416,0.957894736842105,0.319400630914827
E02003063,Whitchurch Park,"Bristol, City of",South West,1172,3914,419,475,368,459,5635,1250,4386,485,481,371,504,6227,922,449,467,367,480,2685,0.210214318285454,0.925773195876289,0.970893970893971,0.98921832884097,0.952380952380952,0.431186767303678
E02003064,Hartcliffe,"Bristol, City of",South West,2091,4227,209,158,158,290,5042,2112,4960,262,180,126,281,5809,865,224,162,114,257,1622,0.174395161290323,0.854961832061069,0.9,0.904761904761905,0.914590747330961,0.279221897056292
E02006887,Temple Meads,"Bristol, City of",South West,1316,7944,153,122,78,100,8397,1380,8980,171,122,86,82,9441,755,106,94,73,59,1087,0.084075723830735,0.619883040935673,0.770491803278689,0.848837209302326,0.719512195121951,0.115136108463087
E02006888,Upper Easton,"Bristol, City of",South West,1912,4759,177,118,81,195,5330,1927,6598,202,144,84,178,7206,631,114,101,56,135,1037,0.0956350409214914,0.564356435643564,0.701388888888889,0.666666666666667,0.758426966292135,0.14390785456564
E02006889,Barton Hill,"Bristol, City of",South West,2678,4836,212,139,136,201,5524,2627,6591,213,157,142,189,7292,651,126,113,107,138,1135,0.0987710514337733,0.591549295774648,0.719745222929936,0.753521126760563,0.73015873015873,0.155650027427318
E02006890,Lower Easton,"Bristol, City of",South West,1945,6166,225,157,155,208,6911,1950,8336,269,182,133,211,9131,989,181,142,101,163,1576,0.118642034548944,0.672862453531598,0.78021978021978,0.759398496240602,0.772511848341232,0.172598839119483
E02003065,Portishead Central,North Somerset,South West,1663,5798,568,650,499,708,8223,1712,6279,562,639,505,696,8681,938,491,607,483,676,3195,0.149386845039019,0.873665480427046,0.949921752738654,0.956435643564356,0.971264367816092,0.368045156088008
E02003066,Portishead Redcliffe,North Somerset,South West,1011,3344,474,550,368,428,5164,996,3661,434,530,427,474,5526,675,391,507,421,463,2457,0.184375853591915,0.900921658986175,0.956603773584906,0.985948477751757,0.976793248945148,0.444625407166124
E02003067,Portishead South,North Somerset,South West,1818,4554,400,429,303,434,6120,1889,5173,397,489,342,502,6903,780,370,466,329,485,2430,0.150782911270056,0.931989924433249,0.952965235173824,0.961988304093567,0.966135458167331,0.352020860495437
E02003068,Pill & Easton,North Somerset,South West,1040,3656,383,436,349,425,5249,1078,4124,367,452,374,467,5784,734,331,436,365,461,2327,0.177982541222114,0.901907356948229,0.964601769911504,0.975935828877005,0.987152034261242,0.40231673582296
E02003069,Clevedon North & Walton,North Somerset,South West,812,2979,419,463,313,625,4799,827,3183,384,472,342,609,4990,730,341,452,325,592,2440,0.229343386742067,0.888020833333333,0.957627118644068,0.950292397660819,0.972085385878489,0.488977955911824
E02003070,Long Ashton & Gordano,North Somerset,South West,3035,7629,764,778,607,818,10596,2804,8002,725,824,608,872,11031,1552,661,786,591,849,4439,0.19395151212197,0.911724137931034,0.953883495145631,0.97203947368421,0.973623853211009,0.402411386093736
E02003071,Clevedon Central,North Somerset,South West,1332,4585,535,516,375,760,6771,1374,4918,534,510,432,786,7180,1038,465,471,407,760,3141,0.211061407076047,0.870786516853933,0.923529411764706,0.94212962962963,0.966921119592875,0.437465181058496
E02003072,Nailsea West,North Somerset,South West,1412,4894,586,772,552,909,7713,1420,5361,602,737,619,978,8297,1285,546,723,611,958,4123,0.239694086924081,0.906976744186047,0.981004070556309,0.987075928917609,0.979550102249489,0.496926599975895
E02003073,Nailsea East,North Somerset,South West,1043,3637,440,582,324,395,5378,993,3870,466,529,417,423,5705,918,432,518,409,417,2694,0.237209302325581,0.927038626609442,0.979206049149338,0.980815347721822,0.985815602836879,0.472217353198948
E02003074,Clevedon South & Yeo,North Somerset,South West,1414,4714,456,444,283,417,6314,1338,4887,511,460,321,453,6632,998,464,444,315,437,2658,0.204215264988746,0.908023483365949,0.965217391304348,0.981308411214953,0.964679911699779,0.400784077201448
E02003075,Backwell & Flax Bourton,North Somerset,South West,1267,3390,337,399,301,355,4782,1255,3724,351,364,323,413,5175,791,320,354,317,405,2187,0.212406015037594,0.911680911680912,0.972527472527472,0.981424148606811,0.980629539951574,0.422608695652174
E02003076,Yatton & Cleeve,North Somerset,South West,1777,5385,621,611,472,568,7657,1767,5949,598,657,478,612,8294,1405,558,625,465,594,3647,0.236174146915448,0.933110367892977,0.951293759512938,0.972803347280335,0.970588235294118,0.439715456956836
E02003077,"Wrington, Felton & Dundry",North Somerset,South West,1091,3570,371,412,325,413,5091,1135,3989,421,380,376,420,5586,820,381,364,364,406,2335,0.205565304587616,0.904988123515439,0.957894736842105,0.968085106382979,0.966666666666667,0.418009308986753
E02003078,Congresbury & Kewstoke,North Somerset,South West,1241,4054,508,609,357,426,5954,1238,4416,525,602,428,446,6417,1147,487,562,405,434,3035,0.25973731884058,0.927619047619048,0.933554817275748,0.946261682242991,0.973094170403587,0.472962443509428
E02003079,North Worle,North Somerset,South West,1847,5749,525,519,326,373,7492,1847,6084,543,569,358,375,7929,1560,504,527,343,365,3299,0.256410256410256,0.92817679558011,0.926186291739895,0.958100558659218,0.973333333333333,0.416067599949552
E02003080,Mid Worle,North Somerset,South West,1498,4579,577,761,569,766,7252,1412,5000,553,726,600,797,7676,1418,507,692,579,770,3966,0.2836,0.916817359855335,0.953168044077135,0.965,0.96612296110414,0.516675351745701
E02003081,Weston Milton,North Somerset,South West,1517,5242,617,779,572,736,7946,1520,5652,615,756,587,747,8357,1515,576,729,567,721,4108,0.268046709129512,0.936585365853659,0.964285714285714,0.965928449744463,0.965194109772423,0.491563958358263
E02003082,Weston Hillside,North Somerset,South West,980,5686,566,655,433,909,8249,973,5926,556,648,492,859,8481,1305,478,587,466,809,3645,0.220215997300034,0.859712230215827,0.905864197530864,0.947154471544715,0.941792782305006,0.429784223558543
E02003084,Weston Town,North Somerset,South West,1680,6849,516,565,312,721,8963,1761,7852,521,530,366,675,9944,1484,418,481,332,625,3340,0.188996434029547,0.802303262955854,0.907547169811321,0.907103825136612,0.925925925925926,0.335880933226066
E02003085,Weston Bournville,North Somerset,South West,1874,4946,349,291,189,281,6056,1993,5754,375,318,200,251,6898,980,292,280,172,227,1951,0.170316301703163,0.778666666666667,0.880503144654088,0.86,0.904382470119522,0.28283560452305
E02003086,Weston Clarence,North Somerset,South West,788,3600,405,408,278,699,5390,812,3967,393,427,321,685,5793,843,345,392,303,655,2538,0.212503150995715,0.877862595419847,0.918032786885246,0.94392523364486,0.956204379562044,0.438114966338685
E02003087,"Hutton, Locking & Banwell",North Somerset,South West,1715,5555,749,894,605,702,8505,1775,6202,736,875,668,728,9209,1554,684,842,646,703,4429,0.250564334085779,0.929347826086957,0.962285714285714,0.967065868263473,0.965659340659341,0.480942556195027
E02003088,"Winscombe, Langford & Blagdon",North Somerset,South West,1366,4493,635,677,517,756,7078,1484,5189,630,677,586,805,7887,1156,583,662,566,785,3752,0.222778955482752,0.925396825396825,0.977843426883309,0.965870307167236,0.975155279503106,0.475719538481045
E02003089,Weston Uphill,North Somerset,South West,1087,3253,349,472,349,433,4856,1103,3652,372,426,371,442,5263,848,317,404,360,423,2352,0.232201533406353,0.852150537634409,0.948356807511737,0.970350404312669,0.957013574660633,0.446893406802204
E02006845,"South Worle, West Wick & St Georges",North Somerset,South West,2258,6096,449,422,250,422,7639,2255,6163,465,393,294,385,7700,1474,421,369,278,369,2911,0.239169235761804,0.905376344086022,0.938931297709924,0.945578231292517,0.958441558441558,0.378051948051948
E02006846,Weston Winterstoke,North Somerset,South West,2553,6055,219,185,103,134,6696,2554,6623,257,206,119,116,7321,1411,224,185,114,112,2046,0.213045447682319,0.8715953307393,0.898058252427185,0.957983193277311,0.96551724137931,0.279470017757137
E02003090,Thornbury North,South Gloucestershire,South West,1557,4682,478,517,388,540,6605,1790,5635,477,502,499,580,7693,1075,432,490,485,565,3047,0.190771960958296,0.905660377358491,0.97609561752988,0.971943887775551,0.974137931034483,0.396074353308202
E02003091,Thornbury South,South Gloucestershire,South West,1151,3791,393,474,361,488,5507,1140,4176,400,452,356,496,5880,868,354,436,337,485,2480,0.207854406130268,0.885,0.964601769911504,0.946629213483146,0.977822580645161,0.421768707482993
E02003092,"Charfield, Wickwar & Iron Acton",South Gloucestershire,South West,1437,5248,463,436,303,333,6783,1492,5756,459,468,331,368,7382,1114,403,446,322,358,2643,0.193537178596247,0.877995642701525,0.952991452991453,0.972809667673716,0.972826086956522,0.35803305337307
E02003093,"Alveston, Olveston & Oldbury",South Gloucestershire,South West,965,3476,449,504,444,623,5496,998,3875,434,505,478,646,5938,795,393,482,472,628,2770,0.205161290322581,0.905529953917051,0.954455445544554,0.98744769874477,0.972136222910217,0.466487032670933
E02003094,"Almondsbury, Pilning & Severn Beach",South Gloucestershire,South West,1820,5354,469,484,359,448,7114,1695,5913,520,483,383,491,7790,1091,460,460,371,466,2848,0.184508709622865,0.884615384615385,0.952380952380952,0.968668407310705,0.94908350305499,0.365596919127086
E02003095,Yate North,South Gloucestershire,South West,1346,4736,427,436,268,323,6190,1477,5428,430,460,325,385,7028,1132,395,441,321,374,2663,0.208548268238762,0.918604651162791,0.958695652173913,0.987692307692308,0.971428571428571,0.378912919749573
E02003096,Yate West,South Gloucestershire,South West,1134,4022,285,350,246,257,5160,1141,4304,317,328,249,346,5544,902,285,311,241,339,2078,0.20957249070632,0.899053627760252,0.948170731707317,0.967871485943775,0.979768786127168,0.374819624819625
E02003097,Chipping Sodbury,South Gloucestershire,South West,1029,3468,428,511,443,564,5414,1027,3794,406,511,442,601,5754,833,364,484,431,588,2700,0.219557195571956,0.896551724137931,0.947162426614481,0.975113122171946,0.978369384359401,0.469238790406674
E02003098,Bradley Stoke North East,South Gloucestershire,South West,2181,7231,375,235,150,134,8125,2109,7681,341,244,169,163,8598,1089,302,222,158,161,1932,0.141778414268975,0.885630498533724,0.909836065573771,0.93491124260355,0.987730061349693,0.22470341939986
E02003099,Yate Kingsgate,South Gloucestershire,South West,1464,4326,388,424,379,485,6002,1478,4920,400,437,384,525,6666,1103,358,414,372,505,2752,0.224186991869919,0.895,0.947368421052632,0.96875,0.961904761904762,0.412841284128413
E02003100,Patchway,South Gloucestershire,South West,2941,8991,505,595,445,600,11136,3367,10468,577,569,477,659,12750,1593,500,519,462,633,3707,0.152178066488345,0.866551126516464,0.912126537785589,0.968553459119497,0.960546282245827,0.290745098039216
E02003101,Bradley Stoke Central,South Gloucestershire,South West,2394,7918,302,247,188,238,8893,2340,8245,351,271,226,233,9326,1186,324,248,213,228,2199,0.143844754396604,0.923076923076923,0.915129151291513,0.942477876106195,0.978540772532189,0.235792408320824
E02003102,Frampton Cotterell,South Gloucestershire,South West,1491,3982,354,411,331,452,5530,1427,4496,355,410,385,460,6106,941,324,399,374,450,2488,0.209297153024911,0.912676056338028,0.973170731707317,0.971428571428571,0.978260869565217,0.407468064199148
E02003103,Yate South,South Gloucestershire,South West,1658,4654,310,327,185,137,5613,1522,4923,295,349,210,180,5957,981,254,330,195,170,1930,0.19926873857404,0.861016949152542,0.945558739255014,0.928571428571429,0.944444444444444,0.32398858485815
E02003104,Stoke Gifford,South Gloucestershire,South West,1360,4819,463,360,274,324,6240,1358,5110,441,408,299,323,6581,913,415,388,288,318,2322,0.17866927592955,0.941043083900227,0.950980392156863,0.963210702341137,0.984520123839009,0.352833915818265
E02003105,Winterbourne,South Gloucestershire,South West,1129,3523,322,400,393,585,5223,1135,4005,344,379,366,608,5702,876,315,366,353,586,2496,0.2187265917603,0.915697674418605,0.965699208443272,0.96448087431694,0.963815789473684,0.437741143458436
E02003106,Frenchay & Great Stoke,South Gloucestershire,South West,2420,12018,350,370,273,502,13513,2522,15228,363,383,319,530,16823,1523,329,354,295,509,3010,0.100013133701077,0.90633608815427,0.924281984334204,0.924764890282132,0.960377358490566,0.178921714319681
E02003107,Filton,South Gloucestershire,South West,1724,7750,408,497,366,583,9604,1691,8560,414,482,383,555,10394,1164,360,452,364,529,2869,0.135981308411215,0.869565217391304,0.937759336099585,0.950391644908616,0.953153153153153,0.276024629593997
E02003108,Pucklechurch & Westerleigh,South Gloucestershire,South West,2061,6951,597,573,455,612,9188,2334,7606,591,615,474,661,9947,1516,513,592,458,639,3718,0.199316329213779,0.868020304568528,0.96260162601626,0.966244725738397,0.966717095310136,0.3737810395094
E02003109,Downend North,South Gloucestershire,South West,1269,3447,312,356,306,473,4894,1236,3837,301,384,314,499,5335,798,276,367,307,484,2232,0.207974980453479,0.916943521594684,0.955729166666667,0.977707006369427,0.969939879759519,0.418369259606373
E02003110,Emersons Green,South Gloucestershire,South West,2885,7855,400,414,254,336,9259,2830,8097,455,403,330,359,9644,1444,411,383,316,346,2900,0.178337655921946,0.903296703296703,0.950372208436725,0.957575757575757,0.963788300835655,0.300705101617586
E02003111,Downend South,South Gloucestershire,South West,1164,3845,363,389,289,589,5475,1203,4214,364,408,278,564,5828,880,332,384,268,539,2403,0.208827717133365,0.912087912087912,0.941176470588235,0.964028776978417,0.955673758865248,0.412319835277969
E02003112,Mangotsfield,South Gloucestershire,South West,1405,4002,314,308,240,410,5274,1338,4208,299,322,278,405,5512,896,261,304,263,391,2115,0.212927756653992,0.872909698996656,0.944099378881988,0.946043165467626,0.965432098765432,0.383708272859216
E02003113,"Marshfield, Wick & Hawkesbury",South Gloucestershire,South West,1916,6297,661,656,510,651,8775,1811,6720,718,675,542,664,9319,1380,657,647,522,642,3848,0.205357142857143,0.915041782729805,0.958518518518519,0.96309963099631,0.966867469879518,0.412919841184676
E02003114,Staple Hill North,South Gloucestershire,South West,1197,4264,351,421,309,637,5982,1301,4484,336,425,295,537,6077,987,290,403,292,516,2488,0.220115967885816,0.863095238095238,0.948235294117647,0.989830508474576,0.960893854748603,0.409412539081784
E02003115,Staple Hill South & Kingswood North West,South Gloucestershire,South West,1889,6308,487,404,338,539,8076,1856,6722,447,436,359,523,8487,1336,387,408,342,504,2977,0.198750371913121,0.865771812080537,0.935779816513761,0.952646239554318,0.963671128107075,0.350771768587251
E02003116,Kingswood North East,South Gloucestershire,South West,1474,4696,367,376,329,544,6312,1461,5108,358,368,343,558,6735,1125,313,353,337,530,2658,0.220242756460454,0.874301675977654,0.959239130434783,0.982507288629738,0.949820788530466,0.394654788418708
E02003117,Kingswood South,South Gloucestershire,South West,1959,5879,401,413,326,430,7449,1833,6243,396,423,316,495,7873,1263,359,399,300,482,2803,0.202306583373378,0.906565656565657,0.943262411347518,0.949367088607595,0.973737373737374,0.356026927473644
E02003118,Cadbury Heath North & Bridgeyate,South Gloucestershire,South West,1778,6719,503,405,327,383,8337,1682,6813,510,465,350,389,8527,1507,474,448,343,380,3152,0.221194774695435,0.929411764705882,0.963440860215054,0.98,0.976863753213368,0.369649349126305
E02003119,Cadbury Heath South & North Common,South Gloucestershire,South West,2088,6476,550,534,333,508,8401,1982,6795,568,552,354,492,8761,1487,524,536,341,470,3358,0.218837380426784,0.922535211267606,0.971014492753623,0.963276836158192,0.955284552845528,0.383289578815204
E02003120,Hanham,South Gloucestershire,South West,1633,5402,508,563,399,715,7587,1637,5833,517,556,450,673,8029,1242,491,537,433,654,3357,0.212926452940168,0.949709864603482,0.965827338129496,0.962222222222222,0.971768202080238,0.418109353593225
E02003121,Longwell Green & Oldland Common,South Gloucestershire,South West,1563,5784,708,647,528,787,8454,1557,6147,688,713,581,786,8915,1389,657,700,561,771,4078,0.225963884821864,0.954941860465116,0.981767180925666,0.965576592082616,0.980916030534351,0.457431295569265
E02003122,Glenholt & Widewell,Plymouth,South West,1145,3841,482,591,451,533,5898,1201,3996,517,559,482,644,6198,982,458,532,459,614,3045,0.245745745745746,0.885880077369439,0.95169946332737,0.952282157676349,0.953416149068323,0.491287512100678
E02003123,Southway,Plymouth,South West,1890,5136,420,432,335,488,6811,1887,5502,397,422,343,487,7151,1291,342,392,322,464,2811,0.234641948382406,0.861460957178841,0.928909952606635,0.938775510204082,0.952772073921971,0.393091875262201
E02003124,Tamerton Foliot,Plymouth,South West,1823,4940,338,309,269,380,6236,1873,5323,363,341,273,360,6660,1094,316,314,263,339,2326,0.20552320120233,0.870523415977961,0.920821114369501,0.963369963369963,0.941666666666667,0.349249249249249
E02003125,Ernesettle,Plymouth,South West,1055,3734,354,363,258,314,5023,1068,3796,372,354,248,308,5078,791,320,330,234,286,1961,0.208377239199157,0.860215053763441,0.932203389830508,0.943548387096774,0.928571428571429,0.386175659708547
E02003126,Derriford & Estover,Plymouth,South West,1416,4733,620,527,262,354,6496,1475,5124,658,614,358,335,7089,1251,590,579,343,320,3083,0.244145199063232,0.896656534954407,0.94299674267101,0.958100558659218,0.955223880597015,0.43489913951192
E02003127,King's Tamerton & West Park,Plymouth,South West,1641,4469,333,381,267,323,5773,1609,4767,377,369,286,348,6147,934,322,345,271,327,2199,0.195930354520663,0.854111405835544,0.934959349593496,0.947552447552448,0.939655172413793,0.357735480722304
E02003128,Honicknowle & Manadon,Plymouth,South West,1779,5367,453,467,306,436,7029,1824,5781,440,484,365,405,7475,1253,380,446,340,377,2796,0.216744507870611,0.863636363636364,0.921487603305785,0.931506849315068,0.930864197530864,0.374046822742475
E02003129,Crownhill,Plymouth,South West,1209,3497,345,420,275,426,4963,1196,3533,336,409,286,421,4985,839,309,390,273,404,2215,0.237475233512596,0.919642857142857,0.953545232273839,0.954545454545455,0.959619952494062,0.444332998996991
E02003130,St Budeaux,Plymouth,South West,2165,6431,526,506,337,452,8252,2124,6705,538,528,390,439,8600,1294,454,487,363,412,3010,0.192990305741984,0.843866171003718,0.922348484848485,0.930769230769231,0.938496583143508,0.35
E02003131,Deer Park & Leigham,Plymouth,South West,1409,4306,416,483,344,369,5918,1354,4495,418,476,366,387,6142,969,359,446,352,373,2499,0.215572858731924,0.858851674641148,0.936974789915966,0.961748633879781,0.963824289405685,0.406870726147835
E02003132,"Ham, Beacon Park & Pennycross",Plymouth,South West,1906,5368,440,478,309,455,7050,1849,5576,473,433,336,445,7263,1199,427,409,320,418,2773,0.215028694404591,0.902748414376321,0.944572748267898,0.952380952380952,0.939325842696629,0.381798155032356
E02003133,Higher Compton & Eggbuckland,Plymouth,South West,1307,4253,407,473,349,376,5858,1263,4488,412,447,365,423,6135,945,369,420,349,402,2485,0.210561497326203,0.895631067961165,0.939597315436242,0.956164383561644,0.950354609929078,0.405052974735126
E02003134,North Prospect,Plymouth,South West,1453,4219,316,303,189,296,5323,1549,4677,319,291,187,273,5747,924,260,270,177,250,1881,0.197562540089801,0.815047021943574,0.927835051546392,0.946524064171123,0.915750915750916,0.327301200626414
E02003135,Keyham,Plymouth,South West,1775,5043,260,248,163,181,5895,1571,8284,299,233,168,203,9187,994,256,218,158,188,1814,0.119990342829551,0.8561872909699,0.935622317596567,0.940476190476191,0.926108374384236,0.197452922608033
E02003136,Plympton St Mary,Plymouth,South West,1248,4093,505,602,488,792,6480,1179,4408,503,614,515,827,6867,1030,445,589,497,784,3345,0.233666061705989,0.884691848906561,0.95928338762215,0.96504854368932,0.948004836759371,0.487112276103102
E02003137,Mannamead & Hartley,Plymouth,South West,1340,4452,431,487,349,751,6470,1364,4730,438,488,364,754,6774,990,394,464,345,712,2905,0.209302325581395,0.899543378995434,0.950819672131147,0.947802197802198,0.944297082228117,0.428845586064364
E02003138,Peverell,Plymouth,South West,1457,5008,313,277,190,291,6079,1430,5256,321,279,218,264,6338,1055,275,252,203,254,2039,0.20072298325723,0.856697819314642,0.903225806451613,0.931192660550459,0.962121212121212,0.321710318712528
E02003139,Plympton Chaddlewood,Plymouth,South West,1462,4164,287,323,170,162,5106,1379,4347,305,328,198,167,5345,1016,272,314,196,160,1958,0.233724407637451,0.891803278688525,0.957317073170732,0.98989898989899,0.958083832335329,0.366323666978485
E02003140,Plympton Underwood,Plymouth,South West,1453,4497,388,431,335,563,6214,1444,4707,391,472,329,552,6451,1102,362,454,316,521,2755,0.234119396643297,0.925831202046036,0.961864406779661,0.96048632218845,0.943840579710145,0.427065571229267
E02003141,Ford & Blockhouse Park,Plymouth,South West,1352,5453,328,309,201,291,6582,1363,5681,347,338,220,273,6859,1081,287,298,204,256,2126,0.190283400809717,0.827089337175793,0.881656804733728,0.927272727272727,0.937728937728938,0.309957719784225
E02003142,"Efford, Laira & Crabtree",Plymouth,South West,1782,5724,475,421,282,421,7323,1804,6006,494,413,339,391,7643,1205,398,380,321,371,2675,0.200632700632701,0.805668016194332,0.920096852300242,0.946902654867257,0.948849104859335,0.349993458066204
E02003143,Plympton St Maurice,Plymouth,South West,1364,4367,466,411,334,404,5982,1340,4448,452,464,328,428,6120,1113,391,438,317,398,2657,0.250224820143885,0.865044247787611,0.943965517241379,0.966463414634146,0.929906542056075,0.434150326797386
E02003144,Mutley,Plymouth,South West,679,7405,195,192,121,270,8183,669,7719,194,207,156,306,8582,1104,137,186,137,286,1850,0.143023707734162,0.706185567010309,0.898550724637681,0.878205128205128,0.934640522875817,0.215567466790958
E02003145,Stoke & Pennycomequick,Plymouth,South West,1029,4547,322,335,211,383,5798,1057,4693,321,362,230,373,5979,902,268,328,210,350,2058,0.192201150649904,0.834890965732087,0.906077348066298,0.91304347826087,0.938337801608579,0.344204716507777
E02003146,Lipson,Plymouth,South West,1344,6550,234,238,169,219,7410,1271,6761,284,231,157,209,7642,1039,216,203,147,194,1799,0.153675491791155,0.76056338028169,0.878787878787879,0.936305732484076,0.92822966507177,0.235409578644334
E02003147,"Devonport, Mount Wise & Morice Town",Plymouth,South West,2178,6060,372,320,207,203,7162,2128,6350,383,320,202,257,7512,1180,302,293,187,231,2193,0.185826771653543,0.788511749347259,0.915625,0.925742574257426,0.898832684824903,0.291932907348243
E02003148,"City Centre, Barbican & Sutton Harbour",Plymouth,South West,938,8508,360,302,212,284,9666,1047,10479,352,297,216,297,11641,1224,265,259,188,269,2205,0.116805038648726,0.752840909090909,0.872053872053872,0.87037037037037,0.905723905723906,0.189416716776909
E02003149,Cattedown & Prince Rock,Plymouth,South West,1632,6909,312,260,186,207,7874,1534,7429,372,279,221,214,8515,1036,273,246,195,190,1940,0.139453493067708,0.733870967741936,0.881720430107527,0.882352941176471,0.88785046728972,0.227833235466823
E02003150,Millbay & Stonehouse,Plymouth,South West,1846,8616,557,507,305,532,10517,1748,10560,643,540,353,538,12634,1533,485,469,320,496,3303,0.145170454545455,0.754276827371695,0.868518518518519,0.906515580736544,0.921933085501859,0.261437391166693
E02003151,Plymstock Elburton,Plymouth,South West,1257,3962,505,681,468,891,6507,1442,4374,527,666,527,909,7003,1203,491,647,513,880,3734,0.275034293552812,0.93168880455408,0.971471471471471,0.973434535104364,0.968096809680968,0.533200057118378
E02003152,Plymstock Hooe & Oreston,Plymouth,South West,2011,5961,602,688,499,659,8409,2112,6728,641,709,530,706,9314,1702,582,673,512,686,4155,0.252972651605232,0.90795631825273,0.949224259520451,0.966037735849057,0.971671388101983,0.446102641185312
E02003153,Plymstock Goosewell & Staddiscombe,Plymouth,South West,1364,4248,406,490,379,581,6104,1284,4072,405,488,406,588,5959,1163,383,467,392,574,2979,0.285609037328094,0.945679012345679,0.956967213114754,0.96551724137931,0.976190476190476,0.499916093304246
E02003154,Watcombe,Torbay,South West,1451,4035,405,479,370,484,5773,1486,4361,402,456,353,491,6063,1278,260,422,330,462,2752,0.293052052281587,0.646766169154229,0.925438596491228,0.934844192634561,0.940936863543788,0.453900709219858
E02003155,St Marychurch & Maidencombe,Torbay,South West,933,3197,354,455,303,538,4847,854,3429,406,449,354,594,5232,1008,254,393,325,561,2541,0.293963254593176,0.625615763546798,0.875278396436526,0.918079096045198,0.944444444444444,0.485665137614679
E02003156,Shiphay & the Willows,Torbay,South West,2215,6419,584,561,369,422,8355,2118,6635,601,587,441,463,8727,2120,387,548,409,425,3889,0.319517709118312,0.643926788685524,0.933560477001704,0.927437641723356,0.91792656587473,0.445628509224247
E02003157,Upton & Hele,Torbay,South West,1232,4014,379,362,197,229,5181,1312,4490,364,356,238,270,5718,1244,211,318,213,250,2236,0.27706013363029,0.57967032967033,0.893258426966292,0.894957983193277,0.925925925925926,0.391045820216859
E02003158,Babbacombe & Plainmoor,Torbay,South West,873,2992,417,441,343,554,4747,918,3348,362,432,345,576,5063,1022,224,400,322,550,2518,0.305256869772999,0.61878453038674,0.925925925925926,0.933333333333333,0.954861111111111,0.497333596681809
E02003159,Ellacombe,Torbay,South West,1204,3645,245,295,175,269,4629,1231,4090,294,282,189,233,5088,1137,181,244,169,209,1940,0.27799511002445,0.615646258503401,0.865248226950355,0.894179894179894,0.896995708154507,0.381289308176101
E02003161,Torquay Central,Torbay,South West,1238,5024,435,327,230,355,6371,1216,5809,463,387,245,362,7266,1232,239,317,212,320,2320,0.212084696161129,0.516198704103672,0.819121447028424,0.86530612244898,0.883977900552486,0.319295348197082
E02003163,Wellswood,Torbay,South West,595,4086,708,836,601,1018,7249,667,4516,719,897,669,1044,7845,1291,460,804,604,956,4115,0.285872453498671,0.639777468706537,0.896321070234114,0.902840059790732,0.915708812260536,0.524537922243467
E02003164,Preston & Shorton,Torbay,South West,1325,4758,669,755,504,811,7497,1372,5205,689,752,596,809,8051,1505,430,705,560,744,3944,0.289145052833814,0.624092888243832,0.9375,0.939597315436242,0.919653893695921,0.489877033908831
E02003165,Clifton & Maidenway,Torbay,South West,1340,4051,423,497,321,478,5770,1310,4441,465,493,357,483,6239,1277,245,434,332,457,2745,0.287547849583427,0.526881720430108,0.880324543610548,0.929971988795518,0.946169772256729,0.439974354864562
E02003166,Blatchcombe & Blagdon,Torbay,South West,2795,6981,638,665,458,515,9257,2859,7935,695,671,503,562,10366,2164,373,610,469,521,4137,0.272715816005041,0.536690647482014,0.909090909090909,0.932405566600398,0.927046263345196,0.399093189272622
E02003167,Paignton Central,Torbay,South West,1300,5457,628,614,554,992,8245,1312,6057,671,674,566,1033,9001,1730,305,602,514,952,4103,0.285619943866601,0.454545454545455,0.893175074183976,0.908127208480565,0.921587608906099,0.455838240195534
E02003168,Goodrington & Roselands,Torbay,South West,1059,3892,528,616,459,593,6088,1013,4193,574,607,515,600,6489,1292,336,563,479,560,3230,0.30813260195564,0.585365853658537,0.927512355848435,0.930097087378641,0.933333333333333,0.49776544922176
E02003169,Churston & Galmpton,Torbay,South West,819,3204,684,758,518,785,5949,753,3333,603,766,573,803,6078,992,372,733,540,758,3395,0.297629762976298,0.616915422885572,0.956919060052219,0.942408376963351,0.943960149439602,0.558571898650872
E02003170,Brixham Town,Torbay,South West,1187,4819,826,1051,697,879,8272,1189,5184,841,943,750,893,8611,1408,487,863,714,833,4305,0.271604938271605,0.579072532699168,0.915164369034995,0.952,0.932810750279955,0.499941934734642
E02003171,Higher Brixham,Torbay,South West,1201,3999,590,611,467,655,6322,1060,4201,567,621,471,656,6516,1250,313,568,446,628,3205,0.297548202808855,0.552028218694885,0.914653784219002,0.94692144373673,0.957317073170732,0.491866175567833
E02006840,"Chelston, Cockington & Livermead",Torbay,South West,2098,6214,692,771,520,650,8847,2085,6980,698,755,542,739,9714,1969,416,700,497,691,4273,0.282091690544413,0.595988538681949,0.927152317880795,0.916974169741697,0.935047361299053,0.43988058472308
E02003212,Highworth,Swindon,South West,1281,4565,591,667,424,591,6838,1350,5083,593,660,459,613,7408,1138,555,631,437,597,3358,0.223883533346449,0.935919055649241,0.956060606060606,0.952069716775599,0.973898858075041,0.45329373650108
E02003214,Penhill,Swindon,South West,1673,3640,268,234,144,256,4542,1840,4117,275,246,157,264,5059,893,227,224,148,248,1740,0.216905513723585,0.825454545454545,0.910569105691057,0.942675159235669,0.939393939393939,0.343941490413125
E02003215,Haydon Wick,Swindon,South West,932,3839,470,544,423,442,5718,918,4069,397,525,418,515,5924,802,365,501,407,496,2571,0.197100024576063,0.919395465994962,0.954285714285714,0.973684210526316,0.963106796116505,0.433997299122215
E02003216,Upper Stratton,Swindon,South West,1586,5552,524,629,411,555,7671,1647,6158,545,567,451,618,8339,1359,466,537,437,591,3390,0.220688535238714,0.855045871559633,0.947089947089947,0.968957871396896,0.956310679611651,0.406523563976496
E02003217,Moredon,Swindon,South West,1598,4277,358,331,256,305,5527,1613,4659,343,355,254,320,5931,814,295,330,238,310,1987,0.174715604206911,0.860058309037901,0.929577464788732,0.937007874015748,0.96875,0.335019389647614
E02003218,Pinehurst,Swindon,South West,1444,3866,321,263,204,258,4912,1404,4245,323,312,207,265,5352,769,281,294,197,245,1786,0.181154299175501,0.869969040247678,0.942307692307692,0.951690821256039,0.924528301886792,0.333707025411061
E02003219,"Broad Blunsdon, South Marston & Wanborough",Swindon,South West,2084,5504,506,442,289,411,7152,2793,7647,545,480,336,407,9415,1588,472,457,324,398,3239,0.207663135870276,0.86605504587156,0.952083333333333,0.964285714285714,0.977886977886978,0.344025491237387
E02003220,Lower Stratton,Swindon,South West,1684,5979,578,471,436,851,8315,1629,6549,602,489,426,818,8884,1308,512,465,415,788,3488,0.199725148877691,0.850498338870432,0.950920245398773,0.974178403755868,0.963325183374083,0.392615938766322
E02003221,Gorse Hill,Swindon,South West,1398,4750,289,261,162,234,5696,1479,5159,303,254,182,233,6131,703,226,233,161,211,1534,0.136266718356271,0.745874587458746,0.917322834645669,0.884615384615385,0.905579399141631,0.250203881911597
E02003222,Roughmoor,Swindon,South West,1182,3958,266,186,103,116,4629,1176,4206,304,224,114,125,4973,771,279,215,106,116,1487,0.183309557774608,0.917763157894737,0.959821428571429,0.929824561403509,0.928,0.299014679268048
E02003223,Rodbourne & Cheney Manor,Swindon,South West,2187,7112,383,326,219,323,8363,2160,7411,397,363,233,343,8747,1112,334,337,210,320,2313,0.150047227094859,0.841309823677582,0.928374655647383,0.901287553648069,0.932944606413994,0.264433520064022
E02003224,Covingham,Swindon,South West,1323,4845,560,517,441,637,7000,1350,5147,570,541,441,649,7348,1085,506,524,432,622,3169,0.210802409170391,0.887719298245614,0.968576709796673,0.979591836734694,0.958397534668721,0.431273816004355
E02003225,Westlea & Shaw,Swindon,South West,1165,3951,325,220,132,158,4786,1181,4340,346,304,152,178,5320,779,309,289,146,165,1688,0.179493087557604,0.893063583815029,0.950657894736842,0.960526315789474,0.926966292134832,0.317293233082707
E02003226,Central North,Swindon,South West,2226,7508,296,225,141,167,8337,2398,9271,324,254,161,187,10197,1062,222,195,136,153,1768,0.114550749649445,0.685185185185185,0.767716535433071,0.84472049689441,0.818181818181818,0.173384328724135
E02003227,Walcot East,Swindon,South West,1603,4312,268,177,145,208,5110,1797,4954,276,218,153,226,5827,1019,222,197,132,206,1776,0.20569236980218,0.804347826086957,0.903669724770642,0.862745098039216,0.911504424778761,0.304788055603226
E02003228,Central East & Walcot West,Swindon,South West,1641,4850,304,270,188,369,5981,1612,5421,341,297,208,365,6632,936,297,271,202,341,2047,0.172661870503597,0.870967741935484,0.912457912457912,0.971153846153846,0.934246575342466,0.308655006031363
E02003229,Freshbrook North & Grange Park,Swindon,South West,1082,3674,268,213,70,72,4297,1136,4081,320,228,112,100,4841,781,297,210,102,92,1482,0.191374663072776,0.928125,0.921052631578947,0.910714285714286,0.92,0.306135096054534
E02003230,Central South & Eastcott,Swindon,South West,1583,6361,250,161,152,214,7138,1769,7224,287,199,152,229,8091,796,223,165,134,206,1524,0.110188261351052,0.777003484320558,0.829145728643216,0.881578947368421,0.899563318777293,0.188357434186133
E02003231,Park North & Park South,Swindon,South West,2143,5274,346,331,246,380,6577,2185,6151,376,334,257,379,7497,1311,289,306,228,344,2478,0.213136075434889,0.768617021276596,0.916167664670659,0.88715953307393,0.907651715039578,0.330532212885154
E02003232,Kingshill & Okus,Swindon,South West,1674,5819,343,309,197,315,6983,1668,6112,371,320,201,336,7340,902,312,301,193,305,2013,0.147578534031414,0.840970350404313,0.940625,0.960199004975124,0.907738095238095,0.27425068119891
E02003233,Freshbrook South & Toothill,Swindon,South West,1722,5303,521,445,259,348,6876,1827,5768,558,477,298,344,7445,1157,494,439,270,324,2684,0.200589459084605,0.885304659498208,0.920335429769392,0.906040268456376,0.941860465116279,0.36051040967092
E02003234,Eldene & Dorcan,Swindon,South West,1421,4927,537,514,312,414,6704,1473,5482,547,565,354,464,7412,1270,477,529,335,435,3046,0.231667274717257,0.872029250457038,0.936283185840708,0.946327683615819,0.9375,0.410955207771182
E02003235,Lawn & East Wichel,Swindon,South West,1717,5556,444,471,339,628,7438,1797,5871,471,474,357,634,7807,1109,419,450,342,619,2939,0.188894566513371,0.889596602972399,0.949367088607595,0.957983193277311,0.976340694006309,0.376457025746125
E02003236,"Wroughton, Wichelstowe & Chiseldon",Swindon,South West,2296,6657,681,793,540,899,9570,2300,7570,713,721,631,942,10577,1617,669,684,612,912,4494,0.213606340819022,0.938288920056101,0.948682385575589,0.969889064976228,0.968152866242038,0.42488418266049
E02006847,Mouldon Hill & Oakhurst,Swindon,South West,2515,6442,218,208,84,161,7113,2593,6810,263,241,163,128,7605,1223,232,218,150,120,1943,0.179588839941263,0.88212927756654,0.904564315352697,0.920245398773006,0.9375,0.255489809335963
E02006848,Abbey Park,Swindon,South West,2165,5582,161,101,92,53,5989,2311,5771,180,106,84,95,6236,987,150,85,74,84,1380,0.171027551550858,0.833333333333333,0.80188679245283,0.880952380952381,0.884210526315789,0.221295702373316
E02006849,Groundwell & Abbey Meads,Swindon,South West,2214,6392,340,281,164,215,7392,2230,6872,336,330,218,227,7983,1345,311,306,193,216,2371,0.195721769499418,0.925595238095238,0.927272727272727,0.885321100917431,0.951541850220264,0.297006138043342
E02003892,Gunnislake & Calstock,Cornwall,South West,915,3527,579,614,399,422,5541,900,3791,601,609,445,436,5882,961,543,575,426,409,2914,0.253495120021103,0.903494176372712,0.944170771756979,0.957303370786517,0.938073394495413,0.495409724583475
E02003893,St Neot & St Cleer,Cornwall,South West,976,3758,583,549,361,378,5629,934,3910,590,542,418,401,5861,1046,490,513,404,386,2839,0.267519181585678,0.830508474576271,0.946494464944649,0.966507177033493,0.962593516209476,0.484388329636581
E02003894,Callington & Pensilva,Cornwall,South West,1400,4911,556,603,389,489,6948,1268,4946,533,597,448,586,7110,1326,485,568,430,565,3374,0.268095430651031,0.909943714821764,0.95142378559464,0.959821428571429,0.964163822525597,0.474542897327707
E02003895,"Dobwalls, Addington & Menheniot",Cornwall,South West,1718,5175,573,586,333,466,7133,1770,5576,593,637,415,531,7752,1542,485,593,400,509,3529,0.276542324246772,0.81787521079258,0.930926216640502,0.963855421686747,0.958568738229755,0.455237358101135
E02003896,Liskeard,Cornwall,South West,1041,3343,383,424,290,374,4814,1026,3559,379,429,321,445,5133,916,309,390,306,425,2346,0.257375667322282,0.815303430079156,0.909090909090909,0.953271028037383,0.955056179775281,0.457042665108124
E02003897,Saltash Latchbrook & St Stephens,Cornwall,South West,940,3270,391,470,263,244,4638,835,3213,356,454,309,289,4621,832,334,439,303,281,2189,0.258948023653906,0.938202247191011,0.966960352422907,0.980582524271845,0.972318339100346,0.473706989829041
E02003898,St Germans & St Mellion,Cornwall,South West,953,3790,574,642,370,396,5772,942,3905,592,600,433,461,5991,985,539,571,421,438,2954,0.252240717029449,0.910472972972973,0.951666666666667,0.972286374133949,0.950108459869848,0.493072942747455
E02003899,Mid Saltash,Cornwall,South West,943,3003,396,478,297,361,4535,903,3109,371,468,338,401,4687,948,338,450,331,384,2451,0.304921196526214,0.911051212938005,0.961538461538461,0.979289940828402,0.957605985037407,0.522935779816514
E02003900,Saltash Town & Pillmere,Cornwall,South West,1272,4186,456,480,326,384,5832,1270,4265,462,472,398,468,6065,1147,421,446,383,444,2841,0.268933177022274,0.911255411255411,0.944915254237288,0.962311557788945,0.948717948717949,0.468425391591097
E02003901,"Lanreath, Pelynt & Polraun",Cornwall,South West,1160,4272,682,720,436,583,6693,1115,4500,711,783,529,685,7208,1224,630,746,513,661,3774,0.272,0.886075949367089,0.952745849297573,0.969754253308129,0.964963503649635,0.523584905660377
E02003902,Torpoint,Cornwall,South West,949,3091,342,328,231,273,4265,923,3292,346,347,277,377,4639,999,308,324,267,360,2258,0.303462940461725,0.890173410404624,0.93371757925072,0.963898916967509,0.954907161803714,0.486742832507006
E02003903,"Kingsand, Antony & Maryfield",Cornwall,South West,968,3631,503,520,339,364,5357,904,4574,499,551,383,430,6437,1072,451,511,371,405,2810,0.234368167905553,0.903807615230461,0.927404718693285,0.968668407310705,0.941860465116279,0.436538760292062
E02003904,Looe & Polperro,Cornwall,South West,562,2688,472,508,316,449,4433,492,2771,480,529,316,461,4557,848,436,496,307,449,2536,0.306026705160592,0.908333333333333,0.937618147448015,0.971518987341772,0.973969631236443,0.556506473557165
E02003905,"Grampound Road, St Newlyn East and Cubert",Cornwall,South West,1401,4165,416,400,232,253,5466,1393,4533,450,470,284,315,6052,1174,406,445,266,296,2587,0.258989631590558,0.902222222222222,0.946808510638298,0.936619718309859,0.93968253968254,0.427461996034369
E02003906,Perranporth & Goonhavern,Cornwall,South West,1105,3272,409,489,276,386,4832,1123,3976,428,477,352,487,5720,1059,388,439,336,461,2683,0.266348088531187,0.906542056074766,0.920335429769392,0.954545454545455,0.946611909650924,0.469055944055944
E02003907,St Agnes & Mount Hawke,Cornwall,South West,1637,4786,539,557,379,472,6733,1645,5363,564,600,457,548,7532,1460,447,557,443,521,3428,0.272235688980048,0.792553191489362,0.928333333333333,0.969365426695843,0.950729927007299,0.455124800849708
E02003908,Truro East,Cornwall,South West,1662,4977,457,508,375,533,6850,1581,5373,435,528,386,597,7319,1488,401,502,356,551,3298,0.276940256839754,0.92183908045977,0.950757575757576,0.922279792746114,0.922948073701843,0.450608006558273
E02003909,Truro West,Cornwall,South West,1907,6381,621,548,447,587,8584,1839,6919,595,620,451,687,9272,2432,549,586,422,647,4636,0.351495880907646,0.922689075630252,0.945161290322581,0.93569844789357,0.941775836972344,0.5
E02003910,Truro South & Central,Cornwall,South West,974,4027,335,379,286,459,5486,1049,4489,367,399,321,531,6107,1192,316,369,292,496,2665,0.265537981733125,0.861035422343324,0.924812030075188,0.909657320872274,0.934086629001883,0.436384476829867
E02003911,"Shortlanesend, Chacewater & Carnon Downs",Cornwall,South West,1513,4849,642,782,582,672,7527,1462,5398,627,784,613,745,8167,1557,584,743,595,709,4188,0.288440163023342,0.931419457735247,0.947704081632653,0.970636215334421,0.951677852348993,0.512795396106281
E02003912,Probus & Roseland,Cornwall,South West,1179,4398,634,743,476,579,6830,1191,4805,587,725,520,706,7343,1324,508,688,491,680,3691,0.275546305931322,0.86541737649063,0.948965517241379,0.944230769230769,0.963172804532578,0.502655590358164
E02003913,Mylor Bridge & Frogpool,Cornwall,South West,948,3201,557,570,404,494,5226,848,3208,500,561,439,524,5232,842,445,523,423,507,2740,0.262468827930175,0.89,0.932263814616756,0.963553530751708,0.967557251908397,0.523700305810398
E02003914,Penryn,Cornwall,South West,1304,5751,347,360,269,308,7035,1252,6214,365,355,291,331,7556,778,299,338,276,314,2005,0.125201158673962,0.819178082191781,0.952112676056338,0.948453608247423,0.948640483383686,0.265352038115405
E02003915,Falmouth North,Cornwall,South West,1128,5299,375,379,297,373,6723,1093,5813,401,394,293,377,7278,728,297,373,264,360,2022,0.125236538792362,0.740648379052369,0.946700507614213,0.901023890784983,0.954907161803714,0.277823577906018
E02003916,Falmouth East,Cornwall,South West,576,4901,377,431,252,463,6424,575,4714,379,447,307,555,6402,510,296,416,291,532,2045,0.108188375053034,0.781002638522427,0.930648769574944,0.947882736156352,0.958558558558559,0.31943142767885
E02003917,Falmouth West & South,Cornwall,South West,1422,4921,545,505,346,456,6773,1477,5069,542,491,372,494,6968,859,458,467,364,476,2624,0.169461432235155,0.845018450184502,0.95112016293279,0.978494623655914,0.963562753036437,0.376578645235362
E02003918,Illogan & Portreath,Cornwall,South West,1173,4093,518,517,365,455,5948,1200,4341,531,506,391,466,6235,1030,474,475,363,441,2783,0.237272517853029,0.892655367231638,0.938735177865613,0.928388746803069,0.946351931330472,0.44635124298316
E02003919,Redruth North,Cornwall,South West,1460,4439,376,439,269,438,5961,1364,4700,373,424,283,388,6168,1181,305,381,262,359,2488,0.251276595744681,0.81769436997319,0.898584905660377,0.925795053003534,0.925257731958763,0.40337224383917
E02003920,Redruth South,Cornwall,South West,1482,4832,422,524,313,508,6599,1500,5053,434,498,361,466,6812,1262,376,453,345,435,2871,0.249752622204631,0.866359447004608,0.909638554216867,0.955678670360111,0.933476394849785,0.421462125660599
E02003921,St Day & Lanner,Cornwall,South West,1054,3503,414,451,300,373,5041,1036,3730,416,464,340,429,5379,960,373,443,331,407,2514,0.257372654155496,0.896634615384615,0.954741379310345,0.973529411764706,0.948717948717949,0.467373117679866
E02003922,Pool & Illogan Highway,Cornwall,South West,1765,5247,475,459,317,410,6908,1802,5898,477,493,359,395,7622,1187,423,460,343,367,2780,0.201254662597491,0.886792452830189,0.933062880324544,0.955431754874652,0.929113924050633,0.364733665704539
E02003923,Camborne East,Cornwall,South West,1855,5070,489,461,306,390,6716,1949,5635,454,498,364,412,7363,1290,405,463,339,379,2876,0.228926353149956,0.892070484581498,0.929718875502008,0.931318681318681,0.919902912621359,0.390601656933315
E02003924,Camborne West,Cornwall,South West,1181,3871,475,549,363,531,5789,1150,4229,455,547,443,647,6321,957,388,506,419,618,2888,0.22629463230078,0.852747252747253,0.925045703839123,0.945823927765237,0.955177743431221,0.456889732637241
E02003925,Camborne South,Cornwall,South West,1441,4419,433,427,275,355,5909,1434,5727,443,454,303,417,7344,1058,396,427,288,382,2551,0.184738955823293,0.893905191873589,0.940528634361234,0.95049504950495,0.916067146282974,0.347358387799564
E02003926,"Crowan, Wendron & Stithians",Cornwall,South West,1547,5059,567,528,360,398,6912,1417,5231,607,597,393,454,7282,1115,531,562,372,433,3013,0.213152360925253,0.874794069192751,0.941373534338359,0.946564885496183,0.953744493392071,0.413759956056029
E02003927,"Ponsanooth, Mabe Burnthouse & Constantine",Cornwall,South West,1538,7249,745,823,506,633,9956,1522,7724,776,771,576,688,10535,1124,693,744,555,656,3772,0.145520455722424,0.893041237113402,0.964980544747082,0.963541666666667,0.953488372093023,0.358044613194115
E02003928,Helston,Cornwall,South West,2591,7220,599,660,477,614,9570,2442,7034,644,666,532,710,9586,2002,570,642,519,686,4419,0.284617571794143,0.885093167701863,0.963963963963964,0.975563909774436,0.966197183098592,0.460984769455456
E02003929,"Porthleven, Breage & Praa Sands",Cornwall,South West,1009,3835,562,628,392,505,5922,974,3971,581,638,429,513,6132,1034,515,602,409,488,3048,0.260387811634349,0.886402753872633,0.943573667711599,0.953379953379953,0.951267056530214,0.49706457925636
E02003930,The Lizard,Cornwall,South West,1398,5525,769,819,493,626,8232,1341,6011,731,820,576,708,8846,1264,637,787,557,678,3923,0.210281151222758,0.87140902872777,0.959756097560976,0.967013888888889,0.957627118644068,0.443477277865702
E02003931,Bude & Stratton,Cornwall,South West,1818,5866,790,808,578,807,8849,1807,6083,796,795,602,876,9152,1431,697,746,573,836,4283,0.235245766891337,0.875628140703518,0.938364779874214,0.951827242524917,0.954337899543379,0.46798513986014
E02003932,Poundstock & Kilkhampton,Cornwall,South West,1308,4189,660,582,314,505,6250,1308,4318,670,589,406,508,6491,1005,594,547,391,475,3012,0.232746641963872,0.886567164179105,0.928692699490662,0.963054187192118,0.93503937007874,0.464027114466184
E02003933,Crackington & Tintagel,Cornwall,South West,1118,3948,593,616,438,479,6074,1031,4000,612,611,449,494,6166,683,526,572,427,456,2664,0.17075,0.859477124183007,0.936170212765957,0.951002227171492,0.923076923076923,0.432046707752189
E02003934,Camelford & Tresmeer,Cornwall,South West,1283,4047,543,623,313,443,5969,1230,4071,518,589,383,450,6011,705,456,556,360,416,2493,0.173176123802506,0.88030888030888,0.943972835314092,0.939947780678851,0.924444444444444,0.414739643986026
E02003935,Launceston,Cornwall,South West,2259,6637,536,491,410,585,8659,2104,6710,538,524,424,621,8817,1451,449,484,400,587,3371,0.216244411326379,0.83457249070632,0.923664122137404,0.943396226415094,0.94524959742351,0.382329590563684
E02003936,Altarnun & Stoke Climsland,Cornwall,South West,1135,4758,711,770,509,616,7364,1112,4804,680,794,561,618,7457,1150,589,755,535,583,3612,0.239383846794338,0.866176470588235,0.95088161209068,0.953654188948306,0.94336569579288,0.484377095346654
E02003937,Trebetherick & Whitecross,Cornwall,South West,847,2959,423,429,342,630,4783,839,3040,376,456,322,470,4664,488,334,431,310,447,2010,0.160526315789474,0.888297872340426,0.945175438596491,0.962732919254658,0.951063829787234,0.430960548885077
E02003938,Padstow & St Issey,Cornwall,South West,1320,3990,459,535,349,463,5796,1162,4077,439,458,373,411,5758,671,377,435,356,391,2230,0.16458180034339,0.85876993166287,0.949781659388646,0.954423592493298,0.951338199513382,0.387287252518235
E02003939,Wadebridge,Cornwall,South West,1143,3865,463,545,389,695,5957,1101,3986,435,534,415,627,5997,742,393,511,396,601,2643,0.186151530356247,0.903448275862069,0.956928838951311,0.954216867469879,0.958532695374801,0.44072036018009
E02003940,"St Breward, Tredethy & Lanivet",Cornwall,South West,888,3484,521,515,369,465,5354,888,3635,508,559,382,477,5561,722,436,521,367,444,2490,0.198624484181568,0.858267716535433,0.932021466905188,0.960732984293194,0.930817610062893,0.447761194029851
E02003941,Bodmin East,Cornwall,South West,1716,5063,429,475,305,454,6726,1694,5504,457,494,356,517,7328,1047,370,461,334,485,2697,0.190225290697674,0.809628008752735,0.933198380566802,0.938202247191011,0.938104448742747,0.3680403930131
E02003942,Bodmin West,Cornwall,South West,1684,4731,437,413,298,435,6314,1679,5174,414,416,327,393,6724,1029,315,377,310,375,2406,0.198879010436799,0.760869565217391,0.90625,0.948012232415902,0.954198473282443,0.357822724568709
E02003943,St Ives & Halsetown,Cornwall,South West,961,3960,571,574,354,536,5995,1000,4375,546,564,402,509,6396,896,471,522,378,481,2748,0.2048,0.862637362637363,0.925531914893617,0.940298507462687,0.944990176817289,0.429643527204503
E02003944,Hayle,Cornwall,South West,1800,5709,641,799,529,666,8344,1801,6118,611,789,567,684,8769,1703,505,736,549,656,4149,0.278358940830337,0.826513911620295,0.932826362484157,0.968253968253968,0.95906432748538,0.473144030106055
E02003945,"Towednack, Lelant & Carbis Bay",Cornwall,South West,825,3229,518,571,408,553,5279,780,3359,486,584,432,502,5363,781,432,543,404,478,2638,0.23250967549866,0.888888888888889,0.929794520547945,0.935185185185185,0.952191235059761,0.4918888681708
E02003946,"Marazion, St Erth & Gwinear Gwithian",Cornwall,South West,1653,5425,695,759,487,603,7969,1597,5570,666,757,551,644,8188,1464,580,708,525,620,3897,0.262836624775584,0.870870870870871,0.935270805812417,0.952813067150635,0.962732919254658,0.475940400586224
E02003947,West Penwith & St Buryan,Cornwall,South West,1007,3635,558,578,410,458,5639,959,3813,554,603,414,484,5868,824,443,559,394,447,2667,0.216102806189352,0.799638989169675,0.927031509121061,0.951690821256039,0.923553719008264,0.454498977505113
E02003948,Penzance North,Cornwall,South West,1418,4703,509,616,422,616,6866,1375,5030,517,604,461,644,7256,1143,426,563,446,605,3183,0.227236580516899,0.823984526112186,0.932119205298013,0.967462039045553,0.93944099378882,0.43867144432194
E02003949,Penzance Quay,Cornwall,South West,913,3889,513,494,310,532,5738,912,4319,501,481,354,499,6154,854,356,422,308,463,2403,0.19773095623987,0.710578842315369,0.877338877338877,0.870056497175141,0.927855711422846,0.390477738056549
E02003950,St Just & Land's End,Cornwall,South West,946,3083,507,402,268,397,4657,818,3108,476,443,305,359,4691,595,403,408,286,333,2025,0.191441441441441,0.846638655462185,0.920993227990971,0.937704918032787,0.927576601671309,0.431677680665103
E02003951,Penzance South & Newlyn,Cornwall,South West,807,3099,517,573,398,535,5122,847,3477,457,559,429,523,5445,735,368,522,402,494,2521,0.211389128559103,0.805251641137856,0.933810375670841,0.937062937062937,0.944550669216061,0.462993572084481
E02003952,St Columb Minor & Porth,Cornwall,South West,1729,5202,545,516,340,454,7057,1940,6415,533,574,374,453,8349,1326,471,537,349,436,3119,0.206703039750585,0.883677298311445,0.935540069686411,0.933155080213904,0.962472406181016,0.373577673972931
E02003953,St Columb Major & St Mawgan,Cornwall,South West,2290,6578,690,748,474,652,9142,2093,6658,641,693,501,558,9051,1348,541,651,469,526,3535,0.202463202162812,0.84399375975039,0.939393939393939,0.936127744510978,0.942652329749104,0.390564578499613
E02003954,Newquay West,Cornwall,South West,1105,4661,451,388,275,523,6298,1044,5850,483,430,296,464,7523,923,396,389,269,432,2409,0.157777777777778,0.819875776397516,0.904651162790698,0.908783783783784,0.931034482758621,0.32021799813904
E02003955,Newquay East,Cornwall,South West,1742,6053,590,616,378,587,8224,1731,7079,551,628,451,612,9321,1318,472,593,432,586,3401,0.186184489334652,0.856624319419238,0.944267515923567,0.957871396895787,0.957516339869281,0.364875013410578
E02003956,Roche & Goss Moor,Cornwall,South West,1514,4790,472,447,274,396,6379,1529,5088,491,452,326,352,6709,1157,350,433,310,334,2584,0.227397798742138,0.712830957230143,0.957964601769912,0.950920245398773,0.948863636363636,0.385154270383068
E02003957,Lostwithiel & Penwithick,Cornwall,South West,1977,6465,716,736,501,624,9042,1978,6645,733,754,571,612,9315,1494,511,713,542,538,3798,0.224830699774266,0.697135061391542,0.945623342175066,0.949211908931699,0.879084967320262,0.407729468599034
E02003958,"Trewoon, Coombe & Foxhole",Cornwall,South West,1652,5044,536,502,296,386,6764,1539,5006,543,500,365,387,6801,1209,369,471,344,367,2760,0.24151018777467,0.679558011049724,0.942,0.942465753424658,0.948320413436693,0.405822673136304
E02003959,Par,Cornwall,South West,1297,4159,416,480,306,452,5813,1274,4330,437,434,308,442,5951,960,299,402,294,411,2366,0.221709006928407,0.68421052631579,0.926267281105991,0.954545454545455,0.929864253393665,0.397580238615359
E02003960,Tywardreath & Fowey,Cornwall,South West,777,3216,489,575,388,612,5280,709,3299,504,525,415,520,5263,708,419,495,398,500,2520,0.214610488026675,0.831349206349206,0.942857142857143,0.959036144578313,0.961538461538461,0.478814364430933
E02003961,St Austell East & Carlyon Bay,Cornwall,South West,1726,5582,666,739,481,669,8137,1638,5601,628,733,527,680,8169,1584,468,696,506,661,3915,0.28280664167113,0.745222929936306,0.949522510231924,0.960151802656546,0.972058823529412,0.479250826294528
E02003962,St Austell North & Carclaze,Cornwall,South West,1317,4323,414,471,265,523,5996,1255,4557,430,477,304,383,6151,1239,300,449,285,364,2637,0.271889400921659,0.697674418604651,0.941299790356394,0.9375,0.950391644908616,0.428710778735165
E02003963,St Austell Central,Cornwall,South West,1906,5747,595,608,472,820,8242,1767,5939,569,603,505,774,8390,1631,379,575,489,729,3803,0.274625357804344,0.666080843585237,0.953565505804312,0.968316831683168,0.941860465116279,0.453277711561383
E02003964,Mevagissey & Polgooth,Cornwall,South West,1025,4135,689,840,562,779,7005,1007,4395,663,783,638,700,7179,1181,515,746,607,681,3730,0.268714448236633,0.776772247360483,0.952745849297573,0.95141065830721,0.972857142857143,0.51957097088731
E02006781,Isles of Scilly,Isles of Scilly,South West,318,1326,138,165,110,167,1906,312,1549,125,142,133,167,2116,337,117,140,125,166,885,0.217559715945771,0.936,0.985915492957746,0.93984962406015,0.994011976047904,0.418241965973535
E02006634,"Ramsbury, Ogbournes & Avebury",Wiltshire,South West,1473,5023,581,615,384,557,7160,1412,5439,630,619,450,586,7724,1159,540,588,429,564,3280,0.21309064166207,0.857142857142857,0.949919224555735,0.953333333333333,0.962457337883959,0.424650440186432
E02006635,Marlborough,Wiltshire,South West,1516,4844,494,505,434,740,7017,1649,5600,506,520,478,828,7932,1123,426,490,461,802,3302,0.200535714285714,0.841897233201581,0.942307692307692,0.964435146443515,0.968599033816425,0.416288451840645
E02006636,Pewsey & Lockeridge,Wiltshire,South West,1156,3974,510,506,347,494,5831,1124,4267,495,539,409,506,6216,1031,407,503,392,488,2821,0.241621748300914,0.822222222222222,0.933209647495362,0.958435207823961,0.964426877470356,0.453828828828829
E02006637,Devizes East,Wiltshire,South West,2098,6722,554,588,437,591,8892,2018,6817,559,633,475,653,9137,1751,430,594,461,621,3857,0.256857855361596,0.769230769230769,0.938388625592417,0.970526315789474,0.950995405819295,0.422129801904345
E02006638,Devizes West,Wiltshire,South West,900,3449,429,478,377,623,5356,861,3749,441,507,420,639,5756,993,336,488,404,612,2833,0.264870632168578,0.761904761904762,0.962524654832347,0.961904761904762,0.957746478873239,0.492182070882557
E02006639,Potterne & Rowde,Wiltshire,South West,1183,5072,582,704,433,492,7283,1112,5167,584,670,527,522,7470,1176,483,638,509,510,3316,0.227598219469712,0.827054794520548,0.952238805970149,0.96584440227704,0.977011494252874,0.443908969210174
E02006640,"Bedwyn, Burbage & Collingbourne",Wiltshire,South West,1358,4315,537,495,288,396,6031,1273,4673,532,521,349,438,6513,981,478,500,336,430,2725,0.209929381553606,0.898496240601504,0.959692898272553,0.962750716332378,0.981735159817352,0.418393981268233
E02006641,Market Lavington & Bishops Cannings,Wiltshire,South West,1451,4793,546,503,382,492,6716,1442,5018,547,532,374,535,7006,1152,433,505,356,519,2965,0.229573535273017,0.791590493601463,0.949248120300752,0.951871657754011,0.970093457943925,0.423208678275764
E02006642,Netheravon & Upavon,Wiltshire,South West,966,3403,389,374,258,263,4687,935,3354,406,391,273,301,4725,812,312,377,265,293,2059,0.242098986285033,0.768472906403941,0.964194373401535,0.970695970695971,0.973421926910299,0.435767195767196
E02006643,Tidworth & Ludgershall,Wiltshire,South West,4830,12020,409,357,200,269,13255,4592,14125,469,416,229,282,15521,1962,389,388,221,268,3228,0.138902654867257,0.829424307036247,0.932692307692308,0.965065502183406,0.950354609929078,0.207976290187488
E02006644,Cricklade & Ashton Keynes,Wiltshire,South West,1049,3783,517,475,326,375,5476,1147,4191,518,547,361,401,6018,726,390,522,338,382,2358,0.173228346456693,0.752895752895753,0.954296160877514,0.936288088642659,0.952618453865337,0.391824526420738
E02006645,"Malmesbury, Crudwell & Oaksey",Wiltshire,South West,1590,4652,464,412,324,392,6244,1501,4968,443,462,345,427,6645,1207,388,445,331,417,2788,0.242954911433172,0.875846501128668,0.963203463203463,0.959420289855072,0.976580796252927,0.419563581640331
E02006646,Lydiard Millicent & Purton,Wiltshire,South West,1697,4561,356,388,238,499,6042,1708,5148,406,402,281,507,6744,1022,292,380,274,487,2455,0.198523698523699,0.719211822660099,0.945273631840796,0.97508896797153,0.960552268244576,0.364027283511269
E02006647,"Somerford, Dauntsey & Minety",Wiltshire,South West,996,3378,448,504,299,333,4962,988,3691,459,486,344,359,5339,879,387,467,333,350,2416,0.238146843673801,0.843137254901961,0.960905349794239,0.968023255813953,0.974930362116992,0.452519198351751
E02006648,Sherston & Hullavington,Wiltshire,South West,1165,3496,364,375,284,425,4944,1141,3614,346,411,317,430,5118,855,317,399,308,417,2296,0.236579966795794,0.916184971098266,0.970802919708029,0.971608832807571,0.969767441860465,0.448612739351309
E02006649,Royal Wootton Bassett Town,Wiltshire,South West,1371,4560,436,406,297,451,6150,1339,4857,446,439,312,490,6544,949,365,416,301,454,2485,0.19538809964999,0.818385650224215,0.947608200455581,0.96474358974359,0.926530612244898,0.379737163814181
E02006650,Royal Wootton Bassett Outer & Lyneham,Wiltshire,South West,2675,7758,702,760,486,603,10309,2285,9393,670,757,587,679,12086,1378,550,728,566,636,3858,0.146704993079953,0.82089552238806,0.961690885072655,0.964224872231686,0.936671575846834,0.319212311765679
E02006651,"Sutton Benger, Kington & Biddestone",Wiltshire,South West,1318,4545,465,482,330,335,6157,1253,4508,492,490,384,403,6277,916,414,477,370,389,2566,0.203194321206744,0.841463414634146,0.973469387755102,0.963541666666667,0.965260545905707,0.40879400987733
E02006652,Chippenham North,Wiltshire,South West,1915,6149,412,402,287,438,7688,1784,6552,457,392,308,439,8148,1008,410,368,296,418,2500,0.153846153846154,0.897155361050328,0.938775510204082,0.961038961038961,0.952164009111617,0.306823760432008
E02006653,Chippenham West,Wiltshire,South West,1785,6078,469,552,364,414,7877,1742,6541,543,533,372,464,8453,1119,501,509,352,445,2926,0.17107475921113,0.922651933701657,0.954971857410882,0.946236559139785,0.959051724137931,0.346149296107891
E02006654,Chippenham South & East,Wiltshire,South West,1593,5701,430,501,388,782,7802,1550,6149,484,505,421,768,8327,1020,430,478,394,735,3057,0.16588063099691,0.888429752066116,0.946534653465346,0.935866983372922,0.95703125,0.36711901044794
E02006655,Derry Hill & Hilmarton,Wiltshire,South West,1206,4307,518,516,351,556,6248,1185,4787,502,555,376,579,6799,871,357,517,366,543,2654,0.181951117610194,0.711155378486056,0.931531531531532,0.973404255319149,0.937823834196891,0.390351522282689
E02006656,Chippenham Pewsham,Wiltshire,South West,1177,4653,319,268,165,227,5632,1149,4885,363,295,162,200,5905,893,330,279,157,193,1852,0.182804503582395,0.909090909090909,0.945762711864407,0.969135802469136,0.965,0.313632514817951
E02006657,Calne North,Wiltshire,South West,2502,6679,482,454,336,415,8366,2434,7123,493,494,348,411,8869,1468,258,468,333,396,2923,0.206092938368665,0.523326572008114,0.947368421052632,0.956896551724138,0.963503649635036,0.329574923892209
E02006658,Calne South,Wiltshire,South West,1315,4476,468,499,333,449,6225,1344,4778,505,519,374,487,6663,920,322,491,372,473,2578,0.192549183758895,0.637623762376238,0.946050096339114,0.994652406417112,0.971252566735113,0.386912802041123
E02006659,"Box, Colerne & Rudloe",Wiltshire,South West,1609,4670,438,454,330,433,6325,1708,4895,462,472,364,453,6646,800,407,445,352,430,2434,0.163432073544433,0.880952380952381,0.942796610169492,0.967032967032967,0.949227373068433,0.366235329521517
E02006660,"Corsham, Bowden Hill & Lacock",Wiltshire,South West,2658,7717,829,868,546,834,10794,2453,8162,811,866,654,884,11377,1305,753,827,626,854,4365,0.159887282528792,0.928483353884094,0.954965357967667,0.957186544342508,0.96606334841629,0.38366880548475
E02006661,"Larkhill, Shrewton & Bulford Camp",Wiltshire,South West,2994,6966,257,226,158,204,7811,2484,9151,262,237,181,211,10042,918,226,223,176,202,1745,0.100316905256256,0.862595419847328,0.940928270042194,0.972375690607735,0.957345971563981,0.173770165305716
E02006662,Durrington & Bulford,Wiltshire,South West,1202,3740,396,330,241,279,4986,1369,3963,387,368,259,297,5274,932,318,356,250,289,2145,0.235175372192783,0.821705426356589,0.967391304347826,0.965250965250965,0.973063973063973,0.406712172923777
E02006663,Amesbury,Wiltshire,South West,2651,7617,584,490,354,658,9703,2524,7890,600,554,400,681,10125,1628,528,529,388,649,3722,0.206337135614702,0.88,0.954873646209386,0.97,0.953010279001468,0.367604938271605
E02006664,"Great Wishford, Woodford Valley & Porton",Wiltshire,South West,1109,3656,429,473,323,413,5294,1020,3682,467,457,342,432,5380,871,426,443,337,420,2497,0.236556219445953,0.91220556745182,0.969365426695843,0.985380116959064,0.972222222222222,0.464126394052045
E02006665,Mere & East Knoyle,Wiltshire,South West,993,3541,551,618,450,582,5742,982,3801,566,611,502,628,6108,860,502,584,482,614,3042,0.226256248355696,0.886925795053003,0.955810147299509,0.960159362549801,0.977707006369427,0.49803536345776
E02006666,Salisbury Bishopsdown,Wiltshire,South West,1445,3931,300,361,225,418,5235,1427,4158,321,350,245,387,5461,1154,299,341,236,368,2398,0.277537277537278,0.931464174454829,0.974285714285714,0.963265306122449,0.950904392764858,0.439113715436733
E02006667,Salisbury Bemerton,Wiltshire,South West,1650,4219,331,237,160,216,5163,1776,4662,333,275,178,210,5658,1354,298,258,163,202,2275,0.29043329043329,0.894894894894895,0.938181818181818,0.915730337078652,0.961904761904762,0.402085542594556
E02006668,Salisbury Stratford,Wiltshire,South West,938,3364,340,444,343,442,4933,907,3612,363,407,350,453,5185,1083,336,393,341,438,2591,0.299833887043189,0.925619834710744,0.965601965601966,0.974285714285714,0.966887417218543,0.499710703953713
E02006669,"Wilton, Nadder & Ebble",Wiltshire,South West,1660,5765,704,746,595,831,8641,1631,6102,684,782,587,864,9019,1571,599,754,562,853,4339,0.257456571615864,0.875730994152047,0.964194373401535,0.957410562180579,0.987268518518519,0.481095465129172
E02006670,Salisbury Churchfields,Wiltshire,South West,1107,4308,356,325,261,385,5635,1078,4584,388,351,266,392,5981,1299,338,327,239,348,2551,0.283376963350785,0.871134020618557,0.931623931623932,0.898496240601504,0.887755102040816,0.426517304798529
E02006671,Salisbury Town North & Milford,Wiltshire,South West,998,3796,316,346,235,417,5110,979,4129,359,368,286,524,5666,1085,316,340,275,481,2497,0.262775490433519,0.880222841225627,0.923913043478261,0.961538461538461,0.91793893129771,0.440698905753618
E02006672,"Laverstock, Bodenham & Coombe Bissett",Wiltshire,South West,2087,5118,404,475,345,643,6985,2025,5628,404,495,356,655,7538,1559,371,476,341,627,3374,0.277007818052594,0.918316831683168,0.961616161616162,0.957865168539326,0.957251908396947,0.447598832581587
E02006673,Salisbury Cathedral & Harnham,Wiltshire,South West,716,2652,354,404,285,577,4272,690,2941,382,388,318,572,4601,823,324,358,306,550,2361,0.279836790207412,0.848167539267016,0.922680412371134,0.962264150943396,0.961538461538461,0.513149315366225
E02006674,Salisbury East Harnham,Wiltshire,South West,1201,3537,315,291,219,399,4761,1141,3826,344,324,240,376,5110,1183,304,300,229,351,2367,0.309200209095661,0.883720930232558,0.925925925925926,0.954166666666667,0.933510638297872,0.46320939334638
E02006675,"Whaddon, Whiteparish & Winterslow",Wiltshire,South West,1303,4536,573,546,439,550,6644,1226,4707,587,596,444,570,6904,1221,540,574,433,557,3325,0.259400892288082,0.919931856899489,0.963087248322148,0.975225225225225,0.97719298245614,0.481604866743917
E02006676,"Tisbury, Donhead & Tollard Royal",Wiltshire,South West,1045,3396,502,498,351,521,5268,1023,3506,500,544,373,508,5431,761,443,524,351,503,2582,0.217056474614946,0.886,0.963235294117647,0.941018766756032,0.990157480314961,0.475418891548518
E02006677,Downton & Morgan's Vale,Wiltshire,South West,1354,4364,572,578,462,700,6676,1286,4668,552,622,472,703,7017,1250,517,597,449,675,3488,0.267780634104542,0.936594202898551,0.959807073954984,0.951271186440678,0.960170697012802,0.497078523585578
E02006678,Melksham North,Wiltshire,South West,1561,4501,383,457,341,357,6039,1461,4820,410,437,379,408,6454,849,355,425,370,394,2393,0.176141078838174,0.865853658536585,0.97254004576659,0.976253298153034,0.965686274509804,0.370777812209482
E02006679,"Bowerhill, Atworth & Whitley",Wiltshire,South West,2236,6644,701,701,476,656,9178,2347,7389,756,698,537,688,10068,1221,684,674,524,668,3771,0.165245635403979,0.904761904761905,0.965616045845272,0.975791433891992,0.970930232558139,0.374553039332539
E02006680,Melksham South,Wiltshire,South West,1263,4257,459,443,344,640,6143,1225,4551,460,479,365,681,6536,819,393,447,350,658,2667,0.179960448253131,0.854347826086957,0.933194154488518,0.958904109589041,0.966226138032305,0.408047735618115
E02006681,"Winsley, Westwood & Holt",Wiltshire,South West,943,3090,467,475,324,513,4869,996,3468,452,495,391,508,5314,611,416,470,378,481,2356,0.176182237600923,0.920353982300885,0.949494949494949,0.966751918158568,0.946850393700787,0.443357169740309
E02006682,Bradford-on-Avon,Wiltshire,South West,1722,5300,783,734,567,904,8288,1775,6202,762,780,595,916,9255,976,670,738,569,886,3839,0.157368590777169,0.879265091863517,0.946153846153846,0.956302521008403,0.967248908296943,0.414802809292274
E02006683,"Staverton, Hilperton & Semington",Wiltshire,South West,1750,5151,430,408,320,354,6663,1506,5178,441,428,331,385,6763,1063,375,401,320,371,2530,0.205291618385477,0.850340136054422,0.936915887850467,0.966767371601209,0.963636363636364,0.374094336832767
E02006684,Trowbridge North,Wiltshire,South West,1173,4436,346,318,167,233,5500,1153,4833,365,358,265,384,6205,879,266,332,254,368,2099,0.18187461204221,0.728767123287671,0.927374301675978,0.958490566037736,0.958333333333333,0.338275584206285
E02006685,Trowbridge East,Wiltshire,South West,2201,6080,510,512,345,568,8015,2310,6647,504,564,367,570,8652,1273,437,528,356,552,3146,0.191514969159019,0.867063492063492,0.936170212765957,0.970027247956403,0.968421052631579,0.363615349052242
E02006686,Trowbridge West,Wiltshire,South West,986,3253,311,328,211,448,4551,985,3551,284,327,226,297,4685,728,220,307,219,294,1768,0.205012672486624,0.774647887323944,0.938837920489297,0.969026548672566,0.98989898989899,0.377374599786553
E02006687,Trowbridge South East,Wiltshire,South West,1553,4954,393,360,197,229,6133,1601,5501,439,366,258,263,6827,1115,346,345,251,256,2313,0.20269041992365,0.788154897494305,0.942622950819672,0.972868217054264,0.973384030418251,0.338801816317563
E02006688,Trowbridge South,Wiltshire,South West,1019,3545,261,308,217,274,4605,876,3779,302,310,223,308,4922,762,232,292,212,298,1796,0.201640645673459,0.768211920529801,0.941935483870968,0.95067264573991,0.967532467532468,0.364892320195043
E02006689,"Steeple Ashton, North Bradley & Southwick",Wiltshire,South West,1308,3815,472,526,367,397,5577,1181,3912,454,495,405,470,5736,770,394,478,395,458,2495,0.196830265848671,0.86784140969163,0.965656565656566,0.975308641975309,0.974468085106383,0.434972105997211
E02006690,Dilton Marsh & Bratton,Wiltshire,South West,1007,3593,530,572,378,456,5529,1052,4026,515,566,402,498,6007,807,408,542,386,481,2624,0.200447093889717,0.792233009708738,0.957597173144876,0.960199004975124,0.965863453815261,0.436823705676711
E02006691,Westbury,Wiltshire,South West,2962,9006,665,722,513,746,11652,2834,9241,695,702,556,785,11979,1781,552,645,528,740,4246,0.192728059733795,0.794244604316547,0.918803418803419,0.949640287769784,0.942675159235669,0.3544536271809
E02006692,Warminster East,Wiltshire,South West,1080,3360,316,291,211,403,4581,1026,3403,288,305,231,372,4599,501,240,286,216,350,1593,0.147223038495445,0.833333333333333,0.937704918032787,0.935064935064935,0.940860215053764,0.346379647749511
E02006693,Warminster West & North,Wiltshire,South West,1045,3525,367,421,246,358,4917,1055,3930,389,403,312,340,5374,795,337,381,296,314,2123,0.202290076335878,0.866323907455013,0.945409429280397,0.948717948717949,0.923529411764706,0.395050241905471
E02006694,Warminster Central,Wiltshire,South West,872,3600,390,456,347,536,5329,858,3816,385,464,401,576,5642,654,299,430,374,548,2305,0.171383647798742,0.776623376623377,0.926724137931035,0.932668329177057,0.951388888888889,0.408543069833392
E02006695,Wylye Valley,Wiltshire,South West,1013,3484,441,553,399,551,5428,975,3841,461,547,415,594,5858,765,386,524,397,577,2649,0.199166883624056,0.837310195227766,0.957952468007313,0.956626506024096,0.971380471380471,0.452202116763401
E02003172,Kinson East,"Bournemouth, Christchurch and Poole",South West,1203,3606,360,420,276,456,5118,1181,4097,366,430,289,427,5609,921,321,396,278,398,2314,0.224798633146205,0.877049180327869,0.92093023255814,0.961937716262976,0.93208430913349,0.41255125690854
E02003173,Kinson West,"Bournemouth, Christchurch and Poole",South West,1129,3472,451,467,328,590,5308,1091,4171,442,487,357,598,6055,1061,396,459,341,568,2825,0.254375449532486,0.895927601809955,0.942505133470226,0.955182072829132,0.949832775919733,0.466556564822461
E02003174,Northbourne,"Bournemouth, Christchurch and Poole",South West,1504,4507,466,520,384,598,6475,1478,5216,500,533,407,627,7283,1125,455,505,380,594,3059,0.215682515337423,0.91,0.947467166979362,0.933660933660934,0.947368421052632,0.420019222847728
E02003175,Throop & Muscliffe,"Bournemouth, Christchurch and Poole",South West,2191,5355,417,433,304,435,6944,2132,6312,459,432,350,409,7962,1498,400,399,322,382,3001,0.237325728770596,0.871459694989107,0.923611111111111,0.92,0.93398533007335,0.376915347902537
E02003176,West Howe,"Bournemouth, Christchurch and Poole",South West,1694,4530,319,310,220,311,5690,1661,5026,341,300,240,291,6198,1161,284,276,218,267,2206,0.23099880620772,0.832844574780059,0.92,0.908333333333333,0.917525773195876,0.355921264924169
E02003177,Moordown,"Bournemouth, Christchurch and Poole",South West,1793,4940,383,348,214,418,6303,1837,5767,414,383,271,407,7242,1293,359,354,247,382,2635,0.224206693254725,0.867149758454106,0.924281984334204,0.911439114391144,0.938574938574938,0.363849765258216
E02003178,East Howe & Ensbury Park,"Bournemouth, Christchurch and Poole",South West,1699,5102,413,437,298,465,6715,1658,5817,413,452,346,469,7497,1227,364,417,316,435,2759,0.210933470861269,0.88135593220339,0.922566371681416,0.913294797687861,0.927505330490405,0.368013872215553
E02003179,Townsend & Strouden,"Bournemouth, Christchurch and Poole",South West,1354,3729,346,400,294,438,5207,1304,4270,351,379,281,431,5712,1209,309,354,261,400,2533,0.283138173302108,0.88034188034188,0.934036939313984,0.928825622775801,0.928074245939675,0.443452380952381
E02003180,Winton,"Bournemouth, Christchurch and Poole",South West,1738,6775,280,273,221,263,7812,1638,7324,303,290,174,294,8385,1133,242,257,146,262,2040,0.154696886947024,0.798679867986799,0.886206896551724,0.839080459770115,0.891156462585034,0.243291592128801
E02003181,Queens Park,"Bournemouth, Christchurch and Poole",South West,1822,5381,391,403,250,420,6845,1719,6333,422,440,282,421,7898,1218,377,393,255,390,2633,0.1923259118901,0.893364928909953,0.893181818181818,0.904255319148936,0.926365795724466,0.333375538110914
E02003182,Littledown,"Bournemouth, Christchurch and Poole",South West,1261,3893,374,395,224,383,5269,1234,4524,354,407,276,381,5942,1177,324,384,261,367,2513,0.260167992926614,0.915254237288136,0.943488943488943,0.945652173913043,0.963254593175853,0.422921575227196
E02003183,Talbot & Branksome Woods,"Bournemouth, Christchurch and Poole",South West,963,4499,371,433,252,438,5993,1009,4929,389,411,317,483,6529,861,342,383,297,435,2318,0.174680462568472,0.879177377892031,0.931873479318735,0.936908517350158,0.900621118012422,0.355031398376474
E02003184,Charminster,"Bournemouth, Christchurch and Poole",South West,1444,5706,229,193,149,286,6563,1405,6713,287,225,156,282,7663,1001,221,191,132,243,1788,0.149113660062565,0.770034843205575,0.848888888888889,0.846153846153846,0.861702127659575,0.233328983426856
E02003185,Iford,"Bournemouth, Christchurch and Poole",South West,1669,4566,354,365,224,365,5874,1532,5302,391,383,243,351,6670,1280,352,354,232,331,2549,0.24141833270464,0.900255754475703,0.924281984334204,0.954732510288066,0.943019943019943,0.38215892053973
E02003186,Springbourne & Queen's Park,"Bournemouth, Christchurch and Poole",South West,1946,6353,308,240,160,223,7284,1958,7668,335,281,181,214,8679,1306,258,240,158,186,2148,0.170318205529473,0.770149253731343,0.854092526690392,0.87292817679558,0.869158878504673,0.247493950916004
E02003187,Boscombe East,"Bournemouth, Christchurch and Poole",South West,1780,6214,428,368,255,381,7646,1846,7505,466,424,287,401,9083,1448,387,376,261,362,2834,0.192938041305796,0.830472103004292,0.886792452830189,0.909407665505226,0.902743142144638,0.312011449961466
E02003188,Central Bournemouth,"Bournemouth, Christchurch and Poole",South West,1145,9982,461,459,291,652,11845,1136,11482,481,469,335,598,13365,1282,366,392,287,529,2856,0.111653022121582,0.760914760914761,0.835820895522388,0.856716417910448,0.884615384615385,0.213692480359147
E02003189,Southbourne West,"Bournemouth, Christchurch and Poole",South West,1338,5141,555,510,336,774,7316,1270,5812,517,575,383,778,8065,1405,452,514,353,729,3453,0.241741225051617,0.874274661508704,0.893913043478261,0.921671018276762,0.937017994858612,0.428146311221327
E02003190,Boscombe West,"Bournemouth, Christchurch and Poole",South West,1651,7676,453,307,192,368,8996,1612,9002,474,397,215,388,10476,1523,348,322,176,340,2709,0.169184625638747,0.734177215189873,0.811083123425693,0.818604651162791,0.876288659793815,0.258591065292096
E02003191,East Southbourne & Hengistbury Head,"Bournemouth, Christchurch and Poole",South West,1231,4269,643,699,512,916,7039,1174,4774,598,693,579,917,7561,1316,537,648,558,871,3930,0.275659824046921,0.897993311036789,0.935064935064935,0.963730569948187,0.949836423118866,0.519772516862849
E02003192,East Cliff,"Bournemouth, Christchurch and Poole",South West,1268,9738,452,489,327,589,11595,1449,11674,453,463,382,617,13589,1371,336,396,338,544,2985,0.117440465992805,0.741721854304636,0.855291576673866,0.884816753926702,0.881685575364668,0.219662962690411
E02003194,Merley,"Bournemouth, Christchurch and Poole",South West,1036,3185,478,580,359,528,5130,1017,3708,468,534,476,517,5703,900,434,507,448,491,2780,0.242718446601942,0.927350427350427,0.949438202247191,0.941176470588235,0.949709864603482,0.487462738909346
E02003195,Bearwood,"Bournemouth, Christchurch and Poole",South West,1048,3357,329,282,179,300,4447,1084,3731,363,301,210,298,4903,977,320,281,201,276,2055,0.261860091128384,0.881542699724518,0.933554817275748,0.957142857142857,0.926174496644295,0.41913114419743
E02003196,Broadstone,"Bournemouth, Christchurch and Poole",South West,1519,5449,717,754,558,1173,8651,1453,6135,710,781,597,1160,9383,1700,648,746,569,1113,4776,0.277098614506927,0.912676056338028,0.955185659411011,0.953098827470687,0.95948275862069,0.509005648513269
E02003197,Canford Heath West,"Bournemouth, Christchurch and Poole",South West,1329,4051,436,431,183,299,5400,1306,4448,447,464,233,291,5883,1152,383,436,218,278,2467,0.258992805755396,0.856823266219239,0.939655172413793,0.935622317596567,0.9553264604811,0.419343872174061
E02003198,Canford Heath East,"Bournemouth, Christchurch and Poole",South West,1582,4573,308,376,278,272,5807,1553,5013,349,375,300,332,6369,1276,309,345,277,310,2517,0.254538200678237,0.885386819484241,0.92,0.923333333333333,0.933734939759036,0.395195478097032
E02003199,Creekmoor,"Bournemouth, Christchurch and Poole",South West,1689,5354,570,571,364,604,7463,1608,5904,585,573,426,663,8151,1520,492,534,395,628,3569,0.257452574525745,0.841025641025641,0.931937172774869,0.927230046948357,0.947209653092006,0.437860385228806
E02003200,Rossmore,"Bournemouth, Christchurch and Poole",South West,2028,6157,517,574,429,530,8207,2123,6861,546,556,426,573,8962,1717,483,509,406,541,3656,0.25025506485935,0.884615384615385,0.915467625899281,0.953051643192488,0.944153577661431,0.40794465521089
E02003201,Newtown,"Bournemouth, Christchurch and Poole",South West,2217,6887,507,507,338,452,8691,2223,7656,555,503,423,507,9644,1876,478,470,395,472,3691,0.24503657262278,0.861261261261261,0.934393638170974,0.933806146572104,0.930966469428008,0.382725010369141
E02003202,Branksome East,"Bournemouth, Christchurch and Poole",South West,1013,4037,351,332,229,313,5262,962,4401,353,341,256,354,5705,843,298,315,234,324,2014,0.191547375596455,0.844192634560907,0.923753665689149,0.9140625,0.915254237288136,0.353023663453111
E02003203,Branksome West,"Bournemouth, Christchurch and Poole",South West,1466,4809,416,312,255,292,6084,1445,5369,392,363,237,327,6688,1248,337,329,219,292,2425,0.232445520581114,0.859693877551021,0.90633608815427,0.924050632911392,0.892966360856269,0.36258971291866
E02003204,Oakdale East,"Bournemouth, Christchurch and Poole",South West,1576,5471,489,492,391,650,7493,1587,5941,493,515,405,658,8012,1513,435,465,374,616,3403,0.254670930819727,0.882352941176471,0.902912621359223,0.923456790123457,0.936170212765957,0.42473789316026
E02003205,Oakdale West,"Bournemouth, Christchurch and Poole",South West,1570,4813,510,553,330,552,6758,1519,5469,488,580,387,531,7455,1456,443,551,369,502,3321,0.266227829584933,0.907786885245902,0.95,0.953488372093023,0.945386064030132,0.445472837022133
E02003206,Penn Hill,"Bournemouth, Christchurch and Poole",South West,1972,6228,439,539,346,519,8071,1868,6886,538,551,390,548,8913,1648,475,510,366,514,3513,0.239326169038629,0.882899628252788,0.925589836660617,0.938461538461539,0.937956204379562,0.394143386065298
E02003207,Hamworthy West,"Bournemouth, Christchurch and Poole",South West,1595,4283,300,355,285,330,5553,1626,5405,329,363,307,314,6718,857,286,341,289,300,2073,0.158556891766883,0.869300911854103,0.939393939393939,0.941368078175896,0.955414012738854,0.308573980351295
E02003208,Poole Town,"Bournemouth, Christchurch and Poole",South West,1794,7552,614,596,455,912,10129,1819,8034,598,674,497,900,10703,1944,522,611,446,855,4378,0.241971620612397,0.872909698996656,0.906528189910979,0.89738430583501,0.95,0.409044193216855
E02003209,Hamworthy East,"Bournemouth, Christchurch and Poole",South West,1182,3857,423,390,258,356,5284,1152,4385,434,455,310,364,5948,819,386,425,297,343,2270,0.186773090079818,0.889400921658986,0.934065934065934,0.958064516129032,0.942307692307692,0.381640887693342
E02003210,Parkstone,"Bournemouth, Christchurch and Poole",South West,1648,5370,550,638,490,885,7933,1664,5848,584,665,549,925,8571,1400,526,613,502,875,3916,0.239398084815322,0.900684931506849,0.921804511278195,0.914389799635701,0.945945945945946,0.456889511142224
E02003211,"Branksome Park, Canford Cliffs & Sandbanks","Bournemouth, Christchurch and Poole",South West,876,4313,689,927,681,1470,8080,837,4341,686,895,798,1474,8194,922,616,829,748,1378,4493,0.212393457728634,0.897959183673469,0.926256983240224,0.93734335839599,0.934871099050203,0.54832804491091
E02004236,Burton & Airport,"Bournemouth, Christchurch and Poole",South West,895,3293,442,504,360,529,5128,903,3610,490,555,397,577,5629,953,422,521,382,529,2807,0.26398891966759,0.861224489795918,0.938738738738739,0.962216624685139,0.916811091854419,0.498667614141055
E02004237,Jumpers Common & Fairmile,"Bournemouth, Christchurch and Poole",South West,1452,4625,467,580,406,730,6808,1478,5083,454,549,431,673,7190,1463,406,523,405,623,3420,0.28782215227228,0.894273127753304,0.95264116575592,0.939675174013921,0.925705794947994,0.475660639777469
E02004238,Highcliffe & Walkford,"Bournemouth, Christchurch and Poole",South West,816,3331,617,840,644,1198,6630,801,3560,553,837,696,1246,6892,826,500,807,677,1202,4012,0.232022471910112,0.904159132007233,0.96415770609319,0.972701149425287,0.964686998394864,0.582124201973302
E02004239,West Highcliffe,"Bournemouth, Christchurch and Poole",South West,897,2991,490,602,468,635,5186,861,3244,441,602,478,719,5484,747,404,577,459,694,2881,0.230271270036991,0.91609977324263,0.958471760797342,0.960251046025105,0.965229485396384,0.525346462436178
E02004240,Somerford,"Bournemouth, Christchurch and Poole",South West,1253,4025,309,317,186,279,5116,1214,4242,322,306,217,279,5366,974,258,275,209,259,1975,0.22960867515323,0.801242236024845,0.898692810457516,0.963133640552995,0.92831541218638,0.368058143868804
E02004241,Christchurch Town,"Bournemouth, Christchurch and Poole",South West,1764,5363,560,648,479,869,7919,1720,5711,546,641,525,976,8399,1424,451,602,499,924,3900,0.249343372439153,0.826007326007326,0.939157566302652,0.95047619047619,0.94672131147541,0.464340992975354
E02004242,Mudeford,"Bournemouth, Christchurch and Poole",South West,738,2986,600,732,519,841,5678,754,3233,580,670,610,836,5929,760,524,635,582,793,3294,0.235075781008351,0.903448275862069,0.947761194029851,0.954098360655738,0.948564593301435,0.555574295834036
E02006883,Westbourne,"Bournemouth, Christchurch and Poole",South West,557,3814,268,321,243,676,5322,620,4463,289,303,294,627,5976,662,237,256,272,582,2009,0.148330719247143,0.820069204152249,0.844884488448845,0.925170068027211,0.92822966507177,0.336178045515395
E02006885,West Cliff,"Bournemouth, Christchurch and Poole",South West,794,5297,401,458,317,662,7135,826,6355,433,471,378,648,8285,894,366,421,334,597,2612,0.140676632572777,0.84526558891455,0.893842887473461,0.883597883597884,0.921296296296296,0.315268557634279
E02004243,Alderholt & Sixpenny Handley,Dorset,South West,1134,3765,486,507,290,341,5389,1082,3992,474,518,324,375,5683,988,406,481,314,361,2550,0.24749498997996,0.856540084388186,0.928571428571429,0.969135802469136,0.962666666666667,0.448706669012845
E02004244,East Verwood,Dorset,South West,1210,4156,458,540,436,626,6216,1243,4559,479,545,452,701,6736,1259,423,510,433,680,3305,0.276157051985084,0.883089770354906,0.935779816513761,0.957964601769912,0.970042796005706,0.490647268408551
E02004245,West Verwood,Dorset,South West,1398,4257,475,549,411,619,6311,1305,4545,463,579,411,643,6641,1213,412,531,396,620,3172,0.266886688668867,0.889848812095032,0.917098445595855,0.963503649635036,0.964230171073095,0.477638909802741
E02004246,St Leonards,Dorset,South West,819,3478,723,884,624,826,6535,925,3963,704,922,668,913,7170,984,593,879,636,867,3959,0.248296744890235,0.842329545454545,0.953362255965293,0.952095808383234,0.949616648411829,0.552161785216179
E02004247,Sturminster Marshall & Crichel,Dorset,South West,990,3528,469,491,288,389,5165,972,3708,494,475,326,359,5362,950,437,441,314,347,2489,0.256202804746494,0.884615384615385,0.928421052631579,0.96319018404908,0.966573816155989,0.464192465497949
E02004248,West Moors,Dorset,South West,829,3547,651,868,638,1090,6794,783,3603,596,828,696,1143,6866,984,503,775,670,1085,4017,0.273105745212323,0.843959731543624,0.935990338164251,0.96264367816092,0.94925634295713,0.585056801631226
E02004249,Colehill,Dorset,South West,984,3131,409,510,295,372,4717,965,3444,409,507,339,419,5118,841,367,473,326,402,2409,0.244192799070848,0.897310513447433,0.932938856015779,0.96165191740413,0.959427207637231,0.470691676436108
E02004250,Ferndown Town,Dorset,South West,1096,3849,629,744,586,1056,6864,1066,4042,587,767,604,1124,7124,1070,459,718,576,1056,3879,0.264720435428006,0.781942078364566,0.936114732724902,0.95364238410596,0.939501779359431,0.54449747332959
E02004251,Ferndown West & Canford Bottom,Dorset,South West,1038,3499,446,557,377,625,5504,974,3665,431,560,427,620,5703,970,351,524,411,581,2837,0.264665757162347,0.814385150812065,0.935714285714286,0.962529274004684,0.937096774193548,0.497457478520077
E02004252,Wimborne Minster,Dorset,South West,1234,4230,491,496,422,800,6439,1176,4406,479,552,459,809,6705,1094,415,520,433,767,3229,0.248297775760327,0.866388308977036,0.942028985507246,0.943355119825708,0.948084054388134,0.481580909768829
E02004253,Parley & Hampreston,Dorset,South West,1294,4705,762,859,749,1272,8347,1294,5155,708,899,785,1355,8902,1235,608,848,754,1294,4739,0.239573229873909,0.858757062146893,0.943270300333704,0.960509554140127,0.954981549815498,0.53235228038643
E02004254,Corfe Mullen,Dorset,South West,1882,5898,666,699,489,585,8337,1759,6489,679,741,535,667,9111,1764,600,693,510,623,4190,0.271844660194175,0.883652430044183,0.935222672064777,0.953271028037383,0.934032983508246,0.45988365711777
E02004255,Gillingham,Dorset,South West,1152,4313,461,599,377,738,6488,1117,4433,483,571,444,758,6689,867,411,526,421,730,2955,0.195578614933454,0.850931677018634,0.921190893169877,0.948198198198198,0.963060686015831,0.441770070264614
E02004256,"Gillingham Outer, Bourton & Motcombe",Dorset,South West,1621,5151,664,655,452,627,7549,1593,5542,689,674,526,668,8099,1084,612,635,508,647,3486,0.195597257307831,0.888243831640058,0.94213649851632,0.965779467680608,0.968562874251497,0.430423509075195
E02004257,Shaftesbury,Dorset,South West,1728,5116,518,528,389,656,7207,1752,5492,516,553,422,695,7678,946,448,519,401,673,2987,0.17225054624909,0.868217054263566,0.938517179023508,0.950236966824644,0.968345323741007,0.389033602500651
E02004258,Sturminster Newton & Stalbridge,Dorset,South West,1478,5402,833,905,636,956,8732,1499,5838,814,906,682,1050,9290,1252,716,865,661,1018,4512,0.214457005823912,0.87960687960688,0.954746136865342,0.969208211143695,0.96952380952381,0.485683530678149
E02004259,Child Okeford & Iwerne Minster,Dorset,South West,1238,3895,588,606,408,521,6018,1128,4263,543,628,451,583,6468,740,458,592,442,570,2802,0.17358667604973,0.843462246777164,0.942675159235669,0.980044345898004,0.97770154373928,0.433209647495362
E02004260,Blandford Outer & Tarrants,Dorset,South West,1721,5377,557,576,393,437,7340,1697,5478,550,572,425,454,7479,1029,478,550,414,442,2913,0.187842278203724,0.869090909090909,0.961538461538461,0.974117647058824,0.973568281938326,0.389490573606097
E02004261,Blandford Forum Town,Dorset,South West,1874,6143,613,656,454,730,8596,1853,6224,645,694,466,768,8797,1438,524,659,448,745,3814,0.231041131105398,0.812403100775194,0.94956772334294,0.96137339055794,0.970052083333333,0.433556894395817
E02004262,"Milborne, Winterborne & Okeford Fitzpaine",Dorset,South West,1176,4593,666,662,442,437,6800,1176,5003,658,713,456,515,7345,903,590,679,441,498,3111,0.180491704977014,0.896656534954407,0.952314165497896,0.967105263157895,0.966990291262136,0.42355343771273
E02004263,Bere Regis & Lytchett Matravers,Dorset,South West,1041,3329,437,405,315,393,4879,1000,3528,428,459,336,397,5148,696,391,441,328,384,2240,0.197278911564626,0.913551401869159,0.96078431372549,0.976190476190476,0.967254408060453,0.435120435120435
E02004264,Upton & Lytchett Minster,Dorset,South West,1579,5038,522,581,424,557,7122,1538,5323,542,619,444,584,7512,1085,495,595,431,561,3167,0.203832425324065,0.913284132841328,0.961227786752827,0.970720720720721,0.960616438356164,0.421592119275825
E02004265,"Wareham, Sandford & Holton Heath",Dorset,South West,1425,4754,678,672,514,744,7362,1317,4902,639,742,561,796,7640,1213,598,711,552,769,3843,0.247450020399837,0.935837245696401,0.95822102425876,0.983957219251337,0.96608040201005,0.503010471204189
E02004266,"Bovington, Wool & Lulworth",Dorset,South West,1668,5308,517,565,374,434,7198,1546,5345,487,527,416,466,7241,1111,455,505,403,448,2922,0.207857811038354,0.93429158110883,0.958254269449715,0.96875,0.96137339055794,0.403535423284077
E02004267,Corfe Castle & Langton Matravers,Dorset,South West,599,2681,482,505,309,431,4408,630,2885,461,528,382,476,4732,649,415,503,367,463,2397,0.224956672443674,0.900216919739696,0.952651515151515,0.960732984293194,0.972689075630252,0.506551141166526
E02004268,Swanage,Dorset,South West,1222,5232,786,950,671,956,8595,1234,5394,792,911,733,1043,8873,1248,724,855,699,979,4505,0.231368186874305,0.914141414141414,0.938529088913282,0.953615279672578,0.938638542665388,0.50772004958864
E02004269,Sherborne,Dorset,South West,1785,4996,582,784,612,1135,8109,1678,5115,615,731,672,1143,8276,1224,485,689,650,1107,4155,0.239296187683284,0.788617886178862,0.942544459644323,0.967261904761905,0.968503937007874,0.502054132431126
E02004270,"Yetminster, Bradford Abbas & Longburton",Dorset,South West,1078,4071,674,686,527,643,6601,1279,4909,681,757,577,757,7681,1219,568,724,563,742,3816,0.248319413322469,0.834067547723936,0.956406869220608,0.975736568457539,0.980184940554822,0.496810311157401
E02004271,"Beaminster, Maiden Newton & Halstock",Dorset,South West,1363,5118,811,924,644,828,8325,1386,5659,855,944,725,915,9098,1202,776,896,703,887,4464,0.212405018554515,0.907602339181287,0.949152542372881,0.969655172413793,0.969398907103825,0.490657287315894
E02004272,"Charlton Down, Cerne Abbas & Puddletown",Dorset,South West,1928,6611,902,949,671,838,9971,1872,7228,871,973,760,886,10718,1646,793,915,729,850,4933,0.227725511898174,0.91044776119403,0.940390544707092,0.95921052631579,0.959367945823928,0.460253778690054
E02004273,"Lyme Regis, Charmouth & Marshwood Vale",Dorset,South West,870,3613,692,735,509,804,6353,887,3995,601,735,564,827,6722,879,524,711,536,779,3429,0.220025031289111,0.871880199667221,0.96734693877551,0.950354609929078,0.941958887545345,0.510116036893782
E02004274,Bridport North,Dorset,South West,1002,3487,550,555,375,580,5547,912,3616,540,579,420,590,5745,751,487,538,405,571,2752,0.207688053097345,0.901851851851852,0.929188255613126,0.964285714285714,0.967796610169492,0.479025239338555
E02004275,Burton Bradstock & Chideock,Dorset,South West,1058,3823,769,744,515,629,6480,1041,4182,778,731,532,658,6881,762,709,701,510,618,3300,0.182209469153515,0.911311053984576,0.958960328317373,0.958646616541353,0.939209726443769,0.479581456183694
E02004276,Bridport South & West Bay,Dorset,South West,651,2846,510,550,398,597,4901,637,3003,523,569,433,603,5131,637,468,538,418,577,2638,0.212121212121212,0.894837476099426,0.945518453427065,0.965357967667437,0.956882255389718,0.514129799259404
E02004277,Dorchester West & Poundbury,Dorset,South West,1901,7048,737,802,629,1348,10564,1879,7511,712,903,719,1406,11251,2080,632,848,687,1355,5602,0.276927173478898,0.887640449438202,0.939091915836102,0.955493741307371,0.963726884779516,0.49791129677362
E02004278,Dorchester East,Dorset,South West,1567,5061,623,599,464,659,7406,1504,5476,568,626,476,640,7786,1424,530,601,467,617,3639,0.260043827611395,0.933098591549296,0.960063897763578,0.98109243697479,0.9640625,0.467377343950681
E02004279,"Owermoigne, Broadmayne & Winterbourne",Dorset,South West,1160,4469,696,682,448,582,6877,1180,4737,660,706,495,578,7176,1087,597,671,479,562,3396,0.229470128773485,0.904545454545454,0.95042492917847,0.967676767676768,0.972318339100346,0.473244147157191
E02004280,Chickerell & Chesil Bank,Dorset,South West,1351,4575,641,622,448,593,6879,1299,4931,606,637,509,665,7348,1199,488,607,495,640,3429,0.243155546542284,0.805280528052805,0.952904238618524,0.972495088408644,0.962406015037594,0.466657593903103
E02004281,Broadwey & Littlemoor,Dorset,South West,1511,4560,419,432,254,308,5973,1448,4846,465,454,309,335,6409,1381,316,421,295,321,2734,0.284977300866694,0.679569892473118,0.927312775330396,0.954692556634304,0.958208955223881,0.42658761117179
E02004282,Preston & Lodmoor,Dorset,South West,1045,4279,871,928,649,1014,7741,1001,4571,786,947,729,1073,8106,1284,626,927,709,1039,4585,0.280901334500109,0.796437659033079,0.978880675818374,0.972565157750343,0.968313140726934,0.565630397236615
E02004283,Westham North & Radipole,Dorset,South West,1455,4932,583,654,476,651,7296,1538,5481,599,638,513,680,7911,1531,424,593,492,651,3691,0.279328589673417,0.707846410684474,0.929467084639498,0.95906432748538,0.957352941176471,0.466565541650866
E02004284,"Weymouth Town, Melcombe Regis & Rodwell",Dorset,South West,1338,5899,693,697,431,726,8446,1283,6542,737,725,526,733,9263,1679,513,640,479,690,4001,0.256649342708652,0.69606512890095,0.882758620689655,0.910646387832699,0.941336971350614,0.431933498866458
E02004285,Westham South,Dorset,South West,1160,4535,476,469,369,536,6385,1198,4904,468,499,350,521,6742,1353,310,469,331,496,2959,0.275897226753671,0.662393162393162,0.939879759519038,0.945714285714286,0.952015355086372,0.438890536932661
E02004286,Weymouth West,Dorset,South West,874,3091,328,358,197,359,4333,816,3166,342,365,224,346,4443,815,234,346,213,333,1941,0.257422615287429,0.68421052631579,0.947945205479452,0.950892857142857,0.96242774566474,0.436866981769075
E02004287,Wyke Regis,Dorset,South West,917,3219,393,464,269,309,4654,905,3392,385,454,289,357,4877,898,261,436,280,342,2217,0.264740566037736,0.677922077922078,0.960352422907489,0.968858131487889,0.957983193277311,0.454582735288087
E02004288,Underhill & The Grove,Dorset,South West,974,3960,368,327,177,237,5069,926,4292,350,337,220,231,5430,980,227,308,200,222,1937,0.228331780055918,0.648571428571429,0.913946587537092,0.909090909090909,0.961038961038961,0.356721915285451
E02004289,Southwell & Weston,Dorset,South West,1307,4166,534,549,352,360,5961,1213,4315,565,540,418,422,6260,1232,365,513,406,408,2924,0.285515643105446,0.646017699115044,0.95,0.971291866028708,0.966824644549763,0.467092651757189
E02004129,"Dunkesewell, Upottery & Stockland",East Devon,South West,894,3065,432,570,377,468,4912,895,3243,461,507,423,480,5114,708,406,492,406,466,2478,0.21831637372803,0.880694143167028,0.970414201183432,0.959810874704492,0.970833333333333,0.484552209620649
E02004130,Honiton North & East,East Devon,South West,929,3252,393,477,369,628,5119,889,3335,384,481,402,682,5284,826,316,451,387,657,2637,0.247676161919041,0.822916666666667,0.937629937629938,0.962686567164179,0.963343108504399,0.499053747161242
E02004131,Honiton South & West,East Devon,South West,881,3138,359,387,278,458,4620,827,3189,351,391,299,500,4730,769,299,371,292,480,2211,0.241141423643776,0.851851851851852,0.948849104859335,0.976588628762542,0.96,0.467441860465116
E02004132,Feniton & Whimple,East Devon,South West,1567,4887,673,667,414,552,7193,1501,5203,653,656,483,542,7537,1182,585,627,459,520,3373,0.227176628867961,0.895865237366003,0.955792682926829,0.950310559006211,0.959409594095941,0.447525540666048
E02004133,Axminster,East Devon,South West,1469,5064,702,756,558,770,7850,1556,5549,684,785,635,818,8471,1341,600,740,610,784,4075,0.241665164894576,0.87719298245614,0.942675159235669,0.960629921259842,0.958435207823961,0.481053004367843
E02004134,"Cranbrook, Broadclyst & Stoke Canon",East Devon,South West,3305,8219,535,531,378,494,10157,3724,9719,600,544,387,561,11811,2084,460,524,374,544,3986,0.214425352402511,0.766666666666667,0.963235294117647,0.96640826873385,0.96969696969697,0.33748200829735
E02004135,"Kilmington, Colyton & Uplyme",East Devon,South West,1160,4172,767,832,593,826,7190,1045,4350,736,811,657,864,7418,944,663,783,637,829,3856,0.217011494252874,0.900815217391304,0.965474722564735,0.969558599695586,0.959490740740741,0.519816662173093
E02004136,Ottery St Mary & West Hill,East Devon,South West,1678,4688,640,686,484,731,7229,1682,5300,609,734,525,810,7978,1411,574,717,512,794,4008,0.26622641509434,0.942528735632184,0.976839237057221,0.975238095238095,0.980246913580247,0.502381549260466
E02004137,"Sidbury, Offwell & Beer",East Devon,South West,703,2697,501,556,405,533,4692,663,2821,476,570,442,567,4876,604,420,542,421,534,2521,0.214108472172988,0.882352941176471,0.950877192982456,0.952488687782805,0.941798941798942,0.517022149302707
E02004138,Seaton,East Devon,South West,801,3337,690,883,698,1126,6734,788,3578,645,895,725,1173,7016,992,534,858,691,1125,4200,0.277249860257127,0.827906976744186,0.958659217877095,0.953103448275862,0.959079283887468,0.598631698973774
E02004139,Sidmouth Sidford,East Devon,South West,1089,3459,529,633,531,790,5942,996,3605,484,625,573,776,6063,1042,450,600,558,745,3395,0.289042995839112,0.929752066115702,0.96,0.973821989528796,0.960051546391753,0.559953818241795
E02004140,Sidmouth Town,East Devon,South West,443,2189,500,590,449,1067,4795,391,2243,471,604,506,1089,4913,541,425,572,489,1039,3066,0.241194828354882,0.902335456475584,0.947019867549669,0.966403162055336,0.954086317722681,0.624058619987788
E02004141,"Poppleford, Otterton & Woodbury",East Devon,South West,967,3409,474,482,340,480,5185,962,3598,482,514,374,506,5474,856,440,496,362,494,2648,0.237909949972207,0.912863070539419,0.964980544747082,0.967914438502674,0.976284584980237,0.483741322616003
E02004142,"Clyst, Exton & Lympstone",East Devon,South West,987,4206,466,449,294,433,5848,900,4604,432,439,339,447,6261,777,389,416,329,435,2346,0.16876629018245,0.900462962962963,0.947608200455581,0.970501474926254,0.973154362416107,0.374700527072353
E02004143,Exmouth Brixington,East Devon,South West,1029,3571,474,531,401,470,5447,990,3598,444,517,412,522,5493,916,418,496,401,499,2730,0.254585881045025,0.941441441441441,0.959381044487427,0.973300970873786,0.955938697318008,0.496996176952485
E02004144,Exmouth Halsdon,East Devon,South West,1137,3678,540,567,397,617,5799,1076,3797,547,572,488,594,5998,936,507,549,473,583,3048,0.246510402949697,0.926873857404022,0.95979020979021,0.969262295081967,0.981481481481481,0.508169389796599
E02004145,Budleigh Salterton,East Devon,South West,773,2714,605,711,541,874,5445,694,2840,574,671,586,910,5581,763,530,638,564,884,3379,0.268661971830986,0.923344947735192,0.950819672131147,0.962457337883959,0.971428571428571,0.605447052499552
E02004146,Exmouth Withycombe Raleigh,East Devon,South West,1426,4387,467,442,280,412,5988,1465,4670,458,496,324,411,6359,1222,412,477,314,399,2824,0.261670235546039,0.899563318777293,0.961693548387097,0.969135802469136,0.970802919708029,0.44409498348797
E02004147,Exmouth Town,East Devon,South West,1182,4783,411,429,221,361,6205,1081,4901,409,434,253,367,6364,1092,356,397,239,343,2427,0.222811671087533,0.87041564792176,0.914746543778802,0.944664031620553,0.934604904632153,0.381363922061597
E02004148,Exmouth Littleham,East Devon,South West,964,3570,538,740,580,1122,6550,966,3959,574,741,650,1197,7121,1011,519,708,622,1157,4017,0.25536751704976,0.90418118466899,0.955465587044534,0.956923076923077,0.966583124477861,0.564106164864485
E02004149,Pennsylvania & University,Exeter,South West,888,9130,429,447,281,455,10742,962,13190,433,468,328,443,14862,918,365,448,306,416,2453,0.0695981804397271,0.842956120092379,0.957264957264957,0.932926829268293,0.939051918735892,0.165051809985197
E02004150,Mincinglake & Beacon Heath,Exeter,South West,1346,4824,270,212,160,207,5673,1264,4918,309,269,211,274,5981,1023,225,242,201,261,1952,0.208011386742578,0.728155339805825,0.899628252788104,0.95260663507109,0.952554744525547,0.326366828289584
E02004151,Pinhoe & Whipton North,Exeter,South West,1864,5592,474,451,330,657,7504,1985,6338,479,496,397,644,8354,1496,352,465,379,623,3315,0.236036604607132,0.734864300626305,0.9375,0.954659949622166,0.967391304347826,0.39681589657649
E02004152,St James's Park & Hoopern,Exeter,South West,572,8155,193,190,141,334,9013,573,7737,209,182,161,194,8483,655,150,155,145,177,1282,0.0846581362285123,0.717703349282297,0.851648351648352,0.900621118012422,0.912371134020619,0.151125780973712
E02004153,Exwick & Foxhayes,Exeter,South West,1554,4956,314,333,213,195,6011,1466,5184,351,344,244,241,6364,1003,302,331,237,238,2111,0.193479938271605,0.86039886039886,0.962209302325581,0.971311475409836,0.987551867219917,0.331709616593338
E02004154,Heavitree West & Polsloe,Exeter,South West,1296,6253,225,248,201,315,7242,1199,6103,262,266,179,337,7147,1350,200,239,159,320,2268,0.221202687203015,0.763358778625954,0.898496240601504,0.888268156424581,0.949554896142433,0.317335945151812
E02004155,Heavitree East & Whipton South,Exeter,South West,1454,4534,424,399,272,458,6087,1502,4893,451,415,290,429,6478,1293,367,389,272,410,2731,0.264255058246475,0.813747228381375,0.937349397590361,0.937931034482759,0.955710955710956,0.42158073479469
E02004156,Central Exeter,Exeter,South West,987,9906,360,304,205,326,11101,909,11022,352,354,247,383,12358,1083,257,319,217,356,2232,0.0982580293957539,0.730113636363636,0.901129943502825,0.878542510121458,0.929503916449086,0.180611749474025
E02004157,St Leonard's,Exeter,South West,1030,4457,298,296,211,428,5690,1021,5094,316,294,227,376,6307,1237,252,276,215,354,2334,0.242834707499018,0.79746835443038,0.938775510204082,0.947136563876652,0.941489361702128,0.370065007134929
E02004158,St Thomas East,Exeter,South West,1501,5532,290,306,213,341,6682,1426,5924,330,325,209,340,7128,1124,288,308,199,329,2248,0.189736664415935,0.872727272727273,0.947692307692308,0.952153110047847,0.967647058823529,0.315375982042649
E02004159,Middlemoor & Sowton,Exeter,South West,2558,8065,557,559,373,438,9992,2470,8064,569,607,415,499,10154,1980,474,584,401,479,3918,0.245535714285714,0.833040421792619,0.962108731466227,0.966265060240964,0.959919839679359,0.385857790033484
E02004160,St Thomas West,Exeter,South West,1316,4234,399,407,331,588,5959,1258,4464,402,447,350,609,6272,1012,360,425,342,590,2729,0.226702508960573,0.895522388059702,0.950782997762864,0.977142857142857,0.9688013136289,0.435108418367347
E02004161,Wonford & St Loye's,Exeter,South West,1558,5386,304,327,248,464,6729,1724,6036,361,358,291,495,7541,1519,280,332,272,478,2881,0.251656726308814,0.775623268698061,0.927374301675978,0.934707903780069,0.965656565656566,0.382044821641692
E02004162,Alphington & Marsh Barton,Exeter,South West,1162,4697,368,341,300,474,6180,1010,4518,379,367,317,520,6101,954,270,349,305,499,2377,0.211155378486056,0.712401055408971,0.950953678474115,0.962145110410095,0.959615384615385,0.389608260940829
E02004163,Countess Wear & Topsham,Exeter,South West,1342,4207,519,567,417,662,6372,1388,4845,550,611,458,684,7148,1136,416,580,442,673,3247,0.234468524251806,0.756363636363636,0.949263502454992,0.965065502183406,0.983918128654971,0.454252937884723
E02004164,"Bampton, Holcombe & Westleigh",Mid Devon,South West,1098,3824,525,560,354,484,5747,1021,3947,524,575,404,521,5971,819,383,537,379,500,2618,0.20749936660755,0.730916030534351,0.933913043478261,0.938118811881188,0.959692898272553,0.438452520515827
E02004165,Tiverton North & Outer,Mid Devon,South West,1467,4833,588,633,516,650,7220,1391,5139,549,625,509,742,7564,1072,372,591,487,708,3230,0.208600895115781,0.677595628415301,0.9456,0.956777996070727,0.954177897574124,0.42702273929138
E02004166,Uffculme & Hemyock,Mid Devon,South West,1309,3884,455,474,313,404,5530,1242,3999,438,483,360,415,5695,960,374,458,354,401,2547,0.240060015003751,0.853881278538813,0.94824016563147,0.983333333333333,0.966265060240964,0.447234416154522
E02004167,Tiverton East,Mid Devon,South West,1647,4501,335,320,253,383,5792,1582,4702,373,348,292,411,6126,899,231,319,283,390,2122,0.191195236069758,0.619302949061662,0.916666666666667,0.969178082191781,0.948905109489051,0.346392425726412
E02004168,Tiverton West,Mid Devon,South West,1201,3753,397,333,252,373,5108,1247,4050,350,375,269,383,5427,817,198,343,249,361,1968,0.201728395061728,0.565714285714286,0.914666666666667,0.925650557620818,0.942558746736293,0.362631288004422
E02004169,"Willand, Sampford Peverell & Halberton",Mid Devon,South West,1344,4301,445,446,324,460,5976,1388,4671,459,475,360,494,6459,895,322,454,342,473,2486,0.191607792763862,0.701525054466231,0.95578947368421,0.95,0.95748987854251,0.384889301749497
E02004170,Cullompton,Mid Devon,South West,1705,5352,500,453,321,464,7090,1677,5675,481,469,364,467,7456,1167,374,456,348,451,2796,0.205638766519824,0.777546777546778,0.97228144989339,0.956043956043956,0.965738758029979,0.375
E02004171,"Bradninch, Silverton & Thorverton",Mid Devon,South West,1551,4829,562,552,368,500,6811,1543,5229,577,561,433,509,7309,1058,469,534,421,494,2976,0.202333142092178,0.812824956672444,0.951871657754011,0.972286374133949,0.970530451866405,0.40716924339855
E02004172,"Bow, Lapford & Yeoford",Mid Devon,South West,1055,3659,503,492,298,363,5315,1052,3919,496,503,347,394,5659,871,369,489,337,386,2452,0.222250574126053,0.743951612903226,0.972166998011928,0.971181556195966,0.979695431472081,0.433292101077929
E02004173,"Morchard Bishop, Copplestone & Newton St Cyres",Mid Devon,South West,1278,4243,593,528,342,436,6142,1239,4501,577,565,372,500,6515,878,476,542,358,472,2726,0.195067762719396,0.824956672443674,0.95929203539823,0.96236559139785,0.944,0.418419033000767
E02004174,Crediton,Mid Devon,South West,1487,4607,455,483,342,551,6438,1506,4882,454,505,374,558,6773,926,373,485,364,543,2691,0.189676362146661,0.8215859030837,0.96039603960396,0.973262032085561,0.973118279569892,0.397312859884837
E02004175,Ilfracombe East,North Devon,South West,930,3190,361,360,221,321,4453,914,3619,376,344,276,349,4964,876,290,320,247,334,2067,0.242055816523902,0.771276595744681,0.930232558139535,0.894927536231884,0.95702005730659,0.416398066075745
E02004176,Lynton & Combe Martin,North Devon,South West,711,3001,528,478,345,420,4772,812,3514,510,539,369,411,5343,681,429,506,344,387,2347,0.19379624359704,0.841176470588235,0.938775510204082,0.932249322493225,0.941605839416058,0.439266329777279
E02004177,Ilfracombe West,North Devon,South West,1000,3454,410,414,257,368,4903,1023,3805,413,467,289,382,5356,916,334,429,272,359,2310,0.240735873850197,0.808716707021792,0.918629550321199,0.941176470588235,0.93979057591623,0.431292008961912
E02004178,"Woolacombe, Georgeham & Croyde",North Devon,South West,918,3015,394,422,271,371,4473,914,3308,375,444,329,371,4827,654,318,425,319,358,2074,0.19770253929867,0.848,0.957207207207207,0.969604863221885,0.964959568733154,0.429666459498653
E02004179,Braunton,North Devon,South West,1780,5390,496,611,469,690,7656,1749,5635,477,593,505,753,7963,1228,385,573,494,728,3408,0.217923691215617,0.807127882599581,0.966273187183811,0.978217821782178,0.966799468791501,0.427979404746955
E02004180,"Bratton Fleming, Goodleigh & Kings Heanton",North Devon,South West,1092,3487,469,430,294,378,5058,1065,3874,471,475,384,443,5647,1005,287,458,374,431,2555,0.259421786267424,0.609341825902336,0.964210526315789,0.973958333333333,0.972911963882618,0.452452629714893
E02004181,Barnstaple Pilton,North Devon,South West,1021,3434,331,364,256,424,4809,1016,3639,336,384,259,421,5039,1065,209,361,246,400,2281,0.292662819455894,0.62202380952381,0.940104166666667,0.94980694980695,0.950118764845606,0.452669180392935
E02004182,Barnstaple Central,North Devon,South West,1235,3829,306,344,239,390,5108,1144,4250,337,326,263,397,5573,1071,173,289,243,377,2153,0.252,0.513353115727003,0.886503067484663,0.923954372623574,0.949622166246851,0.386326933429033
E02004183,Barnstaple Sticklepath,North Devon,South West,877,3267,359,505,349,538,5018,845,3577,365,465,411,544,5362,897,213,436,395,534,2475,0.250768800670953,0.583561643835617,0.937634408602151,0.961070559610706,0.981617647058824,0.461581499440507
E02004184,Barnstaple South,North Devon,South West,1907,5502,371,444,283,384,6984,1781,5742,409,444,275,387,7257,1500,237,420,255,375,2787,0.26123301985371,0.579462102689487,0.945945945945946,0.927272727272727,0.968992248062015,0.384042992972303
E02004185,Fremington & Instow,North Devon,South West,1030,3228,464,606,402,667,5367,989,3580,468,568,522,669,5807,1002,323,538,507,649,3019,0.279888268156425,0.69017094017094,0.947183098591549,0.971264367816092,0.970104633781764,0.519889788186671
E02004186,Roundswell & Landkey,North Devon,South West,1751,5409,539,573,466,508,7495,1878,6156,586,611,487,610,8450,1591,378,573,478,592,3612,0.258447043534763,0.645051194539249,0.937806873977087,0.981519507186858,0.970491803278689,0.427455621301775
E02004187,South Molton,North Devon,South West,1645,5722,648,724,510,722,8326,1786,6226,751,802,580,794,9153,1397,630,763,558,759,4107,0.224381625441696,0.838881491344874,0.951371571072319,0.962068965517241,0.955919395465995,0.448705342510652
E02004188,"Bishop's Nympton, Witheridge & Chulmleigh",North Devon,South West,980,3800,525,587,416,518,5846,993,4022,564,576,467,588,6217,764,451,548,448,570,2781,0.189955246146196,0.799645390070922,0.951388888888889,0.9593147751606,0.969387755102041,0.447321859417726
E02004189,Woolwell & Lee Mill,South Hams,South West,945,3946,379,346,224,295,5190,985,3876,410,373,248,322,5229,906,366,355,241,310,2178,0.23374613003096,0.892682926829268,0.951742627345844,0.971774193548387,0.962732919254658,0.416523235800344
E02004190,South Brent & Cornwood,South Hams,South West,1355,4751,618,633,395,565,6962,1346,5308,628,699,442,555,7632,1116,532,671,424,530,3273,0.21024868123587,0.847133757961784,0.959942775393419,0.959276018099547,0.954954954954955,0.428852201257862
E02004191,Totnes Town,South Hams,South West,1388,5117,683,598,454,604,7456,1388,5954,653,658,502,645,8412,1323,467,576,453,607,3426,0.222203560631508,0.715160796324656,0.875379939209726,0.902390438247012,0.94108527131783,0.407275320970043
E02004192,"Marldon, Stoke Gabriel & Kingswear",South Hams,South West,1073,3996,709,719,425,571,6420,1077,4246,673,742,511,580,6752,1017,512,675,484,543,3231,0.239519547809703,0.760772659732541,0.909703504043127,0.947162426614481,0.936206896551724,0.478524881516588
E02004193,Ivybridge,South Hams,South West,2224,7090,672,678,468,625,9533,2136,7390,694,722,520,658,9984,1755,618,686,495,623,4177,0.237483085250338,0.890489913544669,0.950138504155125,0.951923076923077,0.946808510638298,0.418369391025641
E02004194,Loddiswell & Dartington,South Hams,South West,1302,4072,549,525,303,475,5924,1367,4560,579,542,354,467,6502,886,435,493,340,448,2602,0.194298245614035,0.751295336787565,0.909594095940959,0.96045197740113,0.9593147751606,0.400184558597355
E02004195,Dartmouth,South Hams,South West,671,3088,433,488,336,411,4756,648,3395,435,447,347,472,5096,497,359,411,327,454,2048,0.14639175257732,0.825287356321839,0.919463087248322,0.942363112391931,0.961864406779661,0.401883830455259
E02004196,"Yealmpton, Modbury & Aveton Gifford",South Hams,South West,1316,4163,637,705,359,526,6390,1375,4552,609,713,461,570,6905,1079,543,683,439,545,3289,0.237038664323374,0.891625615763547,0.957924263674614,0.952277657266811,0.956140350877193,0.47632150615496
E02004197,"Wembury, Brixton & Newton Ferrers",South Hams,South West,967,3487,572,641,500,607,5807,995,3817,547,610,523,646,6143,1054,508,594,510,626,3292,0.276133088813204,0.928702010968921,0.973770491803279,0.975143403441683,0.969040247678019,0.535894514081068
E02004198,Kingsbridge,South Hams,South West,1058,3598,430,483,331,596,5438,962,3717,419,468,373,594,5571,715,345,436,352,579,2427,0.192359429647565,0.823389021479714,0.931623931623932,0.943699731903485,0.974747474747475,0.435648896068928
E02004199,"Chillington, Torcross & Stoke Fleming",South Hams,South West,776,2722,548,644,424,550,4888,738,2973,509,647,444,631,5204,534,403,605,435,606,2583,0.179616548940464,0.791748526522593,0.935085007727975,0.97972972972973,0.960380348652932,0.496348962336664
E02004200,"Salcombe, Malborough & Thurlestone",South Hams,South West,653,2662,479,525,381,465,4512,650,2866,443,483,376,496,4664,543,377,462,361,483,2226,0.189462665736218,0.851015801354402,0.956521739130435,0.960106382978723,0.973790322580645,0.477272727272727
E02004201,"Tedburn, Shillingford & Higher Ashton",Teignbridge,South West,788,2865,482,463,367,418,4595,771,3046,488,487,402,456,4879,736,396,470,388,443,2433,0.241628365068943,0.811475409836066,0.965092402464066,0.965174129353234,0.971491228070175,0.498667759786842
E02004202,Starcross & Exminster,Teignbridge,South West,1509,5113,562,569,372,515,7131,1564,5393,565,590,450,547,7545,1192,422,562,439,535,3150,0.221027257556091,0.746902654867257,0.952542372881356,0.975555555555555,0.978062157221207,0.417495029821074
E02004203,"Moretonhampstead, Lustleigh & East Dartmoor",Teignbridge,South West,772,3278,523,508,318,485,5112,813,3436,493,570,343,494,5336,809,419,544,330,477,2579,0.235448195576251,0.849898580121704,0.954385964912281,0.962099125364432,0.965587044534413,0.48332083958021
E02004204,Chudleigh & Bovey Tracey,Teignbridge,South West,1720,5491,684,670,496,694,8035,1700,5906,692,673,575,709,8555,1354,629,634,552,684,3853,0.229258381307145,0.908959537572254,0.942050520059435,0.96,0.964739069111425,0.450379894798364
E02004205,Dawlish North,Teignbridge,South West,1438,4832,676,683,370,500,7061,1422,5217,742,684,505,542,7690,1481,493,649,483,524,3630,0.283879624305156,0.664420485175202,0.948830409356725,0.956435643564356,0.966789667896679,0.472041612483745
E02004206,Dawlish South,Teignbridge,South West,810,3501,566,649,470,714,5900,745,3748,573,628,530,750,6229,1062,381,596,506,724,3269,0.283351120597652,0.664921465968586,0.949044585987261,0.954716981132075,0.965333333333333,0.524803339219779
E02004207,Heathfield & Liverton,Teignbridge,South West,1090,3614,453,471,348,475,5361,1065,3949,447,473,412,488,5769,874,400,452,394,465,2585,0.221321853633831,0.894854586129754,0.955602536997886,0.956310679611651,0.952868852459016,0.448084590050269
E02004208,Teignmouth North,Teignbridge,South West,1306,4562,717,787,452,644,7162,1227,4667,663,793,536,641,7300,1036,456,753,521,615,3381,0.221984143989715,0.687782805429864,0.949558638083228,0.972014925373134,0.959438377535101,0.463150684931507
E02004209,Kingsteignton,Teignbridge,South West,1563,5328,475,550,429,562,7344,1628,5702,482,557,460,611,7812,1222,419,528,437,564,3170,0.214310768151526,0.869294605809129,0.947935368043088,0.95,0.923076923076923,0.405785970302099
E02004210,Teignmouth South,Teignbridge,South West,1013,3957,441,445,313,639,5795,1056,4144,463,451,344,612,6014,991,250,418,325,574,2558,0.239140926640927,0.539956803455724,0.926829268292683,0.944767441860465,0.937908496732026,0.425340871300299
E02004211,Bishopsteignton & Shaldon,Teignbridge,South West,881,3342,655,724,433,663,5817,842,3491,638,735,474,723,6061,808,479,694,452,698,3131,0.231452305929533,0.750783699059561,0.94421768707483,0.953586497890295,0.965421853388658,0.516581422207557
E02004212,"Newton Abbot, Highweek",Teignbridge,South West,1078,3770,375,398,228,301,5072,1059,3782,358,392,250,370,5152,926,315,374,237,354,2206,0.244843997884717,0.879888268156425,0.954081632653061,0.948,0.956756756756757,0.428183229813665
E02004213,"Ogwell, Mile End & Teigngrace",Teignbridge,South West,1649,5282,429,393,257,378,6739,1751,5824,471,431,277,374,7377,1308,418,410,261,363,2760,0.224587912087912,0.887473460721868,0.951276102088167,0.942238267148014,0.970588235294118,0.374135827572184
E02004214,"Newton Abbot, Town Centre",Teignbridge,South West,1158,3956,296,316,212,317,5097,1041,3991,301,316,258,311,5177,895,232,281,241,297,1946,0.224254572788775,0.770764119601329,0.889240506329114,0.934108527131783,0.954983922829582,0.37589337454124
E02004215,"Newton Abbot, Broadlands & Wolborough",Teignbridge,South West,922,3482,344,364,210,446,4846,936,3875,359,362,261,499,5356,903,307,338,247,475,2270,0.233032258064516,0.855153203342618,0.933701657458563,0.946360153256705,0.95190380761523,0.423823749066468
E02004216,"Newton Abbot, Milber & Buckland",Teignbridge,South West,890,3198,414,403,291,407,4713,867,3376,406,399,338,438,4957,816,371,379,323,414,2303,0.241706161137441,0.913793103448276,0.949874686716792,0.955621301775148,0.945205479452055,0.464595521484769
E02004217,Ashburton & Buckfastleigh,Teignbridge,South West,1413,4621,566,550,392,493,6622,1334,4830,553,566,442,514,6905,1049,457,518,425,491,2940,0.217184265010352,0.826401446654611,0.915194346289753,0.961538461538461,0.955252918287938,0.425778421433744
E02004218,Kingskerswell,Teignbridge,South West,921,3498,459,498,314,455,5224,967,3645,442,502,372,460,5421,970,394,475,363,444,2646,0.266117969821674,0.891402714932127,0.946215139442231,0.975806451612903,0.965217391304348,0.488101826231323
E02004219,Ipplepen & Broadhempston,Teignbridge,South West,825,3040,420,473,357,501,4791,813,3268,425,472,424,506,5095,792,393,452,413,486,2536,0.24235006119951,0.924705882352941,0.957627118644068,0.974056603773585,0.960474308300395,0.497742885181551
E02004220,Appledore & Northam North,Torridge,South West,817,3240,551,542,426,522,5281,787,3363,523,575,470,559,5490,902,395,540,458,529,2824,0.268212905144217,0.755258126195029,0.939130434782609,0.974468085106383,0.946332737030411,0.514389799635701
E02004221,Westward Ho! & Northam South,Torridge,South West,726,3107,613,669,488,778,5655,763,3292,529,667,518,744,5750,872,407,624,500,721,3124,0.264884568651276,0.76937618147448,0.935532233883059,0.965250965250965,0.969086021505376,0.543304347826087
E02004222,Bideford North,Torridge,South West,993,3635,396,374,220,341,4966,952,3937,377,411,277,350,5352,938,258,383,254,330,2163,0.238252476504953,0.684350132625995,0.931873479318735,0.916967509025271,0.942857142857143,0.40414798206278
E02004223,Bideford South & East,Torridge,South West,2727,7622,758,706,448,553,10087,2715,8131,754,759,520,598,10762,2248,484,713,497,559,4501,0.276472758578281,0.641909814323607,0.939393939393939,0.955769230769231,0.934782608695652,0.418230812116707
E02004224,Hartland Coast,Torridge,South West,915,3606,556,593,365,473,5593,886,3628,554,575,417,528,5702,774,362,547,398,509,2590,0.213340683572216,0.653429602888087,0.951304347826087,0.954436450839328,0.964015151515152,0.454226587162399
E02004225,Great Torrington,Torridge,South West,1092,3465,365,379,272,407,4888,1017,3526,357,415,293,455,5046,844,226,393,287,440,2190,0.239364719228588,0.633053221288515,0.946987951807229,0.979522184300341,0.967032967032967,0.434007134363853
E02004226,Winkleigh & High Bickington,Torridge,South West,988,4029,667,641,456,531,6324,1024,4152,675,651,492,575,6545,837,468,613,473,556,2947,0.201589595375723,0.693333333333333,0.941628264208909,0.961382113821138,0.96695652173913,0.450267379679144
E02004227,"Holsworthy, Bradworthy & Welcombe",Torridge,South West,1656,5712,832,773,503,657,8477,1639,5919,760,811,561,678,8729,1376,633,771,538,642,3960,0.232471701300895,0.832894736842105,0.950678175092478,0.959001782531194,0.946902654867257,0.453660213082827
E02004228,"Shebbear, Cookworthy & Broadheath",Torridge,South West,1008,3995,629,594,402,454,6074,1024,4357,630,670,494,526,6677,982,506,634,471,483,3076,0.22538443883406,0.803174603174603,0.946268656716418,0.953441295546559,0.918250950570342,0.460685936797963
E02004229,"Hatherleigh, Exbourne & North Tawton",West Devon,South West,1674,5574,645,671,469,614,7973,1680,5773,652,674,513,659,8271,1568,530,640,491,622,3851,0.271609215312662,0.812883435582822,0.949554896142433,0.957115009746589,0.943854324734446,0.465602708257768
E02004230,Okehampton,West Devon,South West,1371,4373,460,485,366,554,6238,1300,4681,460,514,425,575,6655,1423,420,489,399,554,3285,0.303994872890408,0.91304347826087,0.95136186770428,0.938823529411765,0.963478260869565,0.493613824192337
E02004231,"Chagford, Princetown & Dartmoor",West Devon,South West,957,4080,549,558,386,415,5988,950,4351,553,555,411,471,6341,1161,461,524,383,450,2979,0.266835210296484,0.833634719710669,0.944144144144144,0.931873479318735,0.955414012738854,0.469799716133102
E02004232,"Lifton, Lamerton & Bridestowe",West Devon,South West,1013,3779,557,543,322,434,5635,967,3970,569,555,402,477,5973,911,514,512,383,454,2774,0.229471032745592,0.903339191564148,0.922522522522523,0.95273631840796,0.951781970649895,0.464423237903901
E02004233,Tavistock,West Devon,South West,2135,6839,883,995,667,1026,10410,1966,7162,904,990,786,1126,10968,1955,836,944,763,1098,5596,0.272968444568556,0.924778761061947,0.953535353535354,0.970737913486005,0.975133214920071,0.510211524434719
E02004234,Horrabridge & Mary Tavy,West Devon,South West,843,3259,518,580,357,511,5225,857,3390,551,571,427,520,5459,1001,476,550,407,502,2936,0.295280235988201,0.863883847549909,0.96322241681261,0.953161592505855,0.965384615384615,0.537827440923246
E02004235,"Bere Alston, Buckland Monachorum & Yelverton",West Devon,South West,896,3394,531,596,394,523,5438,934,3645,503,622,443,554,5767,1076,432,604,426,529,3067,0.29519890260631,0.858846918489066,0.971061093247588,0.961625282167043,0.954873646209386,0.531818970001734
E02004600,Swindon Village & Wyman's Brook,Cheltenham,South West,979,3376,325,312,228,227,4468,1009,3728,348,327,219,269,4891,918,304,309,210,255,1996,0.246244635193133,0.873563218390805,0.944954128440367,0.958904109589041,0.947955390334572,0.408096503782458
E02004601,Prestbury & Racecourse,Cheltenham,South West,834,2787,400,480,332,544,4543,908,3182,398,455,357,575,4967,720,380,438,352,562,2452,0.226272784412319,0.954773869346734,0.962637362637363,0.985994397759104,0.977391304347826,0.493658143748742
E02004602,Springbank,Cheltenham,South West,1398,3872,322,288,215,297,4994,1477,4652,312,296,216,296,5772,1082,272,280,206,282,2122,0.232588134135856,0.871794871794872,0.945945945945946,0.953703703703704,0.952702702702703,0.367636867636868
E02004603,St Paul's,Cheltenham,South West,1166,6189,260,277,114,259,7099,1162,6634,286,270,194,261,7645,1007,226,243,183,225,1884,0.151793789568888,0.79020979020979,0.9,0.943298969072165,0.862068965517241,0.24643557880968
E02004604,Arle & Hesters Way,Cheltenham,South West,1939,5080,337,247,212,299,6175,1989,5759,351,238,199,303,6850,1358,306,215,190,278,2347,0.235804827226949,0.871794871794872,0.903361344537815,0.954773869346734,0.917491749174918,0.342627737226277
E02004605,Oakley,Cheltenham,South West,1223,3458,275,253,203,203,4392,1327,3932,295,243,202,226,4898,972,260,223,191,211,1857,0.247202441505595,0.88135593220339,0.917695473251029,0.945544554455445,0.933628318584071,0.379134340547162
E02004606,Alstone & St Mark's,Cheltenham,South West,1719,6884,405,358,215,486,8348,1815,7831,405,390,257,534,9417,1606,344,354,243,499,3046,0.205082364959775,0.849382716049383,0.907692307692308,0.945525291828794,0.934456928838951,0.323457576722948
E02004607,Pittville & Fairview,Cheltenham,South West,1231,6635,468,407,270,447,8227,1219,7128,461,477,313,478,8857,1377,405,421,291,433,2927,0.193181818181818,0.878524945770065,0.882599580712788,0.929712460063898,0.905857740585774,0.330473072146325
E02004608,Lansdown & Montpellier,Cheltenham,South West,1272,7073,467,468,290,720,9018,1414,7597,447,465,375,658,9542,1280,376,421,347,615,3039,0.168487560879294,0.841163310961969,0.905376344086022,0.925333333333333,0.934650455927052,0.318486690421295
E02004609,Benhall & The Reddings,Cheltenham,South West,1236,4215,352,420,358,431,5776,1276,4593,371,400,357,521,6242,1031,345,384,349,500,2609,0.224472022643153,0.929919137466307,0.96,0.977591036414566,0.959692898272553,0.417975008010253
E02004610,The Park & Warden Hill,Cheltenham,South West,1175,4547,438,501,382,681,6549,1082,5192,402,539,404,710,7247,948,367,514,391,688,2908,0.182588597842835,0.912935323383085,0.953617810760668,0.967821782178218,0.969014084507042,0.401269490823789
E02004611,Battledown & Charlton Kings,Cheltenham,South West,2553,6784,540,562,386,674,8946,2597,7636,545,543,426,721,9871,1648,497,527,404,699,3775,0.215819800942902,0.911926605504587,0.970534069981584,0.948356807511737,0.969486823855756,0.382433390740553
E02004612,Hatherley,Cheltenham,South West,1590,5340,513,527,444,687,7511,1634,5784,519,545,447,688,7983,1329,486,524,438,662,3439,0.229771784232365,0.936416184971098,0.961467889908257,0.979865771812081,0.962209302325581,0.430790429663034
E02004613,Charlton Park,Cheltenham,South West,1235,3535,414,441,334,511,5235,1206,3951,421,402,362,550,5686,994,400,390,352,540,2676,0.251581878005568,0.950118764845606,0.970149253731343,0.972375690607735,0.981818181818182,0.470629616602181
E02004614,Leckhampton,Cheltenham,South West,1085,2986,327,349,220,508,4390,1124,3351,350,374,238,489,4802,778,335,363,231,478,2185,0.232169501641301,0.957142857142857,0.970588235294118,0.970588235294118,0.977505112474438,0.455018742190754
E02004615,"Willersley, Chipping Campden & Blockley",Cotswold,South West,1259,4471,681,675,583,809,7219,1219,4919,713,699,609,808,7748,914,655,661,592,775,3597,0.185810124008945,0.918653576437588,0.945636623748212,0.972085385878489,0.959158415841584,0.464248838409912
E02004616,Moreton & Stow-on-the-Wold,Cotswold,South West,1439,5346,685,707,573,901,8212,1475,5851,682,721,598,925,8777,1260,619,684,575,900,4038,0.215347803794223,0.907624633431085,0.948682385575589,0.961538461538461,0.972972972972973,0.460066081804717
E02004617,Bourton-on-the-Water & Vale,Cotswold,South West,1673,5231,591,631,458,622,7533,1729,5805,582,618,513,642,8160,1213,529,595,493,615,3445,0.208957795004307,0.90893470790378,0.962783171521036,0.961013645224171,0.957943925233645,0.42218137254902
E02004618,"Sandywell, Ermin & Chedworth",Cotswold,South West,1226,4363,545,512,291,361,6072,1135,4640,577,555,340,386,6498,833,540,535,325,376,2609,0.179525862068966,0.935875216637782,0.963963963963964,0.955882352941176,0.974093264248705,0.401508156355802
E02004619,"Northleach, Coln Valley & Ampneys",Cotswold,South West,1127,4256,550,559,383,491,6239,1091,4482,542,539,436,497,6496,681,489,511,417,471,2569,0.15194109772423,0.902214022140221,0.948051948051948,0.956422018348624,0.947686116700201,0.395474137931035
E02004620,Cirencester East & Stratton,Cotswold,South West,1624,5002,539,466,321,372,6700,1578,5433,512,538,337,418,7238,688,481,511,331,399,2410,0.126633535799742,0.939453125,0.949814126394052,0.98219584569733,0.954545454545455,0.332964907432993
E02004621,Cirencester Central,Cotswold,South West,826,3896,323,392,350,764,5725,765,4430,320,411,333,749,6243,447,271,383,314,716,2131,0.100902934537246,0.846875,0.931873479318735,0.942942942942943,0.955941255006676,0.341342303379785
E02004622,Cirencester South,Cotswold,South West,1239,4740,389,413,288,517,6347,1199,4524,396,421,338,495,6174,551,367,397,325,482,2122,0.121794871794872,0.926767676767677,0.942992874109264,0.961538461538461,0.973737373737374,0.343699384515711
E02004623,Fairford & Lechlade,Cotswold,South West,1606,5025,667,676,468,659,7495,1578,5500,657,741,522,656,8076,754,610,716,504,638,3222,0.137090909090909,0.928462709284627,0.966261808367071,0.96551724137931,0.972560975609756,0.398959881129272
E02004624,Kemble & South Cerney,Cotswold,South West,1162,3862,425,474,309,363,5433,1181,4252,444,454,357,423,5930,483,395,415,347,412,2052,0.113593603010348,0.88963963963964,0.914096916299559,0.971988795518207,0.973995271867612,0.346037099494098
E02004625,Tetbury,Cotswold,South West,1671,5587,695,676,500,577,8035,1700,6220,713,716,540,680,8869,819,642,667,509,654,3291,0.131672025723473,0.900420757363254,0.931564245810056,0.942592592592593,0.961764705882353,0.371067764122224
E02004626,"Dymock, Hartpury & Huntley",Forest of Dean,South West,1379,6359,714,675,533,648,8929,1380,6450,694,708,530,674,9056,911,640,674,513,649,3387,0.141240310077519,0.922190201729107,0.951977401129944,0.967924528301887,0.962908011869436,0.374006183745583
E02004627,Newent,Forest of Dean,South West,970,3612,416,449,318,422,5217,1108,3834,390,438,355,445,5462,622,364,425,345,430,2186,0.162232655190402,0.933333333333333,0.970319634703196,0.971830985915493,0.966292134831461,0.400219699743684
E02004628,"Mitcheldean, Drybrook & Ruardean",Forest of Dean,South West,1451,4749,535,530,354,434,6602,1389,4865,539,553,408,457,6822,922,481,532,392,431,2758,0.189516957862282,0.89239332096475,0.962025316455696,0.96078431372549,0.943107221006565,0.404280269715626
E02004629,Cinderford,Forest of Dean,South West,2396,7896,829,754,528,695,10702,2338,8063,844,778,559,718,10962,1650,771,737,535,687,4380,0.204638472032742,0.913507109004739,0.947300771208226,0.957066189624329,0.956824512534819,0.399562123700055
E02004630,"Longhope, Westbury & Blakeney",Forest of Dean,South West,972,3752,515,504,359,512,5642,939,4002,491,522,373,501,5889,750,447,505,363,476,2541,0.187406296851574,0.910386965376782,0.967432950191571,0.973190348525469,0.950099800399202,0.431482424859908
E02004631,"Lydbrook, Newland & St Briavels",Forest of Dean,South West,733,2918,450,416,296,286,4366,660,3009,383,413,294,343,4442,290,234,265,208,230,1227,0.0963775340644732,0.610966057441253,0.641646489104116,0.707482993197279,0.670553935860058,0.276226924808645
E02004632,Coleford,Forest of Dean,South West,1886,6355,714,723,493,722,9007,1826,6478,740,753,571,752,9294,965,652,706,536,709,3568,0.148965730163631,0.881081081081081,0.937583001328021,0.938704028021016,0.94281914893617,0.383903593716376
E02004633,"Bream, Pillowell & Yorkley",Forest of Dean,South West,1379,4954,671,633,409,440,7107,1301,5043,640,626,423,503,7235,796,562,598,403,472,2831,0.157842554035296,0.878125,0.955271565495208,0.952718676122931,0.938369781312127,0.391292328956462
E02004634,Lydney,Forest of Dean,South West,1848,6231,657,709,505,664,8766,1874,6671,648,742,564,734,9359,966,552,703,538,706,3465,0.144805876180483,0.851851851851852,0.94743935309973,0.953900709219858,0.961852861035422,0.370231862378459
E02004635,Tidenham & Woolaston,Forest of Dean,South West,1271,4226,541,539,367,495,6168,1201,4434,483,546,360,464,6287,103,82,126,80,72,463,0.0232295895354082,0.169772256728778,0.230769230769231,0.222222222222222,0.155172413793103,0.0736440273580404
E02004636,Longlevens,Gloucester,South West,1296,4897,424,488,337,486,6632,1275,5058,462,467,372,471,6830,1177,438,452,361,457,2885,0.232700672202452,0.948051948051948,0.967880085653105,0.970430107526882,0.970276008492569,0.422401171303075
E02004637,Kingsholm & Wotton,Gloucester,South West,1338,5971,454,396,347,638,7806,1393,6243,430,436,323,613,8045,1810,376,397,306,585,3474,0.289924715681563,0.874418604651163,0.910550458715596,0.947368421052632,0.954323001631321,0.431821006836544
E02004638,Elmbridge,Gloucester,South West,1097,3480,313,319,213,324,4649,1115,3790,288,335,233,362,5008,1013,273,324,231,341,2182,0.267282321899736,0.947916666666667,0.967164179104478,0.991416309012876,0.941988950276243,0.435702875399361
E02004639,Central Gloucester & Hempsted,Gloucester,South West,1496,7152,341,381,268,450,8592,1733,8026,419,395,324,532,9696,1393,342,343,302,503,2883,0.173560926987291,0.816229116945107,0.868354430379747,0.932098765432099,0.945488721804511,0.297339108910891
E02004640,Barton,Gloucester,South West,2066,5328,263,195,171,200,6157,2239,6483,312,202,184,239,7420,1142,226,167,154,196,1885,0.176153015579207,0.724358974358974,0.826732673267327,0.836956521739131,0.820083682008368,0.254043126684636
E02004641,Hucclecote,Gloucester,South West,1135,3979,456,609,503,689,6236,1138,4164,471,541,525,716,6417,945,445,526,520,697,3133,0.226945244956772,0.9447983014862,0.972273567467652,0.990476190476191,0.973463687150838,0.488234377434939
E02004642,"Coney Hill, Barnwood & Abbeydale",Gloucester,South West,2618,7487,615,504,309,430,9345,2537,8174,592,530,396,422,10114,1998,540,503,377,393,3811,0.24443356985564,0.912162162162162,0.949056603773585,0.952020202020202,0.931279620853081,0.376804429503658
E02004643,Tredworth,Gloucester,South West,1970,5131,265,209,149,251,6005,2030,5904,284,229,170,254,6841,1223,241,202,145,227,2038,0.207147696476965,0.848591549295775,0.882096069868996,0.852941176470588,0.893700787401575,0.297909662330069
E02004644,Podsmead & Linden,Gloucester,South West,1911,5658,390,343,250,362,7003,1878,6084,414,334,260,371,7463,1516,365,317,246,330,2774,0.249178172255095,0.881642512077295,0.949101796407186,0.946153846153846,0.889487870619946,0.37170038858368
E02004645,Abbeymead & Abbeydale,Gloucester,South West,1653,5717,529,529,308,399,7482,1572,5856,532,524,361,412,7685,1505,498,495,347,395,3240,0.257001366120219,0.93609022556391,0.944656488549618,0.961218836565097,0.95873786407767,0.42160052049447
E02004646,Matson & Robinswood,Gloucester,South West,1956,5407,453,427,278,403,6968,1990,5846,455,437,316,406,7460,1477,405,417,297,383,2979,0.252651385562778,0.89010989010989,0.954233409610984,0.939873417721519,0.943349753694581,0.399329758713137
E02004647,Tuffley,Gloucester,South West,1070,3412,393,358,287,438,4888,1107,3712,364,377,269,448,5170,970,335,350,254,428,2337,0.261314655172414,0.92032967032967,0.928381962864722,0.944237918215613,0.955357142857143,0.452030947775629
E02004648,Lower Tuffley,Gloucester,South West,973,3187,353,460,393,381,4774,913,3252,321,450,396,430,4849,909,292,435,381,412,2429,0.279520295202952,0.909657320872274,0.966666666666667,0.962121212121212,0.958139534883721,0.500928026397195
E02004649,Quedgeley North,Gloucester,South West,1465,4908,264,238,163,263,5836,1482,5173,305,234,156,152,6020,1110,289,219,147,147,1912,0.214575681422772,0.947540983606557,0.935897435897436,0.942307692307692,0.967105263157895,0.317607973421927
E02004650,Quedgeley South,Gloucester,South West,3914,9632,417,315,216,217,10797,3838,9549,471,379,262,340,11001,1751,405,351,248,330,3085,0.183369986386009,0.859872611464968,0.926121372031662,0.946564885496183,0.970588235294118,0.280429051904372
E02004651,Upton St Leonards & Hardwicke,Stroud,South West,2304,6111,517,461,299,353,7741,2374,6778,492,512,321,375,8478,1358,453,479,314,360,2964,0.200354086751254,0.920731707317073,0.935546875,0.978193146417446,0.96,0.349610757254069
E02004652,"Painswick, Bisley & Eastcombe",Stroud,South West,1001,3534,518,539,462,545,5598,976,3735,543,566,458,646,5948,720,512,531,441,620,2824,0.192771084337349,0.942909760589319,0.938162544169611,0.962882096069869,0.959752321981424,0.474781439139207
E02004653,"Frampton, Whitminster & Eastington",Stroud,South West,1157,4095,466,456,293,394,5704,1274,4656,497,514,354,500,6521,957,465,495,345,480,2742,0.205541237113402,0.935613682092555,0.963035019455253,0.974576271186441,0.96,0.420487655267597
E02004654,Ebley & Randwick,Stroud,South West,2185,7182,707,684,464,648,9685,2019,7222,667,743,518,698,9848,1496,621,705,503,673,3998,0.207144835225699,0.931034482758621,0.94885598923284,0.971042471042471,0.964183381088825,0.405970755483347
E02004655,Stonehouse,Stroud,South West,1546,4879,470,429,299,408,6485,1415,5237,492,469,333,473,7004,1051,448,442,318,452,2711,0.200687416459805,0.910569105691057,0.942430703624733,0.954954954954955,0.955602536997886,0.387064534551685
E02004656,Stroud Town,Stroud,South West,1969,7641,625,544,338,570,9718,1899,7736,692,616,381,591,10016,1457,585,573,352,547,3514,0.188340227507756,0.845375722543353,0.930194805194805,0.923884514435695,0.925549915397631,0.350838658146965
E02004657,Rodborough & Thrupp,Stroud,South West,1182,4197,413,413,274,338,5635,1154,4460,429,426,320,370,6005,817,400,407,311,361,2296,0.183183856502242,0.932400932400932,0.955399061032864,0.971875,0.975675675675676,0.382348043297252
E02004658,Chalford & Bussage,Stroud,South West,1082,3766,371,410,259,372,5178,1060,4023,374,426,306,386,5515,675,346,409,293,374,2097,0.167785234899329,0.925133689839572,0.960093896713615,0.957516339869281,0.968911917098446,0.380235720761559
E02004659,Leonard Stanley & Uley,Stroud,South West,1187,3921,490,504,382,427,5724,1211,4202,524,515,386,496,6123,884,497,492,371,481,2725,0.210376011423132,0.948473282442748,0.955339805825243,0.961139896373057,0.969758064516129,0.445043279438184
E02004660,Minchinhampton & Amberley,Stroud,South West,1086,3393,512,586,403,705,5599,1065,3743,476,590,472,698,5979,772,436,563,450,685,2906,0.206251669783596,0.915966386554622,0.954237288135593,0.953389830508475,0.981375358166189,0.486034453922061
E02004661,Cam,Stroud,South West,1372,5101,550,610,430,554,7245,1331,5182,548,652,455,605,7442,1101,513,635,443,596,3288,0.212466229255114,0.936131386861314,0.973926380368098,0.973626373626374,0.985123966942149,0.441816715936576
E02004662,Berkeley & Sharpness,Stroud,South West,1061,3925,427,394,285,362,5393,1067,4005,458,424,297,391,5575,777,421,415,289,383,2285,0.194007490636704,0.919213973799127,0.97877358490566,0.973063973063973,0.979539641943734,0.409865470852018
E02004663,Nailsworth,Stroud,South West,1108,3916,467,432,280,399,5494,1113,4098,481,468,314,412,5773,788,436,445,296,394,2359,0.192288921425085,0.906444906444906,0.950854700854701,0.942675159235669,0.956310679611651,0.408626364108782
E02004664,Dursley,Stroud,South West,1609,4655,332,363,249,442,6041,1508,4843,342,366,275,460,6286,964,310,348,268,447,2337,0.199050175511047,0.906432748538012,0.950819672131147,0.974545454545454,0.971739130434783,0.371778555520204
E02004665,Wotton-under-Edge & Kingswood,Stroud,South West,1566,5121,591,607,449,541,7309,1507,5420,560,595,474,578,7627,919,486,569,464,566,3004,0.169557195571956,0.867857142857143,0.956302521008403,0.978902953586498,0.979238754325259,0.393863904549626
E02004666,Tewkesbury East & Ashchurch,Tewkesbury,South West,2519,7805,638,557,348,478,9826,2325,7893,640,573,429,495,10030,1295,610,546,418,482,3351,0.164069428607627,0.953125,0.952879581151833,0.974358974358974,0.973737373737374,0.334097706879362
E02004667,Tewkesbury West & Twyning,Tewkesbury,South West,1776,6744,750,778,590,809,9671,1726,6697,735,818,609,845,9704,1285,665,778,586,823,4137,0.191876959832761,0.904761904761905,0.951100244498777,0.962233169129721,0.97396449704142,0.426319043693322
E02004668,Winchcombe & Washbourne,Tewkesbury,South West,1473,4958,718,771,553,706,7706,1466,5269,704,852,610,709,8144,1063,663,818,593,683,3820,0.201746061871323,0.941761363636364,0.960093896713615,0.972131147540984,0.963328631875881,0.469056974459725
E02004669,"Cleeve Hill, Gotherington & Apperley",Tewkesbury,South West,1282,4155,587,559,387,526,6214,1294,4347,534,569,405,519,6374,887,498,552,394,502,2833,0.204048769266161,0.932584269662921,0.9701230228471,0.97283950617284,0.967244701348748,0.444461876372764
E02004670,Bishop's Cleeve,Tewkesbury,South West,3302,9155,784,771,672,1026,12408,3272,9812,781,806,690,1061,13150,2220,743,765,679,1045,5452,0.226253567060742,0.95134443021767,0.949131513647643,0.984057971014493,0.984919886899152,0.414600760456274
E02004671,"Highnam, Longford & Norton",Tewkesbury,South West,1261,4081,549,505,298,339,5772,1429,4470,593,531,372,398,6364,1031,560,501,356,394,2842,0.230648769574944,0.944350758853288,0.943502824858757,0.956989247311828,0.989949748743719,0.446574481458202
E02004672,Churchdown & Innsworth,Tewkesbury,South West,2497,8015,681,719,510,804,10729,2374,8429,613,673,547,813,11075,2059,575,650,531,790,4605,0.244275714794163,0.938009787928222,0.965824665676077,0.970749542961609,0.971709717097171,0.415801354401806
E02004673,"Shurdington, Staverton & Witcombe",Tewkesbury,South West,1239,3984,410,416,382,471,5663,1467,4503,438,432,350,528,6251,1094,406,412,342,514,2768,0.242949145014435,0.926940639269406,0.953703703703704,0.977142857142857,0.973484848484848,0.442809150535914
E02004674,Brockworth & Coopers Edge,Tewkesbury,South West,2526,7268,507,533,334,513,9155,2569,7629,559,520,392,551,9651,1523,508,496,377,527,3431,0.199632979420632,0.908765652951699,0.953846153846154,0.961734693877551,0.956442831215971,0.355507201326287
E02006047,"Rode, Mells & Woodlands",Mendip,South West,1533,4990,619,675,368,487,7139,1474,5533,603,667,465,535,7803,1237,554,647,451,513,3402,0.223567684800289,0.918739635157546,0.970014992503748,0.96989247311828,0.958878504672897,0.43598615916955
E02006048,"Stratton, Holcombe & Highbury",Mendip,South West,1308,4147,520,456,305,382,5810,1333,4631,489,515,345,406,6386,923,449,485,332,383,2572,0.199309004534658,0.918200408997955,0.941747572815534,0.96231884057971,0.943349753694581,0.402756028813029
E02006049,Frome North East,Mendip,South West,1229,4222,517,549,402,490,6180,1161,4396,516,597,454,544,6507,1271,475,575,435,526,3282,0.289126478616925,0.920542635658915,0.963149078726968,0.958149779735683,0.966911764705882,0.50437989857077
E02006050,Frome North West,Mendip,South West,1802,5493,485,381,272,488,7119,1836,5946,482,410,297,474,7609,1512,413,390,276,454,3045,0.254288597376388,0.856846473029046,0.951219512195122,0.929292929292929,0.957805907172996,0.400183992640294
E02006051,"Draycott, Westbury & Wookey",Mendip,South West,1381,4437,575,625,462,661,6760,1378,4960,602,609,467,693,7331,1323,527,584,450,662,3546,0.266733870967742,0.875415282392027,0.958949096880131,0.963597430406852,0.955266955266955,0.483699358886919
E02006052,"Oakhill, Horrington & Chewton Mendip",Mendip,South West,1243,4544,525,522,395,584,6570,1209,4971,545,514,440,583,7053,1163,478,486,422,552,3101,0.233956950311809,0.877064220183486,0.945525291828794,0.959090909090909,0.946826758147513,0.43967106195945
E02006053,Frome South & East,Mendip,South West,2336,6321,577,465,337,458,8158,2366,7136,587,555,396,498,9172,2013,532,524,382,476,3927,0.282090807174888,0.906303236797274,0.944144144144144,0.964646464646465,0.955823293172691,0.428150894025294
E02006054,Wells Town,Mendip,South West,1269,4600,571,632,435,902,7140,1196,5042,555,654,517,865,7633,1483,466,616,489,821,3875,0.294129313764379,0.83963963963964,0.941896024464832,0.945841392649903,0.949132947976879,0.50766409013494
E02006055,Shepton Mallet,Mendip,South West,1840,5811,468,453,284,400,7416,1828,6216,477,478,324,414,7909,1348,402,449,304,392,2895,0.216859716859717,0.842767295597484,0.939330543933054,0.938271604938272,0.946859903381642,0.366038690099886
E02006056,Evercreech & Nunney,Mendip,South West,1337,4452,535,559,376,464,6386,1323,4781,494,585,400,496,6756,1132,456,554,385,479,3006,0.236770550094123,0.923076923076923,0.947008547008547,0.9625,0.965725806451613,0.4449378330373
E02006057,Glastonbury Town,Mendip,South West,1327,4526,592,508,349,483,6458,1264,5338,596,590,382,500,7406,1351,394,508,337,462,3052,0.253091045335332,0.661073825503356,0.861016949152542,0.882198952879581,0.924,0.412098298676749
E02006058,Glastonbury West & Street South,Mendip,South West,1663,5146,513,560,372,523,7114,1721,5780,510,563,397,531,7781,1393,417,524,382,510,3226,0.241003460207612,0.817647058823529,0.930728241563055,0.962216624685139,0.96045197740113,0.414599665852718
E02006059,"Pilton, Butleigh & Alhampton",Mendip,South West,1053,3847,552,561,356,424,5740,1066,4262,548,574,374,473,6231,1050,476,543,352,462,2883,0.246363209760676,0.868613138686131,0.945993031358885,0.941176470588235,0.976744186046512,0.462686567164179
E02006060,Street Village,Mendip,South West,1536,4994,387,449,352,558,6740,1527,5369,422,453,352,589,7185,1450,328,420,335,568,3101,0.270068914136711,0.777251184834123,0.927152317880795,0.951704545454545,0.964346349745331,0.431593597773139
E02006061,Cheddar & Axbridge,Sedgemoor,South West,1562,5271,610,660,443,686,7670,1527,5681,581,682,537,714,8195,1354,502,649,517,690,3712,0.238338320718183,0.864027538726334,0.951612903225806,0.962756052141527,0.966386554621849,0.452959121415497
E02006062,Berrow & Brent Knoll,Sedgemoor,South West,1665,6104,868,932,676,914,9494,1527,6385,953,985,742,1007,10072,1722,735,932,710,960,5059,0.269694596711042,0.771248688352571,0.946192893401015,0.956873315363881,0.953326713008937,0.502283558379666
E02006063,Wedmore & Mark,Sedgemoor,South West,1081,3830,562,558,415,454,5819,1026,4037,513,602,427,491,6070,933,437,567,409,474,2820,0.231112212038643,0.851851851851852,0.941860465116279,0.957845433255269,0.965376782077393,0.464579901153213
E02006064,Burnham-on-Sea,Sedgemoor,South West,964,3917,649,670,551,905,6692,923,4206,580,713,595,949,7043,1117,379,663,560,884,3603,0.265572990965288,0.653448275862069,0.929873772791024,0.941176470588235,0.931506849315068,0.511571773392021
E02006065,Highbridge,Sedgemoor,South West,1724,5081,535,629,408,484,7137,1713,5548,578,605,493,503,7727,1387,448,553,465,464,3317,0.25,0.775086505190311,0.91404958677686,0.943204868154158,0.922465208747515,0.429273974375566
E02006066,"Pawlett, Puriton & Woolavington",Sedgemoor,South West,1322,4636,699,646,473,530,6984,1369,4983,627,679,496,567,7352,1056,521,637,470,545,3229,0.211920529801325,0.830940988835726,0.938144329896907,0.94758064516129,0.961199294532628,0.439200217627856
E02006067,"Cannington, Combwich & Nether Stowey",Sedgemoor,South West,1079,3829,533,571,369,528,5830,1070,4167,547,564,431,578,6287,969,463,537,420,562,2951,0.232541396688265,0.846435100548446,0.952127659574468,0.974477958236659,0.972318339100346,0.469381262923493
E02006068,Bridgwater North,Sedgemoor,South West,1864,4895,328,357,204,308,6092,1801,5383,332,351,213,326,6605,885,238,330,208,317,1978,0.164406464796582,0.716867469879518,0.94017094017094,0.976525821596244,0.97239263803681,0.299470098410295
E02006069,Bridgwater Town,Sedgemoor,South West,1902,6874,472,434,240,439,8459,1978,7633,424,443,244,431,9175,1105,328,405,232,401,2471,0.144766146993319,0.773584905660377,0.914221218961625,0.950819672131147,0.930394431554524,0.269318801089918
E02006070,Bridgwater East,Sedgemoor,South West,1649,5129,452,397,273,391,6642,1663,5444,420,442,323,393,7022,909,337,422,309,379,2356,0.166972814107274,0.802380952380952,0.954751131221719,0.956656346749226,0.964376590330789,0.335516946738821
E02006071,Wembdon & Chilton Trinity,Sedgemoor,South West,1884,5662,527,531,363,643,7726,1749,5980,519,582,419,619,8119,1145,451,561,394,603,3154,0.191471571906355,0.86897880539499,0.963917525773196,0.940334128878282,0.974151857835218,0.388471486636285
E02006072,"Westonzoyland, Ashcott & Cossington",Sedgemoor,South West,1347,5352,759,784,513,683,8091,1299,5638,781,804,572,677,8472,1173,650,764,553,656,3796,0.208052500886839,0.832266325224072,0.950248756218905,0.966783216783217,0.968980797636632,0.448064211520302
E02006073,Bridgwater South,Sedgemoor,South West,1667,4502,376,330,254,349,5811,1766,5285,353,358,232,350,6578,853,266,323,222,330,1994,0.161400189214759,0.753541076487252,0.902234636871508,0.956896551724138,0.942857142857143,0.303131650957738
E02006074,Stockmoor & North Petherton,Sedgemoor,South West,2316,6597,584,572,394,558,8705,2430,7205,569,609,436,532,9351,1397,479,582,424,511,3393,0.193893129770992,0.84182776801406,0.955665024630542,0.972477064220184,0.960526315789474,0.362848893166506
E02006075,"Bruton, Brewham & Cucklington",South Somerset,South West,1165,3205,351,307,280,308,4451,1086,3630,334,327,263,322,4876,755,298,308,250,307,1918,0.207988980716253,0.892215568862276,0.941896024464832,0.950570342205323,0.953416149068323,0.393355209187859
E02006076,Castle Cary & Kenton Mandeville,South Somerset,South West,1286,4716,716,716,491,773,7412,1242,5265,711,747,584,806,8113,1516,654,708,566,779,4223,0.287939221272555,0.919831223628692,0.947791164658635,0.969178082191781,0.966501240694789,0.520522618020461
E02006077,Somerton,South Somerset,South West,962,2904,447,462,367,497,4677,998,3371,429,514,377,582,5273,943,389,488,358,562,2740,0.279738949866508,0.906759906759907,0.949416342412451,0.949602122015915,0.965635738831615,0.519628295088185
E02006078,Langport & Long Sutton,South Somerset,South West,986,3237,519,484,377,503,5120,914,3571,519,547,339,466,5442,849,468,525,326,451,2619,0.237748529823579,0.901734104046243,0.959780621572212,0.96165191740413,0.967811158798283,0.481256890848953
E02006079,"Wincanton, Cheriton & Charlton Horethorne",South Somerset,South West,1486,4410,583,524,365,509,6391,1502,4922,540,543,410,546,6961,1265,478,524,398,526,3191,0.257009345794393,0.885185185185185,0.965009208103131,0.970731707317073,0.963369963369963,0.458411147823589
E02006080,"Ilchester, Sparkford & Mudford",South Somerset,South West,1254,4557,367,417,277,379,5997,1235,5212,370,417,313,396,6708,969,336,384,297,380,2366,0.185917114351497,0.908108108108108,0.920863309352518,0.94888178913738,0.95959595959596,0.352713178294574
E02006081,Curry Rivel & Fivehead,South Somerset,South West,855,2926,454,465,311,354,4510,907,3322,466,485,360,453,5086,798,431,463,350,441,2483,0.240216736905479,0.924892703862661,0.954639175257732,0.972222222222222,0.973509933774834,0.488202909948879
E02006082,"Templecombe, Hentsridge & Milborne Port",South Somerset,South West,1171,3660,543,524,376,361,5464,1183,4040,518,571,424,429,5982,1090,460,540,412,414,2916,0.26980198019802,0.888030888030888,0.945709281961471,0.971698113207547,0.965034965034965,0.487462387161484
E02006083,Martock,South Somerset,South West,826,3161,433,478,303,404,4779,760,3213,397,494,341,423,4868,933,353,469,326,407,2488,0.290382819794585,0.889168765743073,0.949392712550607,0.956011730205279,0.962174940898345,0.511092851273624
E02006084,"South Petherton, Seavington & Kingsbury",South Somerset,South West,1195,3911,647,634,445,618,6255,1114,4136,663,648,482,655,6584,1226,599,612,459,629,3525,0.29642166344294,0.903469079939668,0.944444444444444,0.952282157676349,0.96030534351145,0.535388821385176
E02006085,Yeovil North East,South Somerset,South West,1452,4306,439,481,286,355,5867,1538,4698,425,478,314,362,6277,1094,385,453,300,344,2576,0.232865048957003,0.905882352941176,0.947698744769875,0.955414012738854,0.950276243093923,0.41038712760873
E02006086,Yeovil Lufton & Hollands,South Somerset,South West,1505,4324,353,391,292,444,5804,1497,4783,341,442,337,425,6328,1119,306,424,328,402,2579,0.233953585615722,0.897360703812317,0.959276018099547,0.973293768545994,0.945882352941176,0.407553729456384
E02006087,Yeovil Larkhill,South Somerset,South West,1324,3852,270,257,190,326,4895,1285,3943,256,263,220,330,5012,863,226,242,210,316,1857,0.218868881562262,0.8828125,0.920152091254753,0.954545454545455,0.957575757575757,0.370510774142059
E02006088,Yeovil Milford Park,South Somerset,South West,1773,4801,372,368,227,393,6161,1721,5295,373,352,240,381,6641,1220,321,329,223,362,2455,0.230406043437205,0.86058981233244,0.934659090909091,0.929166666666667,0.9501312335958,0.369673241981629
E02006089,Yeovil Town,South Somerset,South West,1203,4741,297,271,165,350,5824,1282,5433,317,278,193,355,6576,1116,250,251,184,334,2135,0.205411374930977,0.788643533123028,0.902877697841727,0.953367875647668,0.940845070422535,0.324665450121655
E02006090,Yeovil Preston Plucknett,South Somerset,South West,1312,4219,360,344,286,433,5642,1412,4721,348,376,282,495,6222,1062,318,355,272,475,2482,0.224952340605804,0.913793103448276,0.944148936170213,0.964539007092199,0.95959595959596,0.398907103825137
E02006091,Ham Hill & Merriott,South Somerset,South West,1619,5247,810,781,593,677,8108,1547,5693,765,834,651,730,8673,1619,681,793,626,704,4423,0.284384331635342,0.890196078431373,0.95083932853717,0.961597542242704,0.964383561643836,0.509973480917791
E02006092,Yeovil South,South Somerset,South West,1017,3721,476,486,269,382,5334,981,3881,442,503,332,367,5525,898,408,484,321,358,2469,0.231383664004123,0.923076923076923,0.962226640159046,0.966867469879518,0.975476839237057,0.446877828054299
E02006093,Ilminster & Horton,South Somerset,South West,1490,4724,601,641,550,803,7319,1449,4931,547,711,563,795,7547,1382,508,680,546,759,3875,0.28026769417968,0.928702010968921,0.956399437412096,0.969804618117229,0.954716981132075,0.513449052603684
E02006094,Stoford & the Cokers,South Somerset,South West,791,2909,393,453,286,452,4493,796,3039,399,469,342,447,4696,838,369,450,329,433,2419,0.275748601513656,0.924812030075188,0.959488272921109,0.961988304093567,0.968680089485458,0.515119250425894
E02006095,Crewkerne,South Somerset,South West,1320,4360,602,607,485,651,6705,1289,4741,557,663,521,692,7174,1419,452,641,505,659,3676,0.299303944315545,0.81149012567325,0.966817496229261,0.969289827255278,0.952312138728324,0.512405910231391
E02006096,Chard North & East,South Somerset,South West,1328,4040,416,504,300,413,5673,1360,4457,428,524,350,455,6214,935,373,506,340,437,2591,0.209782364819385,0.871495327102804,0.965648854961832,0.971428571428571,0.96043956043956,0.416961699388478
E02006097,Chard West,South Somerset,South West,1244,3960,379,381,346,562,5628,1278,4484,389,408,318,559,6158,813,330,380,305,532,2360,0.181311329170384,0.848329048843188,0.931372549019608,0.959119496855346,0.95169946332737,0.383241312114323
E02006098,Tatworth & Combe St Nicholas,South Somerset,South West,1016,3772,730,723,442,589,6256,998,4102,666,722,528,580,6598,972,593,688,512,556,3321,0.236957581667479,0.89039039039039,0.952908587257618,0.96969696969697,0.958620689655172,0.503334343740527
E02006099,Bishops Lydeard & Cotford St Luke,Somerset West and Taunton,South West,1372,4004,501,438,273,386,5602,1315,4288,449,498,349,420,6004,1458,395,466,337,404,3060,0.340018656716418,0.879732739420935,0.93574297188755,0.965616045845272,0.961904761904762,0.509660226515656
E02006100,Taunton Rowbarton & Kingston,Somerset West and Taunton,South West,1473,4704,445,431,345,456,6381,1605,5159,451,474,380,504,6968,1419,404,444,362,486,3115,0.275053304904051,0.895787139689579,0.936708860759494,0.952631578947368,0.964285714285714,0.447043628013777
E02006101,Wiveliscombe & Milverton,Somerset West and Taunton,South West,907,3182,433,427,307,456,4805,882,3358,436,408,355,443,5000,916,375,383,341,424,2439,0.272781417510423,0.860091743119266,0.938725490196078,0.96056338028169,0.957110609480813,0.4878
E02006102,Taunton Pyrland & Priorswood,Somerset West and Taunton,South West,1309,4082,434,347,257,443,5563,1341,4477,428,380,281,440,6006,1366,364,356,267,418,2771,0.30511503238776,0.850467289719626,0.936842105263158,0.950177935943061,0.95,0.461371961371961
E02006103,Ruishton & North Curry,Somerset West and Taunton,South West,1423,4134,634,639,481,566,6454,1333,4519,596,658,500,624,6897,1256,557,631,482,604,3530,0.277937596813454,0.934563758389262,0.958966565349544,0.964,0.967948717948718,0.511816731912426
E02006104,Taunton Halcon & Monkton Heathfield,Somerset West and Taunton,South West,2189,6182,479,490,295,361,7807,2167,6754,494,455,367,406,8476,2063,450,433,351,392,3689,0.3054486230382,0.910931174089069,0.951648351648352,0.956403269754768,0.96551724137931,0.4352288815479
E02006105,Taunton North Town,Somerset West and Taunton,South West,1913,7587,484,467,318,578,9434,1992,8186,548,481,354,512,10081,2200,439,434,328,490,3891,0.268751526997312,0.801094890510949,0.902286902286902,0.926553672316384,0.95703125,0.385973613728797
E02006106,Bishop's Hull & Norton Fitzwarren,Somerset West and Taunton,South West,1884,6006,520,446,328,544,7844,1968,6470,501,485,356,523,8335,2227,438,469,346,506,3986,0.344204018547141,0.874251497005988,0.96701030927835,0.971910112359551,0.967495219885277,0.478224355128974
E02006107,Taunton Holway & Lambrook,Somerset West and Taunton,South West,1909,5051,476,390,241,425,6583,1919,5689,473,437,279,404,7282,1701,405,399,260,381,3146,0.298998066444015,0.856236786469345,0.91304347826087,0.931899641577061,0.943069306930693,0.43202416918429
E02006108,Taunton Wilton,Somerset West and Taunton,South West,1266,5218,454,524,458,992,7646,1235,5679,474,542,469,1005,8169,1695,389,505,446,971,4006,0.298468040147913,0.820675105485232,0.931734317343173,0.950959488272921,0.966169154228856,0.490390500673277
E02006109,Taunton Galmington & Trull,Somerset West and Taunton,South West,1416,4335,504,599,462,766,6666,1405,4630,475,573,497,730,6905,1744,418,551,479,712,3904,0.376673866090713,0.88,0.961605584642234,0.963782696177062,0.975342465753425,0.565387400434468
E02006110,Wellington North,Somerset West and Taunton,South West,1926,5736,553,496,362,567,7714,1989,6406,556,565,378,581,8486,1848,432,524,352,544,3700,0.28847955042148,0.776978417266187,0.927433628318584,0.931216931216931,0.93631669535284,0.436012255479614
E02006111,"Wellington South, Rockwell Green & West Buckland",Somerset West and Taunton,South West,1627,5708,818,961,633,936,9056,1482,6070,793,947,689,933,9432,1636,661,883,674,892,4746,0.269522240527183,0.833543505674653,0.932418162618796,0.978229317851959,0.956055734190782,0.503180661577608
E02006112,Dowslands & Blackdown,Somerset West and Taunton,South West,1181,4384,622,608,402,674,6690,1253,4984,601,605,444,664,7298,1451,542,584,423,631,3631,0.291131621187801,0.901830282861897,0.965289256198347,0.952702702702703,0.950301204819277,0.497533570841326
E02006113,Minehead Town,Somerset West and Taunton,South West,1154,3824,550,601,470,876,6321,1027,4267,510,586,502,868,6733,1220,377,553,482,839,3471,0.2859151628779,0.73921568627451,0.943686006825939,0.960159362549801,0.966589861751152,0.515520570325264
E02006114,Minehead Outer & Porlock,Somerset West and Taunton,South West,756,3484,585,608,479,688,5844,794,3748,582,672,490,763,6255,946,455,630,472,734,3237,0.252401280683031,0.781786941580756,0.9375,0.963265306122449,0.961992136304063,0.517505995203837
E02006115,"Watchet, Washford & Carhampton",Somerset West and Taunton,South West,1108,3862,754,679,454,572,6321,1147,4167,717,684,546,647,6761,1231,620,652,526,624,3653,0.295416366690665,0.864714086471409,0.953216374269006,0.963369963369963,0.964451313755796,0.540304688655524
E02006116,"Williton, Quantock & Stogursey",Somerset West and Taunton,South West,1087,4089,767,784,518,748,6906,1004,4387,764,813,619,729,7312,1189,677,779,598,705,3948,0.271028037383178,0.886125654450262,0.958179581795818,0.966074313408724,0.967078189300411,0.539934354485777
E02006117,"Dunster, Dulverton & Exmoor",Somerset West and Taunton,South West,625,2880,560,583,387,543,4953,636,3106,530,555,430,538,5159,782,467,528,415,522,2714,0.251770766258854,0.881132075471698,0.951351351351351,0.965116279069768,0.970260223048327,0.526070943981392
E02002905,"Wigmore, Orleton & Brimfield","Herefordshire, County of",West Midlands,959,3568,559,589,397,392,5505,824,3550,545,548,439,462,5544,886,476,495,389,409,2655,0.249577464788732,0.873394495412844,0.903284671532847,0.886104783599089,0.885281385281385,0.478896103896104
E02002906,Leominster North,"Herefordshire, County of",West Midlands,1161,3363,340,383,285,573,4944,1086,3319,333,366,261,451,4730,840,303,345,254,445,2187,0.25308827960229,0.90990990990991,0.942622950819672,0.973180076628353,0.98669623059867,0.462367864693446
E02002907,Leominster South,"Herefordshire, County of",West Midlands,1084,3729,436,402,293,352,5212,1081,3992,448,444,344,491,5719,1042,414,409,322,466,2653,0.261022044088176,0.924107142857143,0.921171171171171,0.936046511627907,0.94908350305499,0.463892288861689
E02002908,"Shobdon, Luston & Bodenham","Herefordshire, County of",West Midlands,1335,4909,749,788,520,628,7594,1267,5152,756,810,596,685,7999,1226,704,782,569,652,3933,0.237965838509317,0.931216931216931,0.965432098765432,0.954697986577181,0.951824817518248,0.491686460807601
E02002909,Bromyard & Bishop's Frome,"Herefordshire, County of",West Midlands,1579,6127,909,835,529,789,9189,1473,6335,925,964,629,829,9682,1940,780,912,600,811,5043,0.306235201262826,0.843243243243243,0.946058091286307,0.95389507154213,0.978287092882992,0.520863457963231
E02002910,"Kington, Eardisley & Staunton","Herefordshire, County of",West Midlands,1238,4528,658,677,477,649,6989,1092,4452,689,633,507,715,6996,1030,581,569,469,647,3296,0.231356693620845,0.843251088534107,0.898894154818325,0.925049309664694,0.904895104895105,0.471126357918811
E02002911,"Credenhill, Weobley & Wellington","Herefordshire, County of",West Midlands,1710,5371,671,684,461,713,7900,1531,6498,659,754,512,731,9154,1368,620,730,496,702,3916,0.210526315789474,0.940819423368741,0.96816976127321,0.96875,0.960328317373461,0.427791129560848
E02002912,"Lugwardine, Withington & Moreton on Lugg","Herefordshire, County of",West Midlands,1275,4667,501,492,319,417,6396,1228,4802,495,499,348,467,6611,1040,450,479,335,446,2750,0.216576426488963,0.909090909090909,0.959919839679359,0.96264367816092,0.955032119914347,0.415973377703827
E02002913,"Colwall, Cradley & Wellington Heath","Herefordshire, County of",West Midlands,823,3110,500,531,395,469,5005,783,3230,525,548,420,495,5218,864,452,528,401,466,2711,0.26749226006192,0.860952380952381,0.963503649635036,0.954761904761905,0.941414141414141,0.519547719432733
E02002914,Hereford North West,"Herefordshire, County of",West Midlands,1605,5763,476,510,379,561,7689,1543,5734,499,518,407,554,7712,1374,446,491,388,526,3225,0.239623299616324,0.893787575150301,0.947876447876448,0.953316953316953,0.949458483754513,0.418179460580913
E02002915,Hereford North East,"Herefordshire, County of",West Midlands,1281,4566,421,433,358,691,6469,1275,4759,423,428,415,688,6713,1219,391,404,400,663,3077,0.256146249212019,0.92434988179669,0.94392523364486,0.963855421686747,0.963662790697675,0.458364367644868
E02002916,Hereford Central,"Herefordshire, County of",West Midlands,1656,6823,441,428,271,449,8412,1629,6990,474,470,299,459,8692,1542,404,427,283,430,3086,0.220600858369099,0.852320675105485,0.908510638297872,0.946488294314381,0.93681917211329,0.3550391164289
E02002917,Hereford West,"Herefordshire, County of",West Midlands,1162,4667,334,340,261,410,6012,1128,4567,333,365,275,444,5984,987,286,340,258,418,2289,0.216115611999124,0.858858858858859,0.931506849315068,0.938181818181818,0.941441441441441,0.382520053475936
E02002918,Hereford East,"Herefordshire, County of",West Midlands,1082,3336,391,377,294,511,4909,1001,3434,365,386,298,560,5043,898,346,367,292,539,2442,0.26150262085032,0.947945205479452,0.950777202072539,0.979865771812081,0.9625,0.484235574063058
E02002919,Hereford South,"Herefordshire, County of",West Midlands,2078,6100,450,418,316,417,7701,1948,5820,402,441,310,443,7416,1363,348,420,297,419,2847,0.234192439862543,0.865671641791045,0.952380952380952,0.958064516129032,0.945823927765237,0.383899676375405
E02002920,"Belmont, Madley & Clehonger","Herefordshire, County of",West Midlands,1132,4214,380,375,327,351,5647,1082,4119,390,365,332,349,5555,797,335,343,318,335,2128,0.193493566399612,0.858974358974359,0.93972602739726,0.957831325301205,0.959885386819484,0.383078307830783
E02002921,Hereford South West,"Herefordshire, County of",West Midlands,2101,5131,340,289,163,246,6169,1963,5372,330,329,181,249,6461,1043,279,305,174,233,2034,0.19415487714073,0.845454545454546,0.927051671732523,0.961325966850829,0.93574297188755,0.314811948614766
E02002922,"Fownhope, Tarrington & Marcle","Herefordshire, County of",West Midlands,1056,3967,498,535,345,459,5804,1003,3979,506,541,366,500,5892,942,427,507,355,482,2713,0.236742900226187,0.843873517786561,0.937153419593346,0.969945355191257,0.964,0.460454854039375
E02002923,Ledbury,"Herefordshire, County of",West Midlands,1555,5600,637,776,551,935,8499,1410,5469,567,771,628,930,8365,1478,457,735,607,894,4171,0.270250502834156,0.805996472663139,0.953307392996109,0.96656050955414,0.961290322580645,0.498625224148237
E02002924,Golden Valley,"Herefordshire, County of",West Midlands,1063,3368,497,502,345,471,5183,994,3386,485,530,337,494,5232,499,363,443,296,432,2033,0.147371529828706,0.748453608247423,0.835849056603774,0.878338278931751,0.874493927125506,0.388570336391437
E02002925,Kingstone & Kingsthorne,"Herefordshire, County of",West Midlands,1919,6701,811,735,477,626,9350,1854,6703,771,752,548,710,9484,1301,643,704,517,681,3846,0.194092197523497,0.833981841763943,0.936170212765957,0.943430656934307,0.959154929577465,0.405525094896668
E02002926,Ross-on-Wye,"Herefordshire, County of",West Midlands,1800,6380,796,758,615,960,9509,1750,6508,777,802,637,997,9721,1193,583,757,608,965,4106,0.183312845728334,0.75032175032175,0.943890274314214,0.95447409733124,0.9679037111334,0.422384528340706
E02002927,"Penyard, Llangarron & Goodrich","Herefordshire, County of",West Midlands,1589,6904,1007,972,726,862,10471,1519,7022,1033,936,778,869,10638,1096,735,797,685,741,4054,0.156080888635716,0.711519845111326,0.851495726495726,0.880462724935733,0.852704257767549,0.381086670426772
E02002928,Newport North,Telford and Wrekin,West Midlands,1000,3663,381,402,245,291,4982,953,3516,378,440,311,350,4995,984,348,418,298,327,2375,0.279863481228669,0.920634920634921,0.95,0.958199356913183,0.934285714285714,0.475475475475476
E02002929,Edgemond & Church Aston,Telford and Wrekin,West Midlands,881,3946,421,449,286,375,5477,955,5092,424,449,371,431,6767,1044,389,430,362,408,2633,0.205027494108405,0.917452830188679,0.957683741648107,0.975741239892183,0.946635730858469,0.389094133293926
E02002930,Newport South,Telford and Wrekin,West Midlands,1082,3788,355,414,297,436,5290,1202,4078,356,440,344,469,5687,1064,330,416,329,429,2568,0.260912211868563,0.926966292134832,0.945454545454546,0.956395348837209,0.914712153518124,0.451556180763144
E02002931,Muxton & Lilleshall,Telford and Wrekin,West Midlands,1273,4122,367,393,302,305,5489,1205,4415,367,400,329,353,5864,1196,340,382,319,335,2572,0.270894677236693,0.926430517711172,0.955,0.969604863221885,0.949008498583569,0.438608458390177
E02002932,Donnington,Telford and Wrekin,West Midlands,2110,5811,387,344,271,296,7109,2104,5951,379,360,258,331,7279,1177,339,336,241,299,2392,0.197781885397412,0.894459102902375,0.933333333333333,0.934108527131783,0.903323262839879,0.328616568209919
E02002933,Dothill & Shawbirch,Telford and Wrekin,West Midlands,1291,4842,429,444,370,494,6579,1283,5074,447,468,380,501,6870,1501,421,443,365,478,3208,0.295821836815136,0.941834451901566,0.946581196581197,0.960526315789474,0.954091816367266,0.466957787481805
E02002934,Apley & Leegomery,Telford and Wrekin,West Midlands,1132,3825,406,273,177,215,4896,1157,4094,435,338,210,239,5316,1088,403,316,202,223,2232,0.265754763067904,0.926436781609195,0.93491124260355,0.961904761904762,0.933054393305439,0.419864559819413
E02002935,Wrockwardine Wood & Trench,Telford and Wrekin,West Midlands,1187,3885,395,393,327,347,5347,1166,4082,386,417,297,393,5575,914,341,395,275,363,2288,0.22390984811367,0.883419689119171,0.947242206235012,0.925925925925926,0.923664122137404,0.410403587443946
E02002936,Hadley & Horton,Telford and Wrekin,West Midlands,2585,6844,338,285,197,216,7880,2717,7725,352,321,210,258,8866,1467,281,285,191,230,2454,0.189902912621359,0.798295454545455,0.88785046728972,0.909523809523809,0.891472868217054,0.276787728400632
E02002937,"Ironbridge, Admaston & Higher Ercall",Telford and Wrekin,West Midlands,1632,6126,660,680,448,514,8428,1553,6542,662,683,542,629,9058,1803,613,658,512,594,4180,0.275603790889636,0.925981873111783,0.963396778916545,0.944649446494465,0.944356120826709,0.461470523294326
E02002938,Wellington East,Telford and Wrekin,West Midlands,1671,4510,327,275,207,247,5566,1689,5193,359,322,221,286,6381,1079,292,293,205,256,2125,0.207779703446948,0.813370473537604,0.909937888198758,0.927601809954751,0.895104895104895,0.333019902836546
E02002939,Wellington West,Telford and Wrekin,West Midlands,1177,4191,404,408,291,493,5787,1254,4655,393,447,342,512,6349,1211,354,411,328,485,2789,0.26015037593985,0.900763358778626,0.919463087248322,0.95906432748538,0.947265625,0.439281776657741
E02002940,St George's,Telford and Wrekin,West Midlands,966,3714,323,314,238,301,4890,992,3766,344,337,246,327,5020,874,314,312,229,312,2041,0.232076473712161,0.912790697674419,0.925816023738872,0.930894308943089,0.954128440366972,0.406573705179283
E02002941,Oakengates & Ketley,Telford and Wrekin,West Midlands,2033,6492,533,532,418,476,8451,1935,6743,578,538,451,531,8841,1530,498,503,424,504,3459,0.226901972415839,0.86159169550173,0.934944237918216,0.940133037694013,0.949152542372881,0.391245334238208
E02002942,Priorslee,Telford and Wrekin,West Midlands,1596,4680,377,285,155,260,5757,1711,5045,415,352,206,283,6301,1157,380,320,198,269,2324,0.229335976214073,0.91566265060241,0.909090909090909,0.961165048543689,0.950530035335689,0.368830344389779
E02002943,Horsehay & The Rock,Telford and Wrekin,West Midlands,3765,9619,519,373,252,330,11093,4136,10791,584,458,283,350,12466,2492,509,412,265,326,4004,0.230933185061625,0.871575342465753,0.899563318777293,0.936395759717314,0.931428571428571,0.321193646719076
E02002944,Malinslee,Telford and Wrekin,West Midlands,1946,5092,382,331,208,255,6268,1946,5652,413,344,234,245,6888,1231,339,312,219,224,2325,0.217799009200283,0.820823244552058,0.906976744186047,0.935897435897436,0.914285714285714,0.337543554006969
E02002945,Hollinswood & Randlay,Telford and Wrekin,West Midlands,2120,6234,466,383,240,247,7570,2097,7170,508,428,306,253,8665,1127,404,400,291,235,2457,0.157182705718271,0.795275590551181,0.934579439252336,0.950980392156863,0.928853754940711,0.283554529717253
E02002946,Dawley & Aqueduct,Telford and Wrekin,West Midlands,1357,4954,434,370,251,326,6335,1335,5122,408,434,262,340,6566,1298,358,403,248,321,2628,0.253416634127294,0.877450980392157,0.928571428571429,0.946564885496183,0.944117647058824,0.400243679561377
E02002947,Brookside,Telford and Wrekin,West Midlands,1784,4320,337,318,208,196,5379,1803,4905,346,339,234,219,6043,773,292,310,219,204,1798,0.157594291539246,0.84393063583815,0.914454277286136,0.935897435897436,0.931506849315068,0.29753433724971
E02002948,Woodside,Telford and Wrekin,West Midlands,2247,4528,251,227,159,148,5313,2229,5122,252,269,169,181,5993,898,204,247,153,161,1663,0.175322139789145,0.80952380952381,0.9182156133829,0.905325443786982,0.889502762430939,0.277490405473052
E02002949,Madeley,Telford and Wrekin,West Midlands,853,3259,365,373,221,294,4512,818,3524,399,390,243,312,4868,862,349,364,227,297,2099,0.244608399545971,0.87468671679198,0.933333333333333,0.934156378600823,0.951923076923077,0.431183237469187
E02002950,Sutton Hill,Telford and Wrekin,West Midlands,1371,3263,316,300,264,254,4397,1462,3885,322,322,234,289,5052,575,257,298,218,265,1613,0.148005148005148,0.798136645962733,0.925465838509317,0.931623931623932,0.916955017301038,0.319279493269992
E02002951,Great Chell & Packmoor,Stoke-on-Trent,West Midlands,1381,4455,544,484,315,436,6234,1378,4903,506,553,317,453,6732,1318,463,523,305,429,3038,0.268815011217622,0.91501976284585,0.945750452079566,0.962145110410095,0.947019867549669,0.451277480689245
E02002952,Goldenhill & Sandyford,Stoke-on-Trent,West Midlands,1703,4610,307,295,241,339,5792,1896,5084,318,314,236,351,6303,1129,274,292,231,334,2260,0.2220692368214,0.861635220125786,0.929936305732484,0.978813559322034,0.951566951566952,0.358559416151039
E02002953,Bradeley & Chell Heath,Stoke-on-Trent,West Midlands,1523,4182,432,514,338,384,5850,1617,4551,452,470,380,408,6261,1139,394,444,364,387,2728,0.250274664908811,0.871681415929204,0.94468085106383,0.957894736842105,0.948529411764706,0.435713144865038
E02002954,Norton,Stoke-on-Trent,West Midlands,1744,4869,449,411,322,398,6449,1824,5195,462,406,332,432,6827,1399,409,387,318,408,2921,0.269297401347449,0.885281385281385,0.95320197044335,0.957831325301205,0.944444444444444,0.427859967775011
E02002955,Tunstall,Stoke-on-Trent,West Midlands,1980,4822,266,207,198,228,5721,2162,5690,285,230,186,228,6619,839,220,196,161,202,1618,0.147451669595782,0.771929824561403,0.852173913043478,0.865591397849462,0.885964912280702,0.244447801782747
E02002956,Little Chell & Stanfield,Stoke-on-Trent,West Midlands,2088,5725,438,382,260,358,7163,2126,6314,424,418,293,379,7828,1357,371,387,269,351,2735,0.214919227114349,0.875,0.925837320574163,0.918088737201365,0.926121372031662,0.349386816555953
E02002957,Baddley & Milton,Stoke-on-Trent,West Midlands,1703,5564,550,603,490,656,7863,1614,5931,526,634,503,720,8314,1693,494,609,495,682,3973,0.285449334007756,0.939163498098859,0.960567823343849,0.984095427435388,0.947222222222222,0.47786865528025
E02002958,Smallthorne & Sneyd Green,Stoke-on-Trent,West Midlands,1727,5062,393,389,293,376,6513,1800,5410,392,370,291,445,6908,1359,351,347,272,420,2749,0.251201478743068,0.895408163265306,0.937837837837838,0.934707903780069,0.943820224719101,0.397944412275622
E02002959,Longport & Burslem Park,Stoke-on-Trent,West Midlands,2160,6045,347,334,210,337,7273,2203,6442,347,306,236,337,7668,1104,258,276,219,305,2162,0.171375349270413,0.743515850144092,0.901960784313725,0.927966101694915,0.905044510385757,0.281950965049557
E02002960,Birches Head,Stoke-on-Trent,West Midlands,1023,3621,368,303,213,238,4743,999,3824,388,329,242,287,5070,1055,352,314,232,272,2225,0.275889121338912,0.907216494845361,0.954407294832827,0.958677685950413,0.947735191637631,0.438856015779093
E02002961,Cobridge & Central Forest,Stoke-on-Trent,West Midlands,1591,4562,236,241,185,201,5425,1931,5872,301,209,183,254,6819,823,202,183,170,226,1604,0.140156675749319,0.67109634551495,0.875598086124402,0.92896174863388,0.889763779527559,0.235225106320575
E02002962,Abbey Hulton,Stoke-on-Trent,West Midlands,1639,4321,347,360,254,352,5634,1937,5072,374,331,269,363,6409,1334,332,303,255,338,2562,0.26301261829653,0.887700534759358,0.915407854984894,0.947955390334572,0.931129476584022,0.399750351068809
E02002963,Northwood,Stoke-on-Trent,West Midlands,1377,4897,292,237,198,246,5870,1490,5505,322,265,194,245,6531,1090,263,233,182,219,1987,0.198001816530427,0.816770186335404,0.879245283018868,0.938144329896907,0.893877551020408,0.304241310672179
E02002964,Townsend & Eaton Park,Stoke-on-Trent,West Midlands,1540,4812,552,626,410,554,6954,1552,5256,534,611,438,573,7412,1479,479,584,417,549,3508,0.281392694063927,0.897003745318352,0.955810147299509,0.952054794520548,0.958115183246073,0.473286562331355
E02002965,Hanley & Etruria,Stoke-on-Trent,West Midlands,1868,5957,226,140,126,152,6601,2127,6889,248,188,130,169,7624,904,169,158,115,142,1488,0.131223689940485,0.681451612903226,0.840425531914894,0.884615384615385,0.840236686390533,0.195173137460651
E02002966,Shelton & Joiner's Square,Stoke-on-Trent,West Midlands,1573,7601,291,265,166,224,8547,1884,8805,310,279,173,236,9803,1031,214,249,151,212,1857,0.117092561044861,0.690322580645161,0.89247311827957,0.872832369942197,0.898305084745763,0.189431806589819
E02002967,Bentilee & Ubberley,Stoke-on-Trent,West Midlands,2733,6331,360,334,194,387,7606,2880,7022,401,327,199,369,8318,1708,309,298,187,342,2844,0.243235545428653,0.770573566084788,0.91131498470948,0.939698492462312,0.926829268292683,0.341909112767492
E02002968,Basford & Hartshill,Stoke-on-Trent,West Midlands,1596,6223,395,379,254,397,7648,1598,6550,441,403,247,418,8059,2006,378,374,238,386,3382,0.306259541984733,0.857142857142857,0.928039702233251,0.963562753036437,0.923444976076555,0.41965504405013
E02002969,Boothen & Penkhull,Stoke-on-Trent,West Midlands,1626,6595,352,360,225,298,7830,1733,7087,376,338,242,329,8372,1534,313,316,229,312,2704,0.216452659799633,0.832446808510638,0.93491124260355,0.946280991735537,0.948328267477204,0.322981366459627
E02002970,Fenton,Stoke-on-Trent,West Midlands,1644,5298,346,367,251,237,6499,1618,5577,379,356,279,282,6873,1056,326,334,265,260,2241,0.189349112426036,0.860158311345647,0.938202247191011,0.949820788530466,0.921985815602837,0.326058489742471
E02002971,Fen Park,Stoke-on-Trent,West Midlands,906,3092,340,274,125,117,3948,907,3384,310,320,182,154,4350,686,280,305,173,142,1586,0.202718676122931,0.903225806451613,0.953125,0.950549450549451,0.922077922077922,0.364597701149425
E02002972,Longton West & Sandford Hill,Stoke-on-Trent,West Midlands,1291,3884,323,341,225,228,5001,1298,4084,321,354,239,245,5243,903,286,336,227,231,1983,0.221106758080313,0.890965732087227,0.949152542372881,0.94979079497908,0.942857142857143,0.378218577150486
E02002973,Oakhill & Trent Vale,Stoke-on-Trent,West Midlands,1786,5430,357,303,219,295,6604,1645,5587,353,336,230,300,6806,1659,293,304,218,284,2758,0.29693932342939,0.830028328611898,0.904761904761905,0.947826086956522,0.946666666666667,0.405230678812812
E02002974,Weston Coyney,Stoke-on-Trent,West Midlands,1128,3259,391,438,305,457,4850,1128,3594,388,416,298,474,5170,949,366,398,288,451,2452,0.264051196438509,0.943298969072165,0.956730769230769,0.966442953020134,0.951476793248945,0.474274661508704
E02002975,Longton East,Stoke-on-Trent,West Midlands,1185,4486,423,421,305,252,5887,1130,4637,476,410,297,304,6124,1255,442,382,287,297,2663,0.270649126590468,0.928571428571429,0.931707317073171,0.966329966329966,0.976973684210526,0.434846505551927
E02002976,Hollybush & Blurton North,Stoke-on-Trent,West Midlands,1253,3632,301,355,204,271,4763,1276,3914,306,336,240,287,5083,907,279,320,232,279,2017,0.231732243229433,0.911764705882353,0.952380952380952,0.966666666666667,0.97212543554007,0.396812905764312
E02002977,Dresden,Stoke-on-Trent,West Midlands,849,3163,399,467,361,463,4853,938,3407,384,388,375,486,5040,816,356,358,355,465,2350,0.239506897563839,0.927083333333333,0.922680412371134,0.946666666666667,0.95679012345679,0.466269841269841
E02002978,Meir North,Stoke-on-Trent,West Midlands,1712,4045,293,279,176,268,5061,1681,4291,323,281,204,285,5384,912,282,254,190,267,1905,0.212537869960382,0.873065015479876,0.903914590747331,0.931372549019608,0.936842105263158,0.353826151560178
E02002979,Florence,Stoke-on-Trent,West Midlands,1587,3611,236,203,161,219,4430,1825,4309,262,206,165,203,5145,596,208,180,147,172,1303,0.13831515432815,0.793893129770992,0.87378640776699,0.890909090909091,0.847290640394089,0.253255587949466
E02002980,Hanford & Trentham West,Stoke-on-Trent,West Midlands,1047,3196,392,471,357,530,4946,969,3481,404,447,384,579,5295,941,323,414,359,550,2587,0.270324619362252,0.79950495049505,0.926174496644295,0.934895833333333,0.949913644214162,0.488574126534467
E02002981,Meir South & Lightwood,Stoke-on-Trent,West Midlands,2033,5270,344,306,239,237,6396,2105,5698,353,336,213,311,6911,1225,308,308,199,280,2320,0.214987714987715,0.872521246458924,0.916666666666667,0.934272300469484,0.90032154340836,0.335696715381276
E02002982,Newstead & Blurton South,Stoke-on-Trent,West Midlands,1892,5038,354,286,146,259,6083,2027,5461,410,313,194,247,6625,1267,336,276,182,228,2289,0.232008789598975,0.819512195121951,0.881789137380192,0.938144329896907,0.923076923076923,0.345509433962264
E02002983,Meir Park,Stoke-on-Trent,West Midlands,832,3014,342,381,276,238,4251,866,3303,375,369,286,275,4608,852,356,350,279,264,2101,0.25794732061762,0.949333333333333,0.948509485094851,0.975524475524475,0.96,0.455946180555556
E02002984,Trentham East,Stoke-on-Trent,West Midlands,834,3093,438,402,277,323,4533,863,3338,440,438,304,373,4893,934,370,419,289,343,2355,0.279808268424206,0.840909090909091,0.95662100456621,0.950657894736842,0.919571045576408,0.481299816063765
E02006008,Shifnal,Shropshire,West Midlands,1662,5701,527,575,401,529,7733,1812,6129,537,547,439,560,8212,1417,487,525,424,545,3398,0.231195953662914,0.906890130353817,0.959780621572212,0.965831435079727,0.973214285714286,0.413784705309303
E02006009,Cosford & Albrighton,Shropshire,West Midlands,1070,4204,373,388,344,591,5900,985,5012,321,416,364,616,6729,810,296,407,358,598,2469,0.161612130885874,0.922118380062305,0.978365384615385,0.983516483516483,0.970779220779221,0.366919304502898
E02006010,Much Wenlock & Broseley,Shropshire,West Midlands,1970,6764,889,883,573,717,9826,1831,6693,875,959,643,774,9944,1603,808,923,622,737,4693,0.239503959360526,0.923428571428571,0.962460896767466,0.967340590979782,0.952196382428941,0.471942880128721
E02006011,Bridgnorth West,Shropshire,West Midlands,935,3233,404,483,351,557,5028,825,3239,374,453,384,575,5025,730,342,427,375,561,2435,0.22537820314912,0.914438502673797,0.942604856512141,0.9765625,0.975652173913043,0.484577114427861
E02006012,Bridgnorth East,Shropshire,West Midlands,782,3642,525,516,404,489,5576,823,3643,475,533,406,554,5611,905,447,509,390,527,2778,0.248421630524293,0.941052631578947,0.954971857410882,0.960591133004926,0.951263537906137,0.495098912849759
E02006013,"Alveley, Claverley & Worfield",Shropshire,West Midlands,1113,4261,601,681,506,590,6639,1067,4448,559,649,543,647,6846,1007,513,622,520,624,3286,0.226393884892086,0.917710196779964,0.958397534668721,0.957642725598527,0.964451313755796,0.479988314344143
E02006014,Highley & Ditton Priors,Shropshire,West Midlands,1478,5410,775,822,582,617,8206,1334,5377,755,823,651,678,8284,1100,693,771,634,649,3847,0.204575041844895,0.917880794701987,0.93681652490887,0.973886328725038,0.957227138643068,0.464389183969097
E02006015,Whitchurch,Shropshire,West Midlands,1833,6259,609,659,450,689,8666,1727,6296,614,663,517,749,8839,1439,500,623,503,712,3777,0.228557814485388,0.814332247557003,0.939668174962293,0.972920696324952,0.950600801068091,0.427310781762643
E02006016,"Woore, Prees & Tilstock",Shropshire,West Midlands,1235,4718,653,690,465,475,7001,1194,4963,601,641,489,492,7186,1086,526,617,472,476,3177,0.218819262542817,0.875207986688852,0.962558502340094,0.965235173824131,0.967479674796748,0.442109657667687
E02006017,Ellesmere,Shropshire,West Midlands,1331,4789,545,545,395,542,6816,1251,4808,590,569,399,582,6948,952,462,477,345,490,2726,0.198003327787022,0.783050847457627,0.838312829525483,0.864661654135338,0.84192439862543,0.392343120322395
E02006018,Market Drayton,Shropshire,West Midlands,2248,7271,693,763,584,768,10079,2167,7249,707,781,667,808,10212,1734,528,748,637,774,4421,0.239205407642433,0.746817538896747,0.957746478873239,0.955022488755622,0.957920792079208,0.43292205248727
E02006019,Wem,Shropshire,West Midlands,1054,3647,394,425,291,532,5289,981,3690,379,420,344,536,5369,770,354,402,329,523,2378,0.208672086720867,0.934036939313984,0.957142857142857,0.956395348837209,0.975746268656716,0.442913019184206
E02006020,Hinstock & Hodnet,Shropshire,West Midlands,1261,5167,416,367,230,328,6508,1148,5142,451,392,274,347,6606,1055,401,365,260,325,2406,0.205173084402956,0.889135254988914,0.931122448979592,0.948905109489051,0.936599423631124,0.364214350590372
E02006021,"Baschurch, Cockshutt & Harmer Hill",Shropshire,West Midlands,1367,5283,587,530,372,439,7211,1459,5568,621,592,428,487,7696,1316,565,564,413,463,3321,0.236350574712644,0.909822866344605,0.952702702702703,0.964953271028037,0.950718685831622,0.431522869022869
E02006022,Shawbury & Weston,Shropshire,West Midlands,1085,3911,385,360,245,352,5253,1041,4050,406,368,285,353,5462,791,374,353,276,335,2129,0.195308641975309,0.921182266009852,0.959239130434783,0.968421052631579,0.949008498583569,0.389783961918711
E02006023,"Gobowen, St Martin's & Weston Rhyn",Shropshire,West Midlands,1794,5841,703,627,456,612,8239,1682,5971,675,668,460,629,8403,1059,337,336,245,351,2328,0.17735722659521,0.499259259259259,0.502994011976048,0.532608695652174,0.558028616852146,0.277043912888254
E02006024,Oswestry East,Shropshire,West Midlands,1902,6260,562,512,349,579,8262,1790,6247,589,547,409,560,8352,1808,536,517,387,529,3777,0.289418921082119,0.910016977928693,0.945155393053016,0.946210268948655,0.944642857142857,0.452227011494253
E02006025,Oswestry West,Shropshire,West Midlands,1600,5987,515,629,474,750,8355,1432,6182,522,580,516,736,8536,1494,469,543,480,704,3690,0.241669362665804,0.898467432950192,0.936206896551724,0.930232558139535,0.956521739130435,0.432286785379569
E02006026,"Ruyton-XI-Towns, West Felton & Whittington",Shropshire,West Midlands,1261,4170,533,476,345,364,5888,1250,4490,530,566,404,418,6408,1162,468,530,384,396,2940,0.258797327394209,0.883018867924528,0.936395759717314,0.95049504950495,0.947368421052632,0.458801498127341
E02006027,Trefonen & Pant,Shropshire,West Midlands,809,3074,436,436,308,428,4682,794,3197,422,413,312,447,4791,768,372,357,279,386,2162,0.24022521113544,0.881516587677725,0.864406779661017,0.894230769230769,0.863534675615213,0.451262784387393
E02006028,Bomere Heath & Montford Bridge,Shropshire,West Midlands,1498,5567,580,640,499,648,7934,1439,5679,637,652,526,727,8221,1356,589,622,510,674,3751,0.238774432118331,0.924646781789639,0.95398773006135,0.96958174904943,0.927097661623109,0.456270526699915
E02006029,Shrewsbury Harlescott Grange,Shropshire,West Midlands,1724,4928,388,371,300,410,6397,1657,5238,398,362,272,396,6666,1104,335,335,255,380,2409,0.210767468499427,0.841708542713568,0.925414364640884,0.9375,0.95959595959596,0.361386138613861
E02006030,Shrewsbury Harlescott & Sundorne,Shropshire,West Midlands,1761,5200,381,328,248,331,6488,1727,5415,382,355,259,356,6767,1169,340,340,245,329,2423,0.215881809787627,0.890052356020943,0.957746478873239,0.945945945945946,0.924157303370787,0.358061179252254
E02006031,Shrewsbury Greenfields,Shropshire,West Midlands,1350,5525,399,390,260,437,7011,1208,5330,424,354,300,423,6831,1107,366,325,283,400,2481,0.207692307692308,0.863207547169811,0.918079096045198,0.943333333333333,0.945626477541371,0.363197189284146
E02006032,Shrewsbury Monkmoor,Shropshire,West Midlands,1846,5506,467,484,345,362,7164,1726,5744,475,463,393,405,7480,1419,426,432,374,395,3046,0.247040389972145,0.896842105263158,0.93304535637149,0.951653944020356,0.975308641975309,0.407219251336898
E02006033,Shrewsbury Town,Shropshire,West Midlands,1054,5603,486,557,417,665,7728,1026,5529,512,530,433,708,7712,1219,455,502,421,669,3266,0.220473865075059,0.888671875,0.947169811320755,0.972286374133949,0.944915254237288,0.423495850622407
E02006034,Shrewsbury Copthorne & Bowbrook,Shropshire,West Midlands,1905,6327,586,540,392,552,8397,2013,6632,586,634,433,578,8863,1917,530,604,419,555,4025,0.289053075995175,0.904436860068259,0.952681388012618,0.967667436489607,0.960207612456747,0.454135168678777
E02006035,Shrewsbury London Road,Shropshire,West Midlands,752,2972,423,544,369,542,4850,804,3154,396,537,400,578,5065,778,374,523,393,565,2633,0.246670894102727,0.944444444444444,0.973929236499069,0.9825,0.977508650519031,0.519842053307009
E02006036,Shrewsbury Sutton & Coleham,Shropshire,West Midlands,964,3956,437,380,252,438,5463,909,4120,404,423,322,451,5720,1040,360,399,307,431,2537,0.252427184466019,0.891089108910891,0.943262411347518,0.953416149068323,0.955654101995565,0.443531468531469
E02006037,Shrewsbury Meole & Kingsland,Shropshire,West Midlands,1961,6133,591,556,436,657,8373,1891,6586,637,587,435,674,8919,1482,588,560,418,654,3702,0.225022775584573,0.923076923076923,0.954003407155026,0.960919540229885,0.970326409495549,0.415068953918601
E02006038,Bayston Hill & Atcham,Shropshire,West Midlands,1394,4663,615,586,429,526,6819,1453,4914,569,573,468,556,7080,1268,519,555,459,538,3339,0.258038258038258,0.912126537785589,0.968586387434555,0.980769230769231,0.967625899280575,0.471610169491525
E02006039,"Hanwood, Pontesbury & Minsterley",Shropshire,West Midlands,1388,4654,575,591,420,561,6801,1359,4842,581,633,508,624,7188,1095,539,614,491,601,3340,0.226146220570012,0.927710843373494,0.96998420221169,0.966535433070866,0.963141025641026,0.464663327768503
E02006040,"Cressage, Dorrington & Pulverbatch",Shropshire,West Midlands,1258,4784,486,581,412,435,6698,1155,4984,490,562,460,471,6967,982,445,537,438,439,2841,0.197030497592295,0.908163265306122,0.955516014234875,0.952173913043478,0.932059447983015,0.407779532079805
E02006041,"Bishop's Castle, Brockton & Chirbury",Shropshire,West Midlands,851,3414,494,473,307,406,5094,772,3357,481,502,331,400,5071,623,409,441,290,374,2137,0.18558236520703,0.85031185031185,0.878486055776892,0.876132930513595,0.935,0.421415894300927
E02006042,Church Stretton,Shropshire,West Midlands,703,3000,533,585,442,726,5286,617,3032,495,608,471,789,5395,840,396,579,452,748,3015,0.277044854881267,0.8,0.952302631578947,0.959660297239915,0.948035487959442,0.55885078776645
E02006043,Craven Arms & Broadstone,Shropshire,West Midlands,1048,3888,545,501,402,446,5782,1038,3955,530,508,433,465,5891,894,473,480,403,451,2701,0.226042983565108,0.892452830188679,0.944881889763779,0.930715935334873,0.96989247311828,0.45849601086403
E02006044,Clun & Bucknell,Shropshire,West Midlands,882,3417,583,599,377,480,5456,785,3414,578,631,442,489,5554,565,475,542,399,424,2405,0.165495020503808,0.821799307958478,0.858954041204438,0.902714932126697,0.867075664621677,0.433021245948866
E02006045,Ludlow Town,Shropshire,West Midlands,1527,6045,766,852,646,1152,9461,1479,5955,778,865,698,1180,9476,1509,723,815,673,1124,4844,0.253400503778338,0.929305912596401,0.942196531791908,0.964183381088825,0.952542372881356,0.511186154495568
E02006046,"Cleobury Mortimer, Burford & Ashford Carbonell",Shropshire,West Midlands,1382,5162,684,737,553,603,7739,1341,5150,727,690,633,675,7875,1292,661,668,615,646,3882,0.250873786407767,0.909215955983494,0.968115942028986,0.971563981042654,0.957037037037037,0.492952380952381
E02006118,Rugeley North & Etchinghill,Cannock Chase,West Midlands,1118,4353,537,569,441,463,6363,1105,4489,503,574,472,483,6521,1088,471,552,459,447,3017,0.242370238360437,0.936381709741551,0.961672473867596,0.972457627118644,0.925465838509317,0.462659101364821
E02006119,Rugeley Town,Cannock Chase,West Midlands,1533,5221,421,381,280,471,6774,1494,5432,391,439,294,470,7026,1183,353,412,282,449,2679,0.217783505154639,0.902813299232737,0.938496583143508,0.959183673469388,0.95531914893617,0.381298035866781
E02006120,Rugeley South & Brereton,Cannock Chase,West Midlands,1837,5786,497,468,361,498,7610,1827,5963,482,489,379,487,7800,1310,447,464,365,454,3040,0.219688076471575,0.927385892116183,0.948875255623722,0.963060686015831,0.932238193018481,0.38974358974359
E02006121,Hednesford Pye Green,Cannock Chase,West Midlands,1066,3779,319,312,194,197,4801,996,3740,351,317,214,221,4843,923,312,298,205,209,1947,0.246791443850267,0.888888888888889,0.94006309148265,0.957943925233645,0.945701357466063,0.402023539128639
E02006122,Hednesford Central,Cannock Chase,West Midlands,1352,5174,377,367,250,289,6457,1453,5065,382,342,272,301,6362,1210,341,325,259,280,2415,0.238894373149062,0.892670157068063,0.950292397660819,0.952205882352941,0.930232558139535,0.379597610814209
E02006123,Wimblebury & Cannock Wood,Cannock Chase,West Midlands,1126,4289,352,272,181,253,5347,1190,4372,374,329,231,290,5596,1063,342,313,219,276,2213,0.243138151875572,0.914438502673797,0.951367781155015,0.948051948051948,0.951724137931035,0.395461043602573
E02006124,Cannock North,Cannock Chase,West Midlands,1583,4707,373,361,215,340,5996,1530,4783,376,356,255,328,6098,1040,321,330,238,297,2226,0.217436755174577,0.853723404255319,0.926966292134832,0.933333333333333,0.905487804878049,0.365037717284356
E02006125,Cannock North East,Cannock Chase,West Midlands,1367,4620,402,427,323,300,6072,1308,4752,398,433,361,343,6287,1134,351,404,334,323,2546,0.238636363636364,0.881909547738693,0.933025404157044,0.925207756232687,0.941690962099125,0.40496262128201
E02006126,Hednesford South & Heath Hayes,Cannock Chase,West Midlands,1429,5237,412,490,272,404,6815,1404,5112,484,464,328,402,6790,1201,425,430,321,376,2753,0.234937402190923,0.878099173553719,0.926724137931035,0.978658536585366,0.935323383084577,0.405449189985272
E02006127,Hawks Green,Cannock Chase,West Midlands,1507,5191,338,202,124,197,6052,1429,5031,353,243,130,175,5932,1157,313,232,123,164,1989,0.229974160206718,0.886685552407932,0.954732510288066,0.946153846153846,0.937142857142857,0.335300067430883
E02006128,Cannock West & Mill Green,Cannock Chase,West Midlands,1173,5040,572,657,467,669,7405,1233,4988,536,693,492,736,7445,1214,472,660,473,703,3522,0.243384121892542,0.880597014925373,0.952380952380952,0.961382113821138,0.955163043478261,0.473069173942243
E02006129,Cannock South,Cannock Chase,West Midlands,1667,5376,364,363,287,440,6830,1594,5434,385,351,312,393,6875,1140,322,322,302,366,2452,0.20979020979021,0.836363636363636,0.917378917378917,0.967948717948718,0.931297709923664,0.356654545454545
E02006130,Norton Canes,Cannock Chase,West Midlands,1305,4587,422,457,335,376,6177,1456,5066,435,437,351,391,6680,1298,387,412,338,372,2807,0.256217923410975,0.889655172413793,0.94279176201373,0.962962962962963,0.951406649616368,0.420209580838323
E02006131,"Mayfield, Rocester & Bramshall",East Staffordshire,West Midlands,1182,4603,523,525,395,460,6506,1231,4834,506,564,393,530,6827,1026,468,545,379,515,2933,0.2122465866777,0.924901185770751,0.966312056737589,0.964376590330789,0.971698113207547,0.429617694448513
E02006132,Uttoxeter Heath,East Staffordshire,West Midlands,1322,3954,362,339,249,326,5230,1399,4521,323,349,282,336,5811,1028,292,342,276,321,2259,0.227383322273833,0.904024767801858,0.979942693409742,0.978723404255319,0.955357142857143,0.388745482705214
E02006133,Uttoxeter Town,East Staffordshire,West Midlands,1157,4379,342,348,280,409,5758,1145,4857,384,357,277,399,6274,1146,353,341,262,387,2489,0.235948116121062,0.919270833333333,0.955182072829132,0.945848375451263,0.969924812030075,0.396716608224418
E02006134,Rolleston-on-Dove & Tutbury,East Staffordshire,West Midlands,1648,5499,605,640,564,650,7958,1781,6393,632,664,539,714,8942,1718,593,636,524,691,4162,0.26873142499609,0.938291139240506,0.957831325301205,0.972170686456401,0.967787114845938,0.465443972265712
E02006135,Burton Stretton,East Staffordshire,West Midlands,1246,4450,474,510,361,504,6299,1211,4731,513,516,387,517,6664,1384,493,500,382,505,3264,0.292538575354048,0.961013645224171,0.968992248062015,0.987080103359173,0.97678916827853,0.489795918367347
E02006136,"Abbots Bromley, Yoxall & Marchington",East Staffordshire,West Midlands,1194,5231,563,656,498,581,7529,1166,5917,575,620,560,590,8262,1364,534,590,539,552,3579,0.230522224100051,0.928695652173913,0.951612903225806,0.9625,0.935593220338983,0.433188090050835
E02006137,Burton Horninglow,East Staffordshire,West Midlands,1991,5539,395,413,292,522,7161,2007,5963,411,391,320,460,7545,1494,350,363,308,434,2949,0.250545027670636,0.851581508515815,0.928388746803069,0.9625,0.943478260869565,0.390854870775348
E02006138,Burton Eton Park,East Staffordshire,West Midlands,2002,4807,232,198,126,175,5538,2134,5733,240,218,130,179,6500,972,182,183,112,150,1599,0.169544740973312,0.758333333333333,0.839449541284404,0.861538461538462,0.837988826815642,0.246
E02006139,Burton Shobnall,East Staffordshire,West Midlands,1998,5356,347,235,178,244,6360,2150,6012,343,287,160,268,7070,797,249,236,140,227,1649,0.132568196939454,0.725947521865889,0.822299651567944,0.875,0.847014925373134,0.233239038189533
E02006140,Burton Winshill,East Staffordshire,West Midlands,1798,5094,457,428,368,446,6793,1705,5412,449,453,378,469,7161,1275,397,437,357,445,2911,0.235587583148559,0.884187082405345,0.964679911699779,0.944444444444444,0.948827292110874,0.4065074710236
E02006141,Burton Central,East Staffordshire,West Midlands,2743,8296,348,260,218,319,9441,2986,9724,378,307,237,364,11010,1326,286,261,203,293,2369,0.136363636363636,0.756613756613757,0.850162866449512,0.856540084388186,0.804945054945055,0.215168029064487
E02006142,Burton Brizlincote,East Staffordshire,West Midlands,795,3100,318,355,236,289,4298,816,3285,355,372,242,301,4555,712,336,356,230,288,1922,0.216742770167428,0.946478873239437,0.956989247311828,0.950413223140496,0.956810631229236,0.421953896816685
E02006143,Branston,East Staffordshire,West Midlands,1555,4901,384,366,302,330,6283,1693,5552,409,395,282,349,6987,1383,373,382,270,333,2741,0.249099423631124,0.9119804400978,0.967088607594937,0.957446808510638,0.954154727793696,0.392299985687706
E02006144,Burton Stapenhill,East Staffordshire,West Midlands,1616,4794,448,403,265,446,6356,1598,5545,428,416,287,419,7095,900,350,380,271,393,2294,0.162308385933273,0.817757009345795,0.913461538461539,0.944250871080139,0.937947494033413,0.323326286116984
E02006145,Barton-under-Needwood,East Staffordshire,West Midlands,1103,3320,428,468,269,409,4894,1044,3538,403,445,337,397,5120,800,374,422,318,378,2292,0.226116449971735,0.928039702233251,0.948314606741573,0.943620178041543,0.952141057934509,0.44765625
E02006146,Armitage & Colton,Lichfield,West Midlands,1537,5170,543,549,388,432,7082,1517,5218,516,544,436,439,7153,1206,470,508,420,417,3021,0.231123035645841,0.910852713178295,0.933823529411765,0.963302752293578,0.949886104783599,0.422340276806934
E02006147,"Alrewas, Fradley & King's Bromley",Lichfield,West Midlands,1510,4841,504,527,372,436,6680,1455,5101,484,532,410,482,7009,1087,446,518,391,461,2903,0.213095471476181,0.921487603305785,0.973684210526316,0.953658536585366,0.95643153526971,0.414181766300471
E02006148,Burntwood North East & Longdon,Lichfield,West Midlands,1070,3945,527,604,435,379,5890,1055,4349,495,592,513,435,6384,1000,454,570,493,414,2931,0.229937916762474,0.917171717171717,0.962837837837838,0.961013645224171,0.951724137931035,0.459116541353384
E02006149,Lichfield Central,Lichfield,West Midlands,2217,6715,544,528,475,819,9081,1992,6812,529,522,486,809,9158,1285,416,479,469,769,3418,0.188637698179683,0.786389413988658,0.917624521072797,0.965020576131687,0.950556242274413,0.373225595108102
E02006150,Lichfield East,Lichfield,West Midlands,1669,6508,841,934,632,838,9753,1721,7002,842,946,688,873,10351,1447,733,899,663,826,4568,0.206655241359612,0.870546318289786,0.950317124735729,0.963662790697675,0.946162657502864,0.441310018355714
E02006151,Burntwood West,Lichfield,West Midlands,1632,5690,526,550,474,433,7673,1637,5883,531,559,510,476,7959,1424,477,525,502,460,3388,0.242053374128846,0.898305084745763,0.9391771019678,0.984313725490196,0.966386554621849,0.425681618293756
E02006152,Lichfield West & South,Lichfield,West Midlands,1870,6185,485,702,444,612,8428,1898,6401,511,684,500,618,8714,1220,446,647,475,586,3374,0.190595219496954,0.87279843444227,0.945906432748538,0.95,0.948220064724919,0.387193022722057
E02006153,"Whittington, Hopwas & Clifton Campville",Lichfield,West Midlands,1375,4665,468,494,365,421,6413,1551,5778,494,487,418,465,7642,1233,438,460,401,446,2978,0.213395638629284,0.88663967611336,0.944558521560575,0.95933014354067,0.959139784946237,0.38968856320335
E02006154,Burntwood Chase Terrace & Hammerwich,Lichfield,West Midlands,1383,5324,666,942,769,685,8386,1307,5387,634,858,798,764,8441,1308,588,819,768,736,4219,0.242806757007611,0.927444794952681,0.954545454545455,0.962406015037594,0.963350785340314,0.4998222959365
E02006155,Burntwood Chasetown,Lichfield,West Midlands,1269,3569,261,274,231,220,4555,1226,3670,253,271,232,238,4664,759,220,261,225,222,1687,0.206811989100817,0.869565217391304,0.96309963099631,0.969827586206897,0.932773109243698,0.361706689536878
E02006156,"Shenstone, Stonnall & Little Aston",Lichfield,West Midlands,1165,4329,511,634,514,721,6709,1157,4649,527,600,529,736,7041,1292,481,576,514,691,3554,0.277909227790923,0.912713472485768,0.96,0.97164461247637,0.938858695652174,0.504757846896748
E02006157,"Fazeley, Mile Oak & Drayton Basset",Lichfield,West Midlands,1222,4704,400,412,293,378,6187,1142,4433,416,409,317,388,5963,787,381,395,301,364,2228,0.177532145274081,0.915865384615385,0.965770171149144,0.949526813880126,0.938144329896907,0.373637430823411
E02006158,Kidsgrove East,Newcastle-under-Lyme,West Midlands,1143,5057,529,567,415,337,6905,1151,5197,532,590,471,433,7223,1398,480,570,453,418,3319,0.269001346930922,0.902255639097744,0.966101694915254,0.961783439490446,0.965357967667437,0.459504361068808
E02006159,Kidsgrove Central,Newcastle-under-Lyme,West Midlands,1052,3448,357,356,220,334,4715,1081,3578,340,352,272,344,4886,891,299,337,265,334,2126,0.249021799888206,0.879411764705882,0.957386363636364,0.974264705882353,0.970930232558139,0.435120753172329
E02006160,Kidsgrove West,Newcastle-under-Lyme,West Midlands,1497,5280,535,566,384,451,7216,1564,5372,548,576,394,456,7346,1336,466,553,377,434,3166,0.248696947133284,0.85036496350365,0.960069444444444,0.956852791878173,0.951754385964912,0.430982847808331
E02006161,Talke & Crackley,Newcastle-under-Lyme,West Midlands,1080,4369,374,427,325,354,5849,1058,4320,380,411,325,394,5830,1124,331,392,316,379,2542,0.260185185185185,0.871052631578947,0.953771289537713,0.972307692307692,0.961928934010152,0.436020583190395
E02006162,Audley & Bignall End,Newcastle-under-Lyme,West Midlands,1357,5235,581,550,369,457,7192,1313,5332,531,615,395,521,7394,1286,469,590,381,505,3231,0.241185296324081,0.883239171374765,0.959349593495935,0.964556962025316,0.969289827255278,0.436975926426833
E02006163,Bradwell,Newcastle-under-Lyme,West Midlands,1652,5076,423,373,309,467,6648,1611,5243,388,374,299,411,6715,1168,345,338,280,397,2528,0.222773221438108,0.889175257731959,0.903743315508021,0.936454849498328,0.965936739659367,0.376470588235294
E02006164,Chesterton & Knutton,Newcastle-under-Lyme,West Midlands,1669,4991,389,297,195,429,6301,1602,4896,389,324,219,356,6184,1093,291,299,210,334,2227,0.223243464052288,0.748071979434447,0.92283950617284,0.958904109589041,0.938202247191011,0.360122897800776
E02006165,Porthill,Newcastle-under-Lyme,West Midlands,1340,5179,368,432,247,417,6643,1222,4956,360,438,275,446,6475,1093,307,413,258,421,2492,0.220540758676352,0.852777777777778,0.942922374429224,0.938181818181818,0.943946188340807,0.384864864864865
E02006166,May Bank,Newcastle-under-Lyme,West Midlands,1120,4470,397,433,297,421,6018,1124,4583,444,449,319,451,6246,1148,413,432,300,427,2720,0.250490944795985,0.93018018018018,0.962138084632517,0.940438871473354,0.946784922394679,0.435478706372078
E02006167,Newcastle West & Cross Heath,Newcastle-under-Lyme,West Midlands,2015,6671,416,385,307,455,8234,1997,6582,445,400,303,407,8137,1366,363,365,290,373,2757,0.207535703433607,0.815730337078652,0.9125,0.957095709570957,0.916461916461916,0.338822661914711
E02006168,Newcastle Town,Newcastle-under-Lyme,West Midlands,1087,6583,372,357,288,609,8209,1006,5868,381,363,272,603,7487,1151,319,324,249,555,2598,0.19614860259032,0.837270341207349,0.892561983471074,0.915441176470588,0.920398009950249,0.347001469213303
E02006169,Silverdale & Keele,Newcastle-under-Lyme,West Midlands,1111,7426,301,287,205,265,8484,1125,7225,300,307,232,263,8327,1023,265,286,219,248,2041,0.14159169550173,0.883333333333333,0.931596091205212,0.943965517241379,0.94296577946768,0.245106280773388
E02006170,Madeley & Betley,Newcastle-under-Lyme,West Midlands,836,3114,357,407,248,380,4506,784,3152,337,418,285,426,4618,908,304,397,279,413,2301,0.288071065989848,0.902077151335311,0.949760765550239,0.978947368421053,0.969483568075117,0.498267648332612
E02006171,Clayton & Langdale,Newcastle-under-Lyme,West Midlands,1642,5405,521,514,421,661,7522,1643,5649,502,534,405,657,7747,1478,457,510,389,630,3464,0.261639228181979,0.910358565737052,0.955056179775281,0.960493827160494,0.958904109589041,0.447140828707887
E02006172,Westlands & Seabridge,Newcastle-under-Lyme,West Midlands,1432,5422,635,660,497,768,7982,1469,5757,655,688,561,845,8506,1696,595,662,534,806,4293,0.294597880840716,0.908396946564885,0.962209302325581,0.951871657754011,0.953846153846154,0.504702562896779
E02006173,Loggerheads & Baldwins Gate,Newcastle-under-Lyme,West Midlands,931,3989,584,601,374,505,6053,907,4284,551,616,421,486,6358,985,462,590,404,471,2912,0.229925303454715,0.838475499092559,0.957792207792208,0.959619952494062,0.969135802469136,0.458005662157911
E02006174,Penkridge & Acton Trussell,South Staffordshire,West Midlands,1614,6032,761,798,614,648,8853,1616,6278,738,817,648,709,9190,1623,690,794,627,679,4413,0.258521822236381,0.934959349593496,0.971848225214198,0.967592592592593,0.957686882933709,0.480195865070729
E02006175,Huntington,South Staffordshire,West Midlands,1380,4718,318,328,275,265,5904,1351,4502,300,317,274,263,5656,998,266,299,261,251,2075,0.221679253665038,0.886666666666667,0.943217665615142,0.952554744525547,0.954372623574145,0.366867043847242
E02006176,Brewood & Wheaton Aston,South Staffordshire,West Midlands,1132,4453,502,593,438,557,6543,1118,4475,523,589,479,566,6632,1071,492,570,466,546,3145,0.239329608938548,0.940726577437859,0.967741935483871,0.97286012526096,0.964664310954064,0.474215922798553
E02006177,Cheslyn Hay,South Staffordshire,West Midlands,1659,5769,670,676,541,571,8227,1564,5949,654,678,592,606,8479,1581,577,656,566,576,3956,0.265758951084216,0.882262996941896,0.967551622418879,0.956081081081081,0.95049504950495,0.466564453355349
E02006178,Great Wyrley,South Staffordshire,West Midlands,1174,4804,476,573,405,395,6653,1200,4803,437,547,433,436,6656,1362,393,526,416,409,3106,0.283572767020612,0.899313501144165,0.961608775137111,0.960739030023095,0.938073394495413,0.466646634615385
E02006179,"Featherstone West, Coven & Shareshill",South Staffordshire,West Midlands,962,6622,469,486,420,399,8396,970,7384,440,471,422,452,9169,1290,394,449,404,428,2965,0.174702058504875,0.895454545454546,0.953290870488323,0.957345971563981,0.946902654867257,0.323372232522631
E02006180,Featherstone East & Essington,South Staffordshire,West Midlands,1243,4093,402,371,297,546,5709,1302,4337,385,366,320,548,5956,1134,346,347,308,520,2655,0.261471062946737,0.898701298701299,0.948087431693989,0.9625,0.948905109489051,0.445768972464741
E02006181,Bilbrook,South Staffordshire,West Midlands,989,3293,343,345,289,463,4733,950,3334,328,368,281,457,4768,679,293,352,274,441,2039,0.203659268146371,0.893292682926829,0.956521739130435,0.97508896797153,0.964989059080963,0.427642617449664
E02006182,Codsall,South Staffordshire,West Midlands,1175,3917,422,516,429,594,5878,1206,4129,397,481,471,620,6098,977,363,459,457,606,2862,0.236619036086219,0.914357682619647,0.954261954261954,0.970276008492569,0.97741935483871,0.469334207937029
E02006183,Perton West & Pattingham,South Staffordshire,West Midlands,1166,4567,566,460,331,435,6359,1122,4534,587,499,342,467,6429,980,541,485,331,453,2790,0.216144684605205,0.921635434412266,0.971943887775551,0.967836257309941,0.970021413276231,0.433971068595427
E02006184,Perton East,South Staffordshire,West Midlands,981,3256,387,290,173,194,4300,873,3265,395,331,194,227,4412,590,352,322,183,222,1669,0.180704441041348,0.891139240506329,0.972809667673716,0.943298969072165,0.977973568281938,0.378286491387126
E02006185,Wombourne Inner,South Staffordshire,West Midlands,1241,4219,451,456,383,591,6100,1197,4366,422,444,396,611,6239,1144,385,417,376,581,2903,0.262024736601008,0.912322274881517,0.939189189189189,0.949494949494949,0.950900163666121,0.465298926109954
E02006186,"Wombourne Outer, Swindon & Seisdon",South Staffordshire,West Midlands,1851,7488,833,879,667,1123,10990,1764,7378,855,865,658,1092,10848,1867,767,831,635,1056,5156,0.25304960693955,0.897076023391813,0.960693641618497,0.965045592705167,0.967032967032967,0.475294985250738
E02006187,Kinver,South Staffordshire,West Midlands,969,3948,566,614,525,602,6255,963,4098,518,622,547,652,6437,899,445,599,527,614,3084,0.219375305026842,0.859073359073359,0.963022508038585,0.963436928702011,0.941717791411043,0.479105173217337
E02006188,Fulford & Meir Heath,Stafford,West Midlands,989,3299,433,452,357,523,5064,923,3445,398,429,400,511,5183,922,371,419,389,486,2587,0.267634252539913,0.9321608040201,0.976689976689977,0.9725,0.951076320939335,0.499131776963149
E02006189,"Barlaston, Tittensor & Swynnerton",Stafford,West Midlands,1106,4172,563,581,378,618,6312,1016,4000,530,571,435,621,6157,1062,452,546,422,604,3086,0.2655,0.852830188679245,0.956217162872154,0.970114942528736,0.972624798711755,0.501218125710573
E02006190,Stone Town,Stafford,West Midlands,1991,6470,590,570,432,783,8845,1923,6710,549,624,492,776,9151,1713,490,589,462,744,3998,0.255290611028316,0.892531876138434,0.943910256410256,0.939024390243902,0.958762886597938,0.436892142935198
E02006191,Little Stoke & Milwich,Stafford,West Midlands,1303,4734,589,605,419,430,6777,1246,4767,606,606,460,455,6894,1282,580,577,445,438,3322,0.268932242500524,0.957095709570957,0.952145214521452,0.967391304347826,0.962637362637363,0.481868291267769
E02006192,Eccleshall & Yarnfield,Stafford,West Midlands,1425,5368,584,626,426,505,7509,1416,5530,629,598,492,555,7804,1476,593,563,465,539,3636,0.266907775768535,0.942766295707472,0.941471571906355,0.945121951219512,0.971171171171171,0.465914915427986
E02006193,Stafford Common & Great Bridgeford,Stafford,West Midlands,1125,4123,405,433,416,438,5815,1322,4600,424,425,412,488,6349,1411,396,402,392,470,3071,0.306739130434783,0.933962264150943,0.945882352941176,0.951456310679612,0.963114754098361,0.483698220192156
E02006194,Doxey & Holmcroft,Stafford,West Midlands,1723,5112,373,356,325,550,6716,1726,5426,347,403,318,510,7004,1527,307,373,307,495,3009,0.281422779211205,0.884726224783862,0.925558312655087,0.965408805031447,0.970588235294118,0.429611650485437
E02006195,Weston & Haywood,Stafford,West Midlands,1343,4938,679,763,477,542,7399,1292,5074,672,753,568,601,7668,1251,638,722,551,585,3747,0.246551044540796,0.949404761904762,0.958831341301461,0.970070422535211,0.973377703826955,0.488654147104851
E02006196,Stafford North East,Stafford,West Midlands,1341,5347,313,248,196,229,6333,1354,5324,302,256,209,223,6314,1308,249,232,187,195,2171,0.245679939894816,0.824503311258278,0.90625,0.894736842105263,0.874439461883408,0.343839087741527
E02006197,Central Stafford,Stafford,West Midlands,1743,6639,298,314,238,392,7881,1709,6913,342,310,274,426,8265,1329,286,284,251,395,2545,0.192246492116303,0.83625730994152,0.916129032258065,0.916058394160584,0.927230046948357,0.307924984875983
E02006198,Littleworth & Hopton,Stafford,West Midlands,1505,6044,470,461,349,465,7789,1604,6904,475,503,366,502,8750,1564,445,481,350,474,3314,0.226535341830823,0.936842105263158,0.956262425447316,0.956284153005464,0.944223107569721,0.378742857142857
E02006199,Rowley & Derrington,Stafford,West Midlands,1135,4869,502,563,420,602,6956,1204,5279,557,555,456,627,7474,1543,518,527,435,596,3619,0.2922902064785,0.929982046678636,0.94954954954955,0.953947368421053,0.950558213716108,0.484211934706984
E02006200,Highfields & Burton Manor,Stafford,West Midlands,1657,4924,380,333,286,351,6274,1684,5160,384,363,288,361,6556,1340,335,338,270,341,2624,0.25968992248062,0.872395833333333,0.931129476584022,0.9375,0.944598337950139,0.400244051250763
E02006201,Weeping Cross & Brocton,Stafford,West Midlands,2256,6577,769,898,721,900,9865,2159,6961,748,921,764,975,10369,1973,708,893,746,953,5273,0.283436287889671,0.946524064171123,0.969598262757872,0.976439790575916,0.977435897435898,0.50853505641817
E02006202,Gnosall & Haughton,Stafford,West Midlands,1332,5356,693,729,513,547,7838,1285,6095,682,746,552,620,8695,1468,633,708,535,599,3943,0.240853158326497,0.928152492668622,0.949061662198391,0.969202898550725,0.966129032258065,0.45347901092582
E02006203,Mosspit & Silkmore Lane,Stafford,West Midlands,1552,4944,409,422,284,322,6381,1533,5025,404,431,312,345,6517,1372,358,397,293,320,2740,0.273034825870647,0.886138613861386,0.921113689095128,0.939102564102564,0.927536231884058,0.420438852232622
E02006204,Leek East & Upper Hulme,Staffordshire Moorlands,West Midlands,1384,4517,503,478,310,429,6237,1455,4640,447,527,344,470,6428,1013,392,490,332,452,2679,0.218318965517241,0.876957494407159,0.929791271347249,0.965116279069768,0.961702127659574,0.416770379589297
E02006205,Biddulph Moor & Rudyard,Staffordshire Moorlands,West Midlands,1010,4224,661,658,470,473,6486,951,4147,588,704,479,540,6458,1159,552,677,464,526,3378,0.279479141548107,0.938775510204082,0.961647727272727,0.968684759916493,0.974074074074074,0.523072158563023
E02006206,Biddulph Central,Staffordshire Moorlands,West Midlands,1794,5390,370,301,200,418,6679,1665,5326,381,331,210,339,6587,1684,340,322,202,326,2874,0.316184754036801,0.89238845144357,0.972809667673716,0.961904761904762,0.96165191740413,0.436313951723091
E02006207,Biddulph North & Brownlees,Staffordshire Moorlands,West Midlands,865,3347,515,612,418,479,5371,826,3475,475,626,498,540,5614,1120,446,612,489,526,3193,0.322302158273381,0.938947368421053,0.977635782747604,0.981927710843373,0.974074074074074,0.568756679729248
E02006208,Leek Town,Staffordshire Moorlands,West Midlands,1425,5265,451,440,270,419,6845,1373,5257,467,453,298,457,6932,1001,422,435,282,432,2572,0.190412782956059,0.903640256959315,0.960264900662252,0.946308724832215,0.945295404814004,0.371032890940566
E02006209,Leek South & Cheddleton,Staffordshire Moorlands,West Midlands,1777,6383,706,819,544,766,9218,1641,6380,721,799,607,800,9307,1289,679,770,591,774,4103,0.202037617554859,0.941747572815534,0.963704630788486,0.973640856672158,0.9675,0.440850972386376
E02006210,"Ipstones, Warslow & Hamps Valley",Staffordshire Moorlands,West Midlands,769,3246,425,415,304,337,4727,756,3186,455,406,322,334,4703,660,395,385,305,307,2052,0.207156308851224,0.868131868131868,0.948275862068965,0.947204968944099,0.919161676646707,0.436317244312141
E02006211,Endon & Brown Edge,Staffordshire Moorlands,West Midlands,950,3606,452,466,440,574,5538,922,3730,407,478,415,633,5663,1035,381,456,401,610,2883,0.277479892761394,0.936117936117936,0.95397489539749,0.966265060240964,0.963665086887836,0.509094119724528
E02006212,Werrington & Wetley Rocks,Staffordshire Moorlands,West Midlands,1178,4432,552,627,430,634,6675,1146,4647,549,604,468,656,6924,1148,514,582,458,624,3326,0.247041101786099,0.936247723132969,0.963576158940397,0.978632478632479,0.951219512195122,0.480358174465627
E02006213,"Cheadle North, Alton & Kingsley",Staffordshire Moorlands,West Midlands,1034,3982,414,452,321,361,5530,1014,4132,417,462,369,386,5766,1028,376,446,354,375,2579,0.248789932236205,0.90167865707434,0.965367965367965,0.959349593495935,0.971502590673575,0.447277141866112
E02006214,Cheadle Town,Staffordshire Moorlands,West Midlands,996,3727,400,453,347,364,5291,966,3729,383,418,360,387,5277,912,363,402,349,380,2406,0.244569589702333,0.947780678851175,0.961722488038277,0.969444444444444,0.981912144702842,0.455940875497442
E02006215,"Blythe Bridge, Forsbrook & Caverswall",Staffordshire Moorlands,West Midlands,1159,4658,555,622,441,512,6788,1127,4614,538,594,469,569,6784,1181,507,571,454,547,3260,0.255960121369744,0.942379182156134,0.961279461279461,0.968017057569296,0.961335676625659,0.480542452830189
E02006216,Cheadle South & Upper Tean,Staffordshire Moorlands,West Midlands,1413,5089,611,685,445,466,7296,1341,4922,572,689,478,520,7181,1147,532,665,466,499,3309,0.233035351483137,0.93006993006993,0.965166908563135,0.97489539748954,0.959615384615385,0.460799331569419
E02006217,Coton Farm & Perry Crofts,Tamworth,West Midlands,1609,5122,562,670,540,683,7577,1747,6109,614,643,521,707,8594,1138,554,614,498,676,3480,0.186282533966279,0.90228013029316,0.954898911353033,0.955854126679463,0.956152758132956,0.404933674656737
E02006218,Central Tamworth,Tamworth,West Midlands,1378,5070,393,459,361,625,6908,1436,5678,433,468,396,523,7498,920,366,423,379,486,2574,0.162028883409651,0.84526558891455,0.903846153846154,0.957070707070707,0.92925430210325,0.343291544411843
E02006219,Amington,Tamworth,West Midlands,1436,4804,482,422,255,230,6193,1498,5351,491,469,305,251,6867,930,440,445,298,239,2352,0.173799289852364,0.896130346232179,0.948827292110874,0.977049180327869,0.952191235059761,0.342507645259939
E02006220,Bolehall,Tamworth,West Midlands,1338,4342,440,462,428,410,6082,1289,4622,429,436,405,472,6364,853,384,413,395,457,2502,0.1845521419299,0.895104895104895,0.947247706422018,0.975308641975309,0.968220338983051,0.393148962916405
E02006221,Kettlebrook,Tamworth,West Midlands,1062,4050,306,291,172,153,4972,960,4151,318,297,174,168,5108,637,278,279,166,160,1520,0.153456998313659,0.874213836477987,0.939393939393939,0.954022988505747,0.952380952380952,0.297572435395458
E02006222,Belgrave,Tamworth,West Midlands,1446,4205,393,376,245,253,5472,1376,4517,386,412,268,288,5871,677,344,394,254,277,1946,0.14987823776843,0.89119170984456,0.956310679611651,0.947761194029851,0.961805555555556,0.331459717254301
E02006223,Glascote Heath,Tamworth,West Midlands,1876,4206,304,291,160,162,5123,1808,4694,311,329,182,156,5672,653,273,299,173,137,1535,0.13911376224968,0.877813504823151,0.908814589665653,0.950549450549451,0.878205128205128,0.270627644569817
E02006224,Wilnecote East,Tamworth,West Midlands,1439,4953,415,314,165,188,6035,1395,5065,493,356,205,179,6298,846,452,332,194,166,1990,0.167028627838105,0.91683569979716,0.932584269662921,0.946341463414634,0.927374301675978,0.315973324865037
E02006225,Dosthill & Two Gates,Tamworth,West Midlands,1280,4277,500,471,282,362,5892,1303,4702,501,484,329,385,6401,784,454,470,319,365,2392,0.166737558485751,0.906187624750499,0.971074380165289,0.969604863221885,0.948051948051948,0.37369161068583
E02006226,Wilnecote West & Hockley,Tamworth,West Midlands,2016,6156,488,386,231,301,7562,2079,6488,465,447,274,317,7991,1057,413,415,262,301,2448,0.162916152897657,0.888172043010753,0.92841163310962,0.956204379562044,0.949526813880126,0.306344637717432
E02006468,"Polesworth, Warton & Austrey",North Warwickshire,West Midlands,1942,6586,627,747,501,608,9069,1836,6782,668,694,522,609,9275,1601,627,653,505,572,3958,0.236066057210262,0.938622754491018,0.940922190201729,0.967432950191571,0.939244663382594,0.426738544474394
E02006469,"Dordon, Hurley & Wood End",North Warwickshire,West Midlands,1841,5685,486,466,297,425,7359,1707,5706,473,455,349,406,7389,1264,419,430,330,378,2821,0.221521205748335,0.885835095137421,0.945054945054945,0.945558739255014,0.931034482758621,0.38178373257545
E02006470,Atherstone,North Warwickshire,West Midlands,2221,7219,710,692,477,702,9800,2125,7681,664,709,541,677,10272,1263,549,666,516,617,3611,0.164431714620492,0.826807228915663,0.93935119887165,0.953789279112754,0.911373707533235,0.351538161993769
E02006471,Kingsbury & Curdworth,North Warwickshire,West Midlands,993,4216,490,512,388,348,5954,1025,4413,517,540,393,377,6240,1194,472,510,379,353,2908,0.270564242012237,0.912959381044487,0.944444444444444,0.964376590330789,0.936339522546419,0.466025641025641
E02006472,Hartshill & Ansley,North Warwickshire,West Midlands,1686,5872,580,546,409,456,7863,1784,6187,533,577,437,520,8254,1207,473,547,411,479,3117,0.195086471634071,0.887429643527205,0.948006932409012,0.940503432494279,0.921153846153846,0.3776350860189
E02006473,Coleshill & Water Orton,North Warwickshire,West Midlands,1634,6212,564,611,438,701,8526,1682,6683,590,677,479,730,9159,2403,559,655,456,701,4774,0.359569055813258,0.947457627118644,0.967503692762186,0.951983298538622,0.96027397260274,0.521235942788514
E02006474,New Arley & Fillongley,North Warwickshire,West Midlands,1070,3814,401,416,285,390,5306,1060,4019,423,406,293,394,5535,1033,380,375,281,366,2435,0.257029111719333,0.898345153664303,0.923645320197044,0.959044368600683,0.928934010152284,0.439927732610659
E02006475,Weddington & St Nicholas Park,Nuneaton and Bedworth,West Midlands,1741,4806,527,483,390,536,6742,1828,5647,502,530,377,562,7618,1293,457,508,361,523,3142,0.228971135115991,0.910358565737052,0.958490566037736,0.957559681697613,0.930604982206406,0.412444211079023
E02006476,Camp Hill,Nuneaton and Bedworth,West Midlands,2221,5409,352,326,218,283,6588,2263,6234,381,339,244,292,7490,1163,335,304,221,258,2281,0.186557587423805,0.879265091863517,0.896755162241888,0.905737704918033,0.883561643835616,0.304539385847797
E02006477,Horeston Grange,Nuneaton and Bedworth,West Midlands,1333,4525,469,466,328,426,6214,1577,5364,453,500,356,461,7134,1206,429,479,329,426,2869,0.224832214765101,0.947019867549669,0.958,0.924157303370787,0.924078091106291,0.402158676759181
E02006478,Galley Common & Whittleford,Nuneaton and Bedworth,West Midlands,1592,5113,390,336,211,160,6210,1615,5700,470,365,240,197,6972,1175,424,343,220,180,2342,0.206140350877193,0.902127659574468,0.93972602739726,0.916666666666667,0.913705583756345,0.335915088927137
E02006479,Nuneaton Town Centre,Nuneaton and Bedworth,West Midlands,1668,6254,411,353,257,301,7576,1761,6945,428,353,305,339,8370,1029,338,302,265,281,2215,0.148164146868251,0.789719626168224,0.855524079320113,0.868852459016394,0.828908554572271,0.264635603345281
E02006480,Tomkinson Road,Nuneaton and Bedworth,West Midlands,1549,4599,430,354,280,254,5917,1498,4983,379,373,249,259,6243,1051,341,344,228,224,2188,0.210917118201886,0.899736147757256,0.92225201072386,0.91566265060241,0.864864864864865,0.350472529232741
E02006481,Stockingford,Nuneaton and Bedworth,West Midlands,1536,4258,326,357,273,256,5470,1667,4686,341,389,326,285,6027,984,301,355,310,259,2209,0.209987195902689,0.882697947214076,0.912596401028278,0.950920245398773,0.908771929824561,0.366517338642774
E02006482,Bermuda & Heath End,Nuneaton and Bedworth,West Midlands,1367,4514,381,413,196,251,5755,1427,4724,368,410,258,277,6037,1056,324,380,244,257,2261,0.223539373412362,0.880434782608696,0.926829268292683,0.945736434108527,0.927797833935018,0.374523770084479
E02006483,Caldwell & Chilvers Coton,Nuneaton and Bedworth,West Midlands,1770,5009,382,377,227,407,6402,1678,5246,375,389,259,428,6697,870,295,341,232,384,2122,0.165840640487991,0.786666666666667,0.876606683804627,0.895752895752896,0.897196261682243,0.316858294758847
E02006484,Attleborough,Nuneaton and Bedworth,West Midlands,1462,4718,355,374,265,413,6125,1420,5139,376,325,279,403,6522,972,320,304,256,375,2227,0.189141856392294,0.851063829787234,0.935384615384615,0.917562724014337,0.930521091811414,0.341459674946336
E02006485,Whitestone,Nuneaton and Bedworth,West Midlands,851,3718,532,497,355,414,5516,866,4102,512,557,398,474,6043,819,465,529,387,453,2653,0.199658703071672,0.908203125,0.949730700179533,0.972361809045226,0.955696202531646,0.439020354128744
E02006486,Bedworth Woodlands,Nuneaton and Bedworth,West Midlands,1223,4269,399,408,290,369,5735,1190,4648,426,417,330,415,6236,1115,359,385,301,370,2530,0.239888123924269,0.842723004694836,0.92326139088729,0.912121212121212,0.891566265060241,0.405708787684413
E02006487,Bedworth Town,Nuneaton and Bedworth,West Midlands,1244,3986,428,442,355,421,5632,1265,4403,393,437,372,414,6019,937,333,409,348,367,2394,0.212809448103566,0.847328244274809,0.935926773455378,0.935483870967742,0.886473429951691,0.397740488453231
E02006488,Bulkington,Nuneaton and Bedworth,West Midlands,875,3115,457,555,480,614,5221,871,3480,440,518,488,650,5576,755,383,476,461,609,2684,0.216954022988506,0.870454545454546,0.918918918918919,0.944672131147541,0.936923076923077,0.481348637015782
E02006489,Bedworth Coalpit Field & Exhall,Nuneaton and Bedworth,West Midlands,1762,5092,371,409,204,225,6301,1772,5553,396,392,296,265,6902,1140,327,345,279,233,2324,0.205294435440303,0.825757575757576,0.880102040816326,0.942567567567568,0.879245283018868,0.336713995943205
E02006490,Bedworth Heath,Nuneaton and Bedworth,West Midlands,1597,4660,413,350,261,439,6123,1563,4979,395,439,286,429,6528,1239,322,412,268,397,2638,0.248845149628439,0.815189873417722,0.938496583143508,0.937062937062937,0.925407925407925,0.404105392156863
E02006806,Ash Green & Keresley End,Nuneaton and Bedworth,West Midlands,1788,5202,437,395,293,450,6777,1757,5804,448,396,347,474,7469,1375,375,369,321,435,2875,0.236905582356995,0.837053571428571,0.931818181818182,0.92507204610951,0.917721518987342,0.384924353996519
E02006492,"Brinklow, Wolvey & Clifton",Rugby,West Midlands,2652,8308,674,621,466,647,10716,3013,10060,685,668,521,664,12598,1851,628,623,499,629,4230,0.183996023856859,0.916788321167883,0.932634730538922,0.957773512476008,0.947289156626506,0.335767582155898
E02006493,Brownsover,Rugby,West Midlands,2334,6834,479,356,204,221,8094,2206,7764,475,409,249,231,9128,1219,420,376,235,219,2469,0.157006697578568,0.884210526315789,0.919315403422983,0.943775100401606,0.948051948051948,0.270486415425066
E02006494,Town North & Newbold on Avon,Rugby,West Midlands,1517,4852,324,287,232,366,6061,1331,5510,348,288,234,383,6763,709,276,257,220,356,1818,0.128675136116152,0.793103448275862,0.892361111111111,0.94017094017094,0.929503916449086,0.26881561437232
E02006495,"Wolston, Binley Woods & Ryton",Rugby,West Midlands,1320,4304,477,559,443,484,6267,1280,4891,462,528,463,515,6859,1245,438,506,455,502,3146,0.254549171948477,0.948051948051948,0.958333333333333,0.982721382289417,0.974757281553398,0.458667444233853
E02006496,Town East,Rugby,West Midlands,1390,4987,198,209,151,145,5690,1323,5897,230,220,132,183,6662,701,179,184,113,161,1338,0.118874003730711,0.778260869565217,0.836363636363636,0.856060606060606,0.879781420765027,0.200840588411888
E02006497,New Bilton,Rugby,West Midlands,1729,5692,282,237,190,249,6650,1654,6282,299,257,201,275,7314,794,247,232,182,251,1706,0.126392868513212,0.826086956521739,0.90272373540856,0.90547263681592,0.912727272727273,0.233251298878862
E02006498,Cawston & Long Lawford,Rugby,West Midlands,3368,8141,552,601,316,395,10005,3275,9130,539,632,418,444,11163,1693,496,602,399,422,3612,0.185432639649507,0.920222634508349,0.95253164556962,0.954545454545455,0.95045045045045,0.323568933082505
E02006499,Eastlands,Rugby,West Midlands,1171,3533,260,327,239,352,4711,1330,4279,291,315,272,384,5541,808,272,295,260,370,2005,0.188829165692919,0.934707903780069,0.936507936507937,0.955882352941176,0.963541666666667,0.361848041869699
E02006500,Town South & School,Rugby,West Midlands,1136,3446,310,340,285,453,4834,1197,3998,310,318,314,398,5338,605,277,296,300,378,1856,0.151325662831416,0.893548387096774,0.930817610062893,0.955414012738854,0.949748743718593,0.347695766204571
E02006501,Hillmorton,Rugby,West Midlands,2081,5720,487,531,550,667,7955,2010,6112,518,499,506,636,8271,1158,476,472,489,606,3201,0.18946335078534,0.918918918918919,0.945891783567134,0.966403162055336,0.952830188679245,0.387014871236852
E02006502,Overslade & Bilton,Rugby,West Midlands,1811,5725,629,809,648,1108,8919,1859,6575,598,791,692,1065,9721,1333,542,755,664,1028,4322,0.202737642585551,0.906354515050167,0.95448798988622,0.959537572254335,0.965258215962441,0.444604464561259
E02006503,"Dunchurch, Stretton-on-Dunsmore & Marton",Rugby,West Midlands,1526,4623,519,661,474,721,6998,1871,5781,547,627,555,710,8220,1279,511,606,535,689,3620,0.221241999654039,0.93418647166362,0.966507177033493,0.963963963963964,0.970422535211268,0.440389294403893
E02006504,"Earlswood, Tanworth-in-Arden & Sambourne",Stratford-on-Avon,West Midlands,897,3274,433,444,366,411,4928,901,3643,455,423,381,450,5352,970,428,405,363,427,2593,0.266264068075762,0.940659340659341,0.957446808510638,0.952755905511811,0.948888888888889,0.48449177877429
E02006505,Henley-in-Arden & Claverdon,Stratford-on-Avon,West Midlands,987,3525,476,648,466,678,5793,1038,4103,473,586,512,681,6355,1093,439,557,483,651,3223,0.266390446015111,0.928118393234672,0.950511945392492,0.943359375,0.955947136563877,0.507159716758458
E02006506,Studley,Stratford-on-Avon,West Midlands,1123,3350,351,369,299,450,4819,1046,3561,339,408,333,459,5100,1039,314,390,325,435,2503,0.291771974164561,0.926253687315634,0.955882352941176,0.975975975975976,0.947712418300654,0.49078431372549
E02006507,"Southam, Stockton & Napton",Stratford-on-Avon,West Midlands,1785,5917,520,566,424,589,8016,1833,7117,557,628,502,648,9452,1991,518,608,485,617,4219,0.279752704791345,0.929982046678636,0.968152866242038,0.966135458167331,0.95216049382716,0.446360558611934
E02006508,"Harbury, Long Itchington & Fenny Compton",Stratford-on-Avon,West Midlands,1817,6097,621,719,522,589,8548,1937,6861,667,656,589,606,9379,1777,616,615,571,589,4168,0.259000145751348,0.923538230884558,0.9375,0.969439728353141,0.971947194719472,0.444397057255571
E02006509,Alcester,Stratford-on-Avon,West Midlands,929,3415,382,462,324,589,5172,902,3567,415,442,379,518,5321,1044,380,420,363,495,2702,0.292682926829268,0.91566265060241,0.950226244343891,0.95778364116095,0.955598455598455,0.507799285848525
E02006510,Wilmcote & Great Alne,Stratford-on-Avon,West Midlands,1091,3811,506,552,443,530,5842,1044,4315,497,566,485,606,6469,1022,470,542,462,586,3082,0.236848203939745,0.945674044265593,0.957597173144876,0.952577319587629,0.966996699669967,0.47642603184418
E02006511,Wellesbourne & Snitterfield,Stratford-on-Avon,West Midlands,1780,5722,623,731,431,705,8212,1926,6719,677,698,535,721,9350,1527,629,666,518,701,4041,0.227265962196756,0.929098966026588,0.954154727793696,0.96822429906542,0.972260748959778,0.432192513368984
E02006512,Stratford North,Stratford-on-Avon,West Midlands,1973,7854,611,661,458,760,10344,2022,9252,691,715,544,743,11945,1884,593,668,517,705,4367,0.203631647211414,0.858176555716353,0.934265734265734,0.950367647058824,0.94885598923284,0.36559229803265
E02006513,Stratford South East & Tiddington,Stratford-on-Avon,West Midlands,1511,4732,463,531,409,655,6790,1461,5299,474,532,426,720,7451,1245,435,498,408,699,3285,0.234949990564257,0.917721518987342,0.93609022556391,0.957746478873239,0.970833333333333,0.44088041873574
E02006514,Stratford South West,Stratford-on-Avon,West Midlands,1274,5358,633,675,503,923,8092,1265,6163,624,695,536,884,8902,1380,551,644,508,852,3935,0.22391692357618,0.88301282051282,0.926618705035971,0.947761194029851,0.963800904977376,0.44203549764098
E02006515,Bidford & Welford,Stratford-on-Avon,West Midlands,1868,6100,685,733,501,668,8687,1946,6958,724,773,557,685,9697,1545,666,733,536,663,4143,0.222046565104915,0.919889502762431,0.948253557567917,0.96229802513465,0.967883211678832,0.427245539857688
E02006516,"Kineton, Tysoe & Warmington",Stratford-on-Avon,West Midlands,1553,5597,589,678,369,532,7765,1530,6308,640,647,494,574,8663,1600,577,612,468,541,3798,0.253646163601776,0.9015625,0.945904173106646,0.947368421052632,0.942508710801394,0.438416253030128
E02006517,Lower Quinton & Ettington,Stratford-on-Avon,West Midlands,1774,5167,524,602,360,511,7164,1895,6081,569,601,473,498,8222,1151,526,578,448,485,3188,0.189278079263279,0.924428822495606,0.961730449251248,0.947145877378435,0.973895582329317,0.387740209194843
E02006518,Shipston-on-Stour & Brailes,Stratford-on-Avon,West Midlands,1429,5247,724,715,594,855,8135,1439,5920,726,799,624,840,8909,1255,659,759,592,805,4070,0.211993243243243,0.907713498622589,0.949937421777222,0.948717948717949,0.958333333333333,0.456841396340779
E02006519,Kenilworth West,Warwick,West Midlands,1166,4154,481,546,427,675,6283,1303,5109,517,530,455,670,7281,1253,476,503,442,646,3320,0.245253474261108,0.920696324951644,0.949056603773585,0.971428571428571,0.964179104477612,0.455981321247081
E02006520,Kenilworth East,Warwick,West Midlands,1333,4770,473,524,369,557,6693,1430,5439,490,536,438,621,7524,1496,457,500,421,597,3471,0.275050560764846,0.93265306122449,0.932835820895522,0.961187214611872,0.961352657004831,0.461323763955343
E02006521,Kenilworth South,Warwick,West Midlands,1219,3900,419,535,403,664,5921,1218,4471,446,526,429,721,6593,1303,410,493,414,702,3322,0.291433683739656,0.919282511210762,0.937262357414449,0.965034965034965,0.973647711511789,0.503867738510541
E02006522,Kingswood & Leek Wootton,Warwick,West Midlands,800,3106,362,418,270,284,4440,884,3736,429,423,319,348,5255,1003,398,403,302,329,2435,0.268468950749465,0.927738927738928,0.952718676122931,0.946708463949843,0.945402298850575,0.46336822074215
E02006523,"Cubbington, Stoneleigh & Radford Semele",Warwick,West Midlands,1857,8601,595,622,475,777,11070,1737,6188,612,660,516,792,8768,1682,563,636,501,765,4147,0.271816418875242,0.919934640522876,0.963636363636364,0.970930232558139,0.965909090909091,0.472969890510949
E02006524,Lillington,Warwick,West Midlands,1117,3332,262,263,186,319,4362,1086,3795,282,268,196,295,4836,924,242,248,190,275,1879,0.243478260869565,0.858156028368794,0.925373134328358,0.969387755102041,0.932203389830508,0.388544251447477
E02006525,Leamington Central & North,Warwick,West Midlands,2024,9080,539,662,488,885,11654,2043,10004,599,685,550,906,12744,1912,526,628,516,837,4419,0.191123550579768,0.878130217028381,0.916788321167883,0.938181818181818,0.923841059602649,0.346751412429379
E02006526,Warwick North,Warwick,West Midlands,1438,5169,521,495,327,458,6970,1507,5787,595,514,402,458,7756,1533,539,477,373,424,3346,0.26490409538621,0.905882352941176,0.928015564202335,0.927860696517413,0.925764192139738,0.431407942238267
E02006527,Leamington West & Milverton,Warwick,West Midlands,1439,6460,455,452,316,529,8212,1494,7141,443,503,374,491,8952,1394,370,458,346,437,3005,0.195210754796247,0.835214446952596,0.910536779324056,0.925133689839572,0.890020366598778,0.335679177837355
E02006528,Leamington East & Sydenham,Warwick,West Midlands,1675,7969,430,358,270,377,9404,1795,8744,478,430,301,394,10347,1585,402,390,283,369,3029,0.181267154620311,0.841004184100419,0.906976744186047,0.940199335548173,0.936548223350254,0.292741857543249
E02006529,Warwick South West & Aylesford,Warwick,West Midlands,2627,7997,527,520,329,585,9958,2640,8744,535,558,388,555,10780,2037,476,520,362,510,3905,0.232959743824337,0.889719626168224,0.931899641577061,0.93298969072165,0.918918918918919,0.362244897959184
E02006530,"Warwick South East, Myton & Heathcote",Warwick,West Midlands,2343,7187,538,564,430,568,9287,2509,8661,562,585,483,662,10953,1999,496,547,459,628,4129,0.230804756956472,0.882562277580071,0.935042735042735,0.950310559006211,0.948640483383686,0.37697434492833
E02006531,Leamington Brunswick,Warwick,West Midlands,1697,8186,354,250,159,291,9240,1661,8443,395,273,197,278,9586,1389,310,245,185,257,2386,0.16451498282601,0.784810126582278,0.897435897435897,0.939086294416244,0.924460431654676,0.248904652618402
E02006532,"Bishops Tachbrook, Barford & Hatton Park",Warwick,West Midlands,2050,5829,510,542,340,439,7660,2441,7203,523,528,422,446,9122,1782,475,508,395,432,3592,0.247396917950854,0.908221797323136,0.962121212121212,0.936018957345972,0.968609865470852,0.393773295329972
E02006533,Whitnash,Warwick,West Midlands,1960,6201,407,366,391,489,7854,2008,7169,468,407,351,532,8927,1724,433,389,331,502,3379,0.240479843771795,0.925213675213675,0.955773955773956,0.943019943019943,0.943609022556391,0.378514618572869
E02006696,Hagley,Bromsgrove,West Midlands,1587,3906,323,414,374,558,5575,1516,4224,320,397,391,592,5924,1113,295,382,380,563,2733,0.263494318181818,0.921875,0.962216624685139,0.971867007672634,0.951013513513514,0.461343686698177
E02006697,"Dodford, Belbroughton & Romsley",Bromsgrove,West Midlands,1189,4271,531,541,357,617,6317,1162,4517,527,513,403,568,6528,895,442,484,381,543,2745,0.198140358645118,0.838709677419355,0.943469785575049,0.945409429280397,0.955985915492958,0.420496323529412
E02006698,Rubery West,Bromsgrove,West Midlands,1083,3911,391,360,284,494,5440,1095,4128,402,390,263,489,5672,1007,380,379,256,473,2495,0.243943798449612,0.945273631840796,0.971794871794872,0.973384030418251,0.967280163599182,0.439880112834979
E02006699,Hollywood & Drakes Cross,Bromsgrove,West Midlands,1099,3313,405,441,352,455,4966,1089,3381,399,407,350,481,5018,575,363,394,338,463,2133,0.170068027210884,0.909774436090226,0.968058968058968,0.965714285714286,0.962577962577963,0.425069748903946
E02006700,Wythall & Gay Hill,Bromsgrove,West Midlands,995,3457,384,423,352,649,5265,1077,3766,434,396,404,569,5569,731,389,378,386,539,2423,0.194105151354222,0.8963133640553,0.954545454545455,0.955445544554455,0.947275922671353,0.435087089244029
E02006701,Barnt Green & Lickey Hills,Bromsgrove,West Midlands,1382,4068,442,378,333,417,5638,1380,4450,447,414,344,460,6115,1083,411,402,330,447,2673,0.243370786516854,0.919463087248322,0.971014492753623,0.959302325581395,0.971739130434783,0.437121831561734
E02006702,Catshill,Bromsgrove,West Midlands,1214,3683,328,356,216,328,4911,1199,3889,326,356,247,348,5166,877,307,335,241,325,2085,0.225507842633068,0.941717791411043,0.941011235955056,0.975708502024291,0.933908045977011,0.403600464576074
E02006703,Marlbrook & Lickey End,Bromsgrove,West Midlands,1405,4610,473,442,351,441,6317,1479,4949,488,475,368,501,6781,1225,446,460,359,481,2971,0.247524752475248,0.913934426229508,0.968421052631579,0.97554347826087,0.960079840319361,0.438135968146291
E02006704,"Alvechurch, Hopwood & Holt End",Bromsgrove,West Midlands,1319,3984,494,443,347,528,5796,1219,4060,482,467,383,532,5924,1004,439,432,369,505,2749,0.247290640394089,0.910788381742739,0.925053533190578,0.963446475195822,0.949248120300752,0.464044564483457
E02006705,Bromsgrove Sidemoor,Bromsgrove,West Midlands,1348,4519,376,381,274,401,5951,1451,4749,390,385,314,401,6239,1175,359,358,300,389,2581,0.247420509580964,0.92051282051282,0.92987012987013,0.955414012738854,0.970074812967581,0.413688091040231
E02006706,Bromsgrove Central & Sanders Park,Bromsgrove,West Midlands,1164,4437,413,390,348,700,6288,1123,4543,382,432,364,662,6383,932,356,405,346,635,2674,0.205150781421968,0.931937172774869,0.9375,0.950549450549451,0.959214501510574,0.418925270249099
E02006707,Bromsgrove Stoney Hill,Bromsgrove,West Midlands,1507,4094,339,401,261,391,5486,1430,4344,323,411,279,386,5743,979,310,400,272,378,2339,0.22536832412523,0.959752321981424,0.97323600973236,0.974910394265233,0.979274611398964,0.407278425909803
E02006708,Bromsgrove Charford,Bromsgrove,West Midlands,1858,5368,382,315,216,331,6612,1712,5327,360,344,239,309,6579,1085,322,322,222,296,2247,0.203679369250986,0.894444444444445,0.936046511627907,0.928870292887029,0.957928802588997,0.341541267669859
E02006709,"Stoke Heath, Finstall & Bentley",Bromsgrove,West Midlands,1217,5269,525,499,288,371,6952,1222,5683,534,485,358,367,7427,1221,485,471,335,346,2858,0.214851310927327,0.908239700374532,0.971134020618557,0.935754189944134,0.942779291553134,0.384812171805574
E02006710,"Tenbury Wells, Mamble & Clifton",Malvern Hills,West Midlands,1283,4448,610,690,505,663,6916,1275,4777,636,699,539,637,7288,1641,592,672,522,618,4045,0.343521038308562,0.930817610062893,0.96137339055794,0.968460111317254,0.970172684458399,0.555021953896817
E02006711,"Abberley, Holt Heath & Hallow",Malvern Hills,West Midlands,1346,4612,646,638,471,586,6953,1288,4980,626,631,474,650,7361,2009,594,605,455,634,4297,0.403413654618474,0.94888178913738,0.958795562599049,0.959915611814346,0.975384615384615,0.583752207580492
E02006712,"Broadheath, Sinton & Alfrick",Malvern Hills,West Midlands,1176,4007,576,593,420,586,6182,1226,4444,538,607,446,596,6631,1618,512,580,431,566,3707,0.364086408640864,0.951672862453531,0.955518945634267,0.966367713004484,0.949664429530201,0.559040868647263
E02006713,Malvern Link,Malvern Hills,West Midlands,951,3674,371,437,359,646,5487,893,3735,371,446,388,629,5569,946,334,421,370,609,2680,0.253279785809906,0.900269541778976,0.943946188340807,0.95360824742268,0.968203497615262,0.481235410307057
E02006714,"Colletts Green, Callow End & Hanley",Malvern Hills,West Midlands,844,3009,425,497,359,516,4806,841,3276,397,510,379,525,5087,812,376,490,369,512,2559,0.247863247863248,0.947103274559194,0.96078431372549,0.973614775725594,0.975238095238095,0.503046982504423
E02006715,North Malvern,Malvern Hills,West Midlands,1535,5284,552,504,339,425,7104,1526,5525,528,547,351,448,7399,1257,470,519,342,434,3022,0.227511312217195,0.890151515151515,0.948811700182815,0.974358974358974,0.96875,0.408433572104338
E02006716,Malvern Pickersleigh,Malvern Hills,West Midlands,1418,3726,340,324,241,348,4979,1433,4093,329,353,267,345,5387,1062,302,328,247,333,2272,0.259467383337405,0.917933130699088,0.929178470254957,0.925093632958801,0.965217391304348,0.421756079450529
E02006717,Kempsey & Ryall,Malvern Hills,West Midlands,1058,3535,475,523,378,501,5412,1061,3796,476,514,400,521,5707,946,450,493,385,508,2782,0.249209694415174,0.945378151260504,0.959143968871595,0.9625,0.975047984644914,0.4874715261959
E02006718,Barnard's Green,Malvern Hills,West Midlands,926,3295,454,513,366,663,5291,882,3547,441,541,385,646,5560,864,407,516,379,625,2791,0.243586129123203,0.922902494331066,0.953789279112754,0.984415584415584,0.967492260061919,0.501978417266187
E02006719,Malvern Wells & Priory,Malvern Hills,West Midlands,1005,4417,630,636,414,791,6888,966,4573,604,665,457,743,7042,856,549,630,439,703,3177,0.187185654931117,0.908940397350993,0.947368421052632,0.960612691466083,0.946164199192463,0.451150241408691
E02006720,"Upton-upon-Severn, Welland & Eldersfield",Malvern Hills,West Midlands,1046,3927,563,534,451,617,6092,962,4223,577,564,431,624,6419,916,524,534,423,604,3001,0.216907411792565,0.908145580589255,0.946808510638298,0.981438515081206,0.967948717948718,0.467518305031936
E02006721,Riverside & Church Hill North,Redditch,West Midlands,1125,3562,434,457,285,305,5043,1140,3772,464,513,315,332,5396,689,418,490,298,316,2211,0.182661717921527,0.900862068965517,0.955165692007797,0.946031746031746,0.951807228915663,0.409747961452928
E02006722,Church Hill South,Redditch,West Midlands,1337,3375,310,217,88,88,4078,1280,3725,280,263,110,111,4489,481,225,246,97,98,1147,0.129127516778524,0.803571428571429,0.935361216730038,0.881818181818182,0.882882882882883,0.255513477389174
E02006723,Batchley & Brockhill,Redditch,West Midlands,2101,5432,364,301,207,378,6682,2057,5987,367,332,228,349,7263,954,304,304,214,326,2102,0.159345248037414,0.828337874659401,0.91566265060241,0.93859649122807,0.934097421203438,0.289412088668594
E02006724,Redditch Town & Abbeydale,Redditch,West Midlands,1597,4817,248,181,149,215,5610,1566,5499,280,229,153,240,6401,597,190,199,134,182,1302,0.108565193671577,0.678571428571429,0.868995633187773,0.875816993464052,0.758333333333333,0.203405717856585
E02006725,Winyates Green,Redditch,West Midlands,1063,3520,426,270,171,132,4519,1089,3809,390,341,180,167,4887,539,306,313,163,157,1478,0.141506957206616,0.784615384615385,0.917888563049853,0.905555555555556,0.940119760479042,0.3024350317168
E02006726,Southcrest,Redditch,West Midlands,1269,4226,301,295,210,256,5288,1228,4554,365,317,221,264,5721,662,322,287,211,241,1723,0.145366710584102,0.882191780821918,0.905362776025237,0.954751131221719,0.912878787878788,0.301171123929383
E02006727,Arrow Valley & Ipsley,Redditch,West Midlands,1077,3534,382,399,277,314,4906,1066,3794,404,408,292,344,5242,646,353,383,281,325,1988,0.170268845545598,0.873762376237624,0.938725490196078,0.962328767123288,0.944767441860465,0.379244563143838
E02006728,Webheath,Redditch,West Midlands,1249,4206,502,383,307,505,5903,1302,4622,521,432,340,505,6420,900,474,413,329,472,2588,0.194720900043271,0.90978886756238,0.956018518518519,0.967647058823529,0.934653465346535,0.403115264797508
E02006729,Matchborough & Park Farm,Redditch,West Midlands,1400,4284,501,491,219,217,5712,1472,4868,473,523,287,219,6370,886,400,489,274,202,2251,0.182004930156122,0.845665961945032,0.934990439770555,0.954703832752613,0.922374429223744,0.353375196232339
E02006730,Greenlands,Redditch,West Midlands,1694,4141,265,269,131,160,4966,1696,4466,260,252,193,158,5329,630,204,231,176,144,1385,0.141065830721003,0.784615384615385,0.916666666666667,0.911917098445596,0.911392405063291,0.25989866766748
E02006731,Oakenshaw,Redditch,West Midlands,1028,3356,346,348,264,267,4581,955,3573,363,350,275,268,4829,651,313,332,262,256,1814,0.182199832073887,0.862258953168044,0.948571428571429,0.952727272727273,0.955223880597015,0.375647131911369
E02006732,Crabbs Cross,Redditch,West Midlands,1197,4347,438,439,263,320,5807,1133,4498,450,440,316,387,6091,858,412,417,300,373,2360,0.190751445086705,0.915555555555556,0.947727272727273,0.949367088607595,0.963824289405685,0.387456903628304
E02006733,Hunt End & Feckenham,Redditch,West Midlands,1034,3539,408,450,264,334,4995,1007,3731,395,422,308,285,5141,644,347,399,290,277,1957,0.172607879924953,0.878481012658228,0.945497630331754,0.941558441558442,0.971929824561404,0.380665240225637
E02006734,Northwick,Worcester,West Midlands,1473,4514,523,509,387,670,6603,1485,4912,518,502,455,619,7006,1281,479,478,438,589,3265,0.26078990228013,0.924710424710425,0.952191235059761,0.962637362637363,0.951534733441034,0.466029117898944
E02006735,Warndon West,Worcester,West Midlands,1425,3316,201,174,159,221,4071,1424,3749,235,186,151,224,4545,942,211,165,139,208,1665,0.251267004534543,0.897872340425532,0.887096774193548,0.920529801324503,0.928571428571429,0.366336633663366
E02006736,Warndon East,Worcester,West Midlands,1213,4338,232,200,147,151,5068,1203,4797,255,225,171,174,5622,1316,233,214,163,165,2091,0.274338127996665,0.913725490196078,0.951111111111111,0.953216374269006,0.948275862068965,0.371931696905016
E02006737,Barbourne & Rainbow Hill,Worcester,West Midlands,1424,5259,418,447,302,320,6746,1398,5463,437,455,332,350,7037,1355,396,422,315,339,2827,0.248032216730734,0.906178489702517,0.927472527472528,0.948795180722892,0.968571428571429,0.401733693335228
E02006738,King George's Field,Worcester,West Midlands,2224,5569,352,310,251,288,6770,2250,6818,437,318,243,296,8112,1485,381,286,217,265,2634,0.217805808154884,0.871853546910755,0.89937106918239,0.893004115226337,0.89527027027027,0.324704142011834
E02006739,Henwick,Worcester,West Midlands,602,3848,260,291,285,405,5089,555,3590,281,289,281,411,4852,916,261,274,275,391,2117,0.255153203342618,0.928825622775801,0.948096885813149,0.97864768683274,0.951338199513382,0.436314921681781
E02006740,Worcester Town North,Worcester,West Midlands,851,5855,318,274,195,290,6932,783,5866,362,313,210,314,7065,1124,300,286,197,288,2195,0.191612683259461,0.828729281767956,0.913738019169329,0.938095238095238,0.917197452229299,0.310686482661005
E02006741,Lyppard Grange,Worcester,West Midlands,1235,3930,236,237,123,268,4794,1297,4401,262,249,151,246,5309,1300,245,230,137,227,2139,0.295387411951829,0.935114503816794,0.923694779116466,0.907284768211921,0.922764227642276,0.40290073460162
E02006742,Dines Green & St Johns,Worcester,West Midlands,1662,5691,408,368,305,402,7174,1637,5979,389,392,308,426,7494,1569,350,373,294,395,2981,0.262418464626192,0.89974293059126,0.951530612244898,0.954545454545455,0.927230046948357,0.397784894582333
E02006743,Ronkswood & Nunnery Wood,Worcester,West Midlands,1433,4130,326,309,163,189,5117,1555,4709,330,333,188,209,5769,1254,289,308,169,192,2212,0.26629857719261,0.875757575757576,0.924924924924925,0.898936170212766,0.91866028708134,0.383428670480153
E02006744,Worcester Town South,Worcester,West Midlands,1304,5129,300,237,164,286,6116,1241,5718,348,284,188,286,6824,1191,281,248,174,267,2161,0.208289611752361,0.807471264367816,0.873239436619718,0.925531914893617,0.933566433566433,0.316676436107855
E02006745,Lower Wick & Bromwich Road,Worcester,West Midlands,1388,4763,523,530,360,603,6779,1418,5354,534,585,388,644,7505,1429,504,557,373,621,3484,0.266903249906612,0.943820224719101,0.952136752136752,0.961340206185567,0.964285714285714,0.464223850766156
E02006746,Battenhall & Diglis,Worcester,West Midlands,1457,5226,473,467,283,426,6875,1457,5655,465,546,352,461,7479,1455,422,504,321,440,3142,0.257294429708223,0.90752688172043,0.923076923076923,0.911931818181818,0.954446854663775,0.420109640326247
E02006747,St Peters,Worcester,West Midlands,940,3476,258,293,176,254,4457,917,3751,293,319,225,279,4867,994,270,304,215,271,2054,0.264996001066382,0.921501706484642,0.952978056426332,0.955555555555556,0.971326164874552,0.422025888637765
E02006748,Hartlebury & Wychbold,Wychavon,West Midlands,1502,4622,517,483,356,505,6483,1588,5349,505,533,364,520,7271,1465,473,507,358,504,3307,0.273882968779211,0.936633663366337,0.951219512195122,0.983516483516483,0.969230769230769,0.45482051987347
E02006749,Droitwich Spa West & North,Wychavon,West Midlands,1214,3069,308,316,175,197,4065,1196,3582,296,301,184,194,4557,947,266,287,174,186,1860,0.264377442769403,0.898648648648649,0.953488372093023,0.945652173913043,0.958762886597938,0.408163265306122
E02006750,Droitwich Spa East,Wychavon,West Midlands,809,3002,347,396,308,580,4633,812,3150,331,401,330,605,4817,869,307,383,321,586,2466,0.275873015873016,0.927492447129909,0.955112219451372,0.972727272727273,0.968595041322314,0.51193689018061
E02006751,Droitwich Spa Central,Wychavon,West Midlands,1041,3333,403,427,318,469,4950,991,3601,326,421,315,443,5106,1079,301,407,306,420,2513,0.299638989169675,0.923312883435583,0.966745843230404,0.971428571428571,0.948081264108352,0.492166079122601
E02006752,Droitwich Spa South,Wychavon,West Midlands,1290,4399,484,547,335,412,6177,1462,5091,517,528,366,456,6958,1326,500,513,355,440,3134,0.260459634649381,0.967117988394584,0.971590909090909,0.969945355191257,0.964912280701754,0.450416786432883
E02006753,Fernhill Heath & Ombersley,Wychavon,West Midlands,1203,3945,457,510,352,418,5682,1285,4450,506,497,365,470,6288,1586,481,478,351,444,3340,0.356404494382022,0.950592885375494,0.961770623742455,0.961643835616438,0.94468085106383,0.53117048346056
E02006754,Crowle & Tibberton,Wychavon,West Midlands,909,3200,439,484,324,316,4763,880,3360,424,470,347,348,4949,864,402,451,340,334,2391,0.257142857142857,0.94811320754717,0.959574468085106,0.979827089337176,0.959770114942529,0.483127904627197
E02006755,Inkberrow & Flyford Flavell,Wychavon,West Midlands,820,3147,436,490,393,435,4901,781,3466,450,459,416,483,5274,752,420,440,400,471,2483,0.216964800923254,0.933333333333333,0.958605664488017,0.961538461538461,0.975155279503106,0.470800151687524
E02006756,Drakes Broughton & Norton,Wychavon,West Midlands,1251,3809,370,325,214,348,5066,1223,4037,363,367,248,296,5311,1012,341,352,238,291,2234,0.250681198910082,0.939393939393939,0.959128065395095,0.959677419354839,0.983108108108108,0.420636414987761
E02006757,"Wick, Elmley Castle & Fladbury",Wychavon,West Midlands,951,3902,587,581,452,608,6130,909,4196,563,600,476,631,6466,994,537,574,457,611,3173,0.236892278360343,0.953818827708703,0.956666666666667,0.960084033613445,0.968304278922345,0.490720692854934
E02006758,Honeybourne & Littleton,Wychavon,West Midlands,938,3691,406,421,277,292,5087,1006,4046,412,440,304,297,5499,858,381,417,292,288,2236,0.212061295106278,0.924757281553398,0.947727272727273,0.960526315789474,0.96969696969697,0.40661938534279
E02006759,Pershore,Wychavon,West Midlands,1364,4246,598,631,494,763,6732,1356,4616,556,641,565,760,7138,1109,506,615,548,742,3520,0.24025129982669,0.910071942446043,0.959438377535101,0.969911504424779,0.976315789473684,0.493135332025778
E02006760,"Harvington, Offenham & Badsey",Wychavon,West Midlands,1554,5244,664,653,445,654,7660,1467,5449,665,649,520,663,7946,1321,631,623,506,642,3723,0.242429803633694,0.948872180451128,0.959938366718028,0.973076923076923,0.968325791855204,0.468537628995721
E02006761,Evesham Central,Wychavon,West Midlands,1104,4479,308,261,173,370,5591,1086,4831,334,275,202,339,5981,751,293,248,186,319,1797,0.155454357275926,0.877245508982036,0.901818181818182,0.920792079207921,0.941002949852507,0.300451429526835
E02006762,Evesham North & Hampton,Wychavon,West Midlands,1266,4077,363,432,295,387,5554,1251,4520,364,418,323,445,6070,990,337,397,313,436,2473,0.219026548672566,0.925824175824176,0.949760765550239,0.969040247678019,0.979775280898876,0.407413509060956
E02006763,Evesham East,Wychavon,West Midlands,1799,5296,470,447,270,426,6909,1664,5566,469,506,314,487,7342,1159,433,482,305,471,2850,0.208228530362918,0.923240938166311,0.952569169960474,0.971337579617834,0.967145790554415,0.388177608281122
E02006764,Evesham South,Wychavon,West Midlands,1153,3923,326,275,177,251,4952,1102,4030,321,294,187,237,5069,827,286,268,183,224,1788,0.205210918114144,0.890965732087227,0.91156462585034,0.978609625668449,0.945147679324895,0.352732294338134
E02006765,"Broadway, Wickhamford & Sedgeberrow",Wychavon,West Midlands,801,3187,560,554,424,667,5392,814,3514,523,584,462,699,5782,765,485,563,446,676,2935,0.21770062606716,0.927342256214149,0.964041095890411,0.965367965367965,0.967095851216023,0.507609823590453
E02006766,"Bredon, Ashton & Eckington",Wychavon,West Midlands,1147,4195,684,723,420,568,6590,1068,4536,658,733,505,583,7015,1148,617,702,492,563,3522,0.253086419753086,0.937689969604863,0.957708049113233,0.974257425742574,0.965694682675815,0.502066999287242
E02006767,"Wolverley, Cookley & Blakedown",Wyre Forest,West Midlands,1512,5035,615,766,501,677,7594,1448,5387,684,739,613,724,8147,1287,626,707,594,692,3906,0.238908483385929,0.915204678362573,0.956698240866035,0.969004893964111,0.955801104972376,0.479440284767399
E02006768,Franche,Wyre Forest,West Midlands,1208,3886,413,526,407,443,5675,1182,4123,384,513,482,462,5964,1004,354,490,470,446,2764,0.243512005821004,0.921875,0.955165692007797,0.975103734439834,0.965367965367965,0.463447350771294
E02006769,Greenhill,Wyre Forest,West Midlands,1173,4213,441,431,323,429,5837,1140,4449,411,432,368,486,6146,1024,373,414,357,471,2639,0.230164081816139,0.907542579075426,0.958333333333333,0.970108695652174,0.969135802469136,0.429384965831435
E02006770,Kidderminster Town,Wyre Forest,West Midlands,1887,5515,304,333,232,271,6655,1838,5765,306,319,248,260,6898,1221,260,281,235,241,2238,0.211795316565481,0.849673202614379,0.880877742946709,0.94758064516129,0.926923076923077,0.324441867207886
E02006771,Bewdley East & Upper Arley,Wyre Forest,West Midlands,1001,3740,603,587,438,465,5833,970,3957,575,600,459,499,6090,1069,536,570,443,467,3085,0.27015415718979,0.932173913043478,0.95,0.965141612200436,0.935871743486974,0.506568144499179
E02006772,Habberley,Wyre Forest,West Midlands,1048,3754,406,465,329,550,5504,1138,4059,375,476,371,515,5796,1013,351,456,360,498,2678,0.249568859324957,0.936,0.957983193277311,0.970350404312669,0.966990291262136,0.462042788129745
E02006773,Comberton,Wyre Forest,West Midlands,1419,4767,546,651,453,603,7020,1395,4894,545,633,487,602,7161,1123,494,607,461,579,3264,0.229464650592562,0.906422018348624,0.958925750394945,0.946611909650924,0.961794019933555,0.455802262253875
E02006774,Foley Park,Wyre Forest,West Midlands,1402,4747,415,432,250,333,6177,1344,4887,398,422,294,329,6330,1091,362,404,281,318,2456,0.223245344792306,0.909547738693467,0.957345971563981,0.95578231292517,0.966565349544073,0.387993680884676
E02006775,Birchen Coppice,Wyre Forest,West Midlands,1426,3637,281,266,209,254,4647,1451,4067,295,289,223,235,5109,896,254,273,205,226,1854,0.220309810671256,0.861016949152542,0.944636678200692,0.919282511210762,0.961702127659574,0.362889019377569
E02006776,Spennells & Hoobrook,Wyre Forest,West Midlands,1020,3828,481,501,273,316,5399,992,3837,426,528,312,327,5430,908,392,511,294,308,2413,0.236643210841803,0.92018779342723,0.96780303030303,0.942307692307692,0.941896024464832,0.444383057090239
E02006777,"Bewdley West, Ribbesford & Far Forest",Wyre Forest,West Midlands,906,3729,636,650,455,678,6148,901,4132,651,690,554,636,6663,1164,612,666,535,610,3587,0.281703775411423,0.940092165898618,0.965217391304348,0.965703971119133,0.959119496855346,0.538346090349692
E02006778,Stourport Lickhill & Burlish,Wyre Forest,West Midlands,1297,3881,414,499,367,556,5717,1289,4237,424,539,427,597,6224,1157,387,528,416,585,3073,0.273070568798678,0.912735849056604,0.979591836734694,0.97423887587822,0.979899497487437,0.493733933161954
E02006779,Stourport Mitton & Wilden,Wyre Forest,West Midlands,1254,4674,515,583,404,501,6677,1230,4863,507,623,441,533,6967,1333,456,596,422,512,3319,0.274110631297553,0.899408284023669,0.956661316211878,0.956916099773243,0.960600375234522,0.476388689536386
E02006780,Stourport Areley Kings,Wyre Forest,West Midlands,968,3107,452,531,397,400,4887,936,3323,447,517,443,469,5199,991,408,495,431,460,2785,0.298224495937406,0.912751677852349,0.957446808510638,0.972911963882618,0.980810234541578,0.535679938449702
E02001827,Hill Hook,Birmingham,West Midlands,1304,3441,341,400,267,518,4967,1270,3870,384,379,315,523,5471,1128,355,359,304,496,2642,0.291472868217054,0.924479166666667,0.947229551451187,0.965079365079365,0.948374760994264,0.482909888503016
E02001828,Four Oaks,Birmingham,West Midlands,1318,3858,364,427,379,660,5688,1320,4305,359,444,434,674,6216,1350,328,423,413,650,3164,0.313588850174216,0.913649025069638,0.952702702702703,0.951612903225806,0.964391691394659,0.509009009009009
E02001829,Little Sutton & Roughley,Birmingham,West Midlands,2014,4944,427,494,372,581,6818,2059,5749,444,498,407,573,7671,1637,414,470,392,552,3465,0.284745173073578,0.932432432432432,0.943775100401606,0.963144963144963,0.963350785340314,0.451701212358232
E02001830,Sutton Coldfield North & Park,Birmingham,West Midlands,1526,5263,588,665,477,861,7854,1558,5891,593,686,538,846,8554,1871,551,652,512,793,4379,0.317603123408589,0.929173693086003,0.950437317784256,0.951672862453531,0.937352245862884,0.511924245966799
E02001831,Reddicap Heath,Birmingham,West Midlands,2202,6165,482,441,338,538,7964,2351,7136,491,483,364,531,9005,2024,428,440,348,480,3720,0.283632286995516,0.871690427698574,0.910973084886128,0.956043956043956,0.903954802259887,0.413103831204886
E02001832,Rectory Park & New Hall Valley,Birmingham,West Midlands,1388,4758,465,475,350,487,6535,1314,5122,490,499,376,512,6999,1492,439,472,356,475,3234,0.291292463881296,0.895918367346939,0.945891783567134,0.946808510638298,0.927734375,0.462066009429919
E02001833,Kingstanding North,Birmingham,West Midlands,1141,3492,292,310,230,328,4652,1162,3952,343,316,254,341,5206,998,311,300,243,319,2171,0.25253036437247,0.906705539358601,0.949367088607595,0.956692913385827,0.935483870967742,0.417018824433346
E02001834,Old Oscott,Birmingham,West Midlands,1495,3711,223,208,158,253,4553,1503,4203,228,235,177,237,5080,945,200,211,158,215,1729,0.224839400428266,0.87719298245614,0.897872340425532,0.892655367231638,0.907172995780591,0.340354330708661
E02001835,Sutton Coldfield South & Central,Birmingham,West Midlands,1512,4996,386,388,311,566,6647,1459,5426,431,436,327,571,7191,1587,389,410,307,533,3226,0.292480648728345,0.902552204176334,0.940366972477064,0.938837920489297,0.933450087565674,0.448616325963009
E02001836,New Oscott,Birmingham,West Midlands,1696,5762,522,455,423,611,7773,1697,5778,585,520,451,607,7941,1610,514,493,418,573,3608,0.278643129110419,0.878632478632479,0.948076923076923,0.926829268292683,0.943986820428336,0.454350837426017
E02001837,Kingstanding South East,Birmingham,West Midlands,2708,6443,372,328,227,328,7698,2799,7681,417,346,252,330,9026,1491,327,300,225,276,2619,0.194115349563859,0.784172661870504,0.867052023121387,0.892857142857143,0.836363636363636,0.290161754930202
E02001838,Walmley,Birmingham,West Midlands,1200,4362,531,434,337,453,6117,1224,4843,597,496,330,490,6756,1321,553,473,310,458,3115,0.272764815197192,0.926298157453936,0.953629032258064,0.939393939393939,0.93469387755102,0.461071640023683
E02001839,Queslett,Birmingham,West Midlands,1289,3936,291,300,247,378,5152,1263,4309,313,303,230,379,5534,953,250,280,209,347,2039,0.221165003481086,0.798722044728435,0.924092409240924,0.908695652173913,0.9155672823219,0.368449584387423
E02001840,Perry Common - College Road,Birmingham,West Midlands,2433,5809,362,298,233,363,7065,2543,6779,402,314,242,351,8088,1298,314,265,221,300,2398,0.191473668682697,0.781094527363184,0.843949044585987,0.913223140495868,0.854700854700855,0.29648862512364
E02001841,Wylde Green,Birmingham,West Midlands,916,3032,436,480,297,426,4671,1042,3793,431,538,372,476,5610,1196,394,506,348,451,2895,0.315317690482468,0.91415313225058,0.940520446096654,0.935483870967742,0.947478991596639,0.516042780748663
E02001842,Perry Beeches West,Birmingham,West Midlands,1592,4687,300,306,277,354,5924,1731,5436,317,335,294,385,6767,943,253,293,272,341,2102,0.173473142016188,0.798107255520505,0.874626865671642,0.925170068027211,0.885714285714286,0.310625092359982
E02001843,Kingstanding South West,Birmingham,West Midlands,1367,4086,290,298,250,370,5294,1325,4315,312,307,273,361,5568,916,276,277,246,327,2042,0.212282734646582,0.884615384615385,0.90228013029316,0.901098901098901,0.905817174515235,0.366738505747126
E02001844,Chester Road,Birmingham,West Midlands,1554,5901,527,513,464,836,8241,1573,6283,540,547,456,813,8639,1817,481,507,428,750,3983,0.289193060639822,0.890740740740741,0.926873857404022,0.93859649122807,0.922509225092251,0.461048732492187
E02001845,Perry Beeches East,Birmingham,West Midlands,1486,4163,243,268,186,171,5031,1513,4452,275,250,233,196,5406,782,218,218,214,175,1607,0.175651392632525,0.792727272727273,0.872,0.918454935622318,0.892857142857143,0.297262301146874
E02001846,Short Heath,Birmingham,West Midlands,1947,5188,284,252,252,274,6250,1907,5800,324,281,238,262,6905,1203,260,245,219,226,2153,0.207413793103448,0.802469135802469,0.871886120996441,0.920168067226891,0.862595419847328,0.311803041274439
E02001847,Minworth,Birmingham,West Midlands,983,3070,391,336,236,365,4398,1034,3476,368,396,261,347,4848,881,334,379,249,317,2160,0.253452243958573,0.907608695652174,0.957070707070707,0.954022988505747,0.913544668587896,0.445544554455446
E02001848,Upper Witton,Birmingham,West Midlands,1912,4339,222,202,188,291,5242,1936,4943,235,235,171,306,5890,751,174,200,139,265,1529,0.15193202508598,0.740425531914894,0.851063829787234,0.812865497076023,0.866013071895425,0.259592529711375
E02001849,Erdington Town,Birmingham,West Midlands,2226,5193,269,225,144,229,6060,2312,6200,304,232,168,231,7135,1202,249,213,148,193,2005,0.193870967741935,0.819078947368421,0.918103448275862,0.880952380952381,0.835497835497836,0.281009110021023
E02001850,Perry Barr & South Hamstead,Birmingham,West Midlands,1888,5217,265,304,247,354,6387,2097,6305,341,319,272,378,7615,945,232,273,239,319,2008,0.149881046788263,0.680351906158358,0.855799373040752,0.878676470588235,0.843915343915344,0.263690085357846
E02001851,Pype Hayes Park,Birmingham,West Midlands,1864,5591,400,380,263,418,7052,1908,6155,464,402,276,403,7700,1508,373,361,254,369,2865,0.245004061738424,0.803879310344828,0.898009950248756,0.920289855072464,0.915632754342432,0.372077922077922
E02001852,Stockland Green - Marsh Hill,Birmingham,West Midlands,1593,4623,291,249,174,296,5633,1629,5581,288,280,183,284,6616,970,226,239,157,240,1832,0.17380397778176,0.784722222222222,0.853571428571429,0.85792349726776,0.845070422535211,0.276904474002418
E02001854,Birches Green,Birmingham,West Midlands,1648,4841,298,333,249,381,6102,1734,5637,356,326,268,379,6966,1315,297,289,247,353,2501,0.233280113535569,0.834269662921348,0.886503067484663,0.921641791044776,0.931398416886544,0.359029572207867
E02001855,Castle Vale,Birmingham,West Midlands,2166,5996,401,333,303,551,7584,2359,7132,446,358,312,517,8765,1844,390,323,293,468,3318,0.258553000560853,0.874439461883408,0.902234636871508,0.939102564102564,0.905222437137331,0.378551055333714
E02001856,Brookvale,Birmingham,West Midlands,2302,6579,294,192,146,247,7458,2439,7494,331,244,161,244,8474,972,256,197,136,189,1750,0.129703763010408,0.773413897280967,0.807377049180328,0.84472049689441,0.774590163934426,0.206514042954921
E02001857,Gravelly Hill & South Erdington,Birmingham,West Midlands,2931,9968,435,378,249,364,11394,2920,10986,483,386,234,396,12485,1774,357,323,196,312,2962,0.161478245039141,0.739130434782609,0.836787564766839,0.837606837606838,0.787878787878788,0.237244693632359
E02001858,Handsworth East,Birmingham,West Midlands,1826,6427,356,227,167,246,7423,1857,7305,383,238,163,292,8381,1057,255,183,139,220,1854,0.144695414099932,0.66579634464752,0.76890756302521,0.852760736196319,0.753424657534247,0.221214652189476
E02001859,Birchfield East,Birmingham,West Midlands,2661,7149,278,167,159,309,8062,3052,10003,346,228,170,321,11068,830,212,164,131,235,1572,0.0829751074677597,0.61271676300578,0.719298245614035,0.770588235294118,0.73208722741433,0.1420310805927
E02001860,Handsworth West,Birmingham,West Midlands,2448,6085,275,176,159,280,6975,2761,8314,319,196,155,273,9257,824,178,141,117,204,1464,0.0991099350493144,0.557993730407524,0.719387755102041,0.754838709677419,0.747252747252747,0.158150588743653
E02001861,Birchfield West,Birmingham,West Midlands,2804,7190,304,171,166,297,8128,3000,9165,353,199,184,295,10196,894,212,153,137,198,1594,0.0975450081833061,0.60056657223796,0.768844221105528,0.744565217391304,0.671186440677966,0.156335817967831
E02001862,Middlemore,Birmingham,West Midlands,2709,7010,373,194,205,357,8139,2930,9498,432,262,171,371,10734,1142,263,179,132,274,1990,0.120235839124026,0.608796296296296,0.683206106870229,0.771929824561403,0.738544474393531,0.185392211663872
E02001863,Aston Park,Birmingham,West Midlands,2271,5139,209,141,120,223,5832,2553,6874,269,181,119,243,7686,644,164,131,94,168,1201,0.0936863543788187,0.609665427509294,0.723756906077348,0.789915966386555,0.691358024691358,0.156258131667968
E02001864,Bromford,Birmingham,West Midlands,1679,3351,153,167,114,146,3931,1750,3869,161,156,115,141,4442,501,125,126,95,129,976,0.129490824502455,0.77639751552795,0.807692307692308,0.826086956521739,0.914893617021277,0.219720846465556
E02001865,Handsworth South,Birmingham,West Midlands,2979,7592,356,209,222,282,8661,3226,11006,397,266,206,329,12204,1201,235,195,156,213,2000,0.109122296928948,0.591939546599496,0.733082706766917,0.757281553398058,0.64741641337386,0.163880694854146
E02001866,Lozells West,Birmingham,West Midlands,2385,5987,234,144,128,237,6730,2536,7867,308,180,122,253,8730,770,174,125,87,174,1330,0.0978772085928562,0.564935064935065,0.694444444444445,0.713114754098361,0.687747035573123,0.152348224513173
E02001867,Lozells East,Birmingham,West Midlands,2424,4715,191,157,129,163,5355,2742,6760,237,168,132,227,7524,573,122,103,92,146,1036,0.0847633136094675,0.514767932489452,0.613095238095238,0.696969696969697,0.643171806167401,0.137692716640085
E02001868,Hodge Hill,Birmingham,West Midlands,2589,5847,296,248,201,380,6972,2810,6756,304,284,209,382,7935,1067,226,240,188,330,2051,0.15793368857312,0.743421052631579,0.845070422535211,0.899521531100479,0.863874345549738,0.258475110270952
E02001869,Nechells,Birmingham,West Midlands,2254,4054,175,141,101,132,4603,2438,4962,209,133,99,157,5560,468,130,103,75,111,887,0.094316807738815,0.62200956937799,0.774436090225564,0.757575757575758,0.707006369426752,0.159532374100719
E02001870,Ward End & Bromford West,Birmingham,West Midlands,3871,7732,340,219,219,358,8868,4254,9539,371,293,205,364,10772,1276,259,221,167,303,2226,0.133766642205682,0.69811320754717,0.754266211604096,0.814634146341463,0.832417582417583,0.206646862235425
E02001871,Buckland End,Birmingham,West Midlands,1926,4966,338,308,303,387,6302,2088,5547,394,368,280,373,6962,1028,344,342,254,336,2304,0.185325401117721,0.873096446700508,0.929347826086957,0.907142857142857,0.900804289544236,0.330939385234128
E02001872,Shard End & Kingfisher,Birmingham,West Midlands,1829,4374,345,331,178,330,5558,1909,5014,322,317,212,277,6142,933,275,290,189,250,1937,0.186078978859194,0.854037267080745,0.914826498422713,0.891509433962264,0.902527075812274,0.315369586453924
E02001873,Winson Green & Gib Heath,Birmingham,West Midlands,3253,7716,312,210,184,250,8672,3508,10190,357,245,177,248,11217,1029,192,169,129,180,1699,0.100981354268891,0.53781512605042,0.689795918367347,0.728813559322034,0.725806451612903,0.151466524026032
E02001874,Washwood Heath,Birmingham,West Midlands,3106,6325,231,146,145,202,7049,3472,7886,278,172,139,215,8690,864,177,115,101,136,1393,0.109561247780878,0.636690647482014,0.668604651162791,0.726618705035971,0.632558139534884,0.16029919447641
E02001875,Hockley & Jewellery Quarter,Birmingham,West Midlands,2527,6460,181,128,122,216,7107,2560,7009,187,131,98,128,7553,591,101,83,74,87,936,0.0843201597945499,0.540106951871658,0.633587786259542,0.755102040816326,0.6796875,0.123924268502582
E02001876,North Central & Dartmouth Circus,Birmingham,West Midlands,2118,12020,133,126,70,161,12510,2391,11699,189,138,99,194,12319,661,89,98,74,134,1056,0.056500555603043,0.470899470899471,0.710144927536232,0.747474747474748,0.690721649484536,0.0857212436074357
E02001877,Saltley East,Birmingham,West Midlands,3664,7212,289,172,128,311,8112,4065,9547,398,214,143,303,10605,1015,229,141,100,195,1680,0.106316120247198,0.575376884422111,0.658878504672897,0.699300699300699,0.643564356435644,0.158415841584158
E02001878,Saltley West,Birmingham,West Midlands,2627,5795,185,129,94,237,6440,2943,7458,277,152,104,246,8237,769,134,111,77,151,1242,0.103110753553231,0.483754512635379,0.730263157894737,0.740384615384615,0.613821138211382,0.150783052082069
E02001879,Summerfield,Birmingham,West Midlands,2580,7123,302,144,184,339,8092,2528,9648,313,188,167,351,10667,1085,189,128,127,252,1781,0.112458540630182,0.603833865814696,0.680851063829787,0.760479041916168,0.717948717948718,0.166963532389613
E02001880,Glebe Farm,Birmingham,West Midlands,3031,5892,276,243,172,233,6816,3118,6901,340,249,175,200,7865,955,234,204,152,160,1705,0.138385741196928,0.688235294117647,0.819277108433735,0.868571428571429,0.8,0.216783216783217
E02001881,Belchers Lane & Eastfield Road,Birmingham,West Midlands,3460,6119,248,167,130,236,6900,3717,7852,282,200,136,246,8716,929,186,149,108,173,1545,0.118313805399898,0.659574468085106,0.745,0.794117647058824,0.703252032520325,0.177260211106012
E02001882,Stechford,Birmingham,West Midlands,2193,5271,293,295,213,380,6452,2272,5928,315,297,255,351,7146,931,240,269,229,303,1972,0.157051282051282,0.761904761904762,0.905723905723906,0.898039215686275,0.863247863247863,0.275958578225581
E02001883,Kitts Green,Birmingham,West Midlands,2118,5025,327,313,185,310,6160,2157,5568,315,338,212,302,6735,927,264,295,184,271,1941,0.166487068965517,0.838095238095238,0.872781065088758,0.867924528301887,0.897350993377484,0.288195991091314
E02001884,Bordesley Green North,Birmingham,West Midlands,3482,6079,159,113,93,164,6608,3954,7971,222,151,98,182,8624,719,128,104,68,123,1142,0.0902019821854221,0.576576576576577,0.688741721854305,0.693877551020408,0.675824175824176,0.132421150278293
E02001886,Rotton Park,Birmingham,West Midlands,2156,7157,361,268,206,278,8270,2223,8803,403,322,224,343,10095,1351,284,275,181,269,2360,0.153470407815517,0.704714640198511,0.854037267080745,0.808035714285714,0.784256559766764,0.233779098563645
E02001888,Kent's Moat,Birmingham,West Midlands,1764,3994,242,245,167,308,4956,1892,4770,271,262,200,285,5788,833,211,234,177,258,1713,0.174633123689727,0.77859778597786,0.893129770992367,0.885,0.905263157894737,0.295957152729786
E02001889,Little Bromwich,Birmingham,West Midlands,2795,5482,200,126,142,222,6172,3105,7246,256,157,119,221,7999,742,167,120,95,170,1294,0.102401324868893,0.65234375,0.764331210191083,0.798319327731092,0.769230769230769,0.16177022127766
E02001890,Edgbaston North,Birmingham,West Midlands,1612,8265,345,331,309,382,9632,1722,9227,418,363,297,440,10745,1599,315,300,254,367,2835,0.173295762436328,0.753588516746412,0.826446280991736,0.855218855218855,0.834090909090909,0.263843648208469
E02001892,Yardley Fields,Birmingham,West Midlands,3470,6587,253,228,181,275,7524,3762,8201,289,250,176,248,9164,1127,182,195,140,193,1837,0.137422265577369,0.629757785467128,0.78,0.795454545454545,0.778225806451613,0.200458315146224
E02001893,Yardley,Birmingham,West Midlands,1896,5133,384,335,270,476,6598,1972,5938,400,354,272,449,7413,1109,322,317,241,392,2381,0.186763219939374,0.805,0.895480225988701,0.886029411764706,0.873051224944321,0.321192499662755
E02001895,Sheldon North,Birmingham,West Midlands,2214,5366,397,365,235,395,6758,2130,6027,389,365,263,423,7467,1057,315,325,238,371,2306,0.175377468060395,0.809768637532134,0.89041095890411,0.904942965779468,0.877068557919622,0.308825498861658
E02001896,Small Heath Park,Birmingham,West Midlands,2770,6046,216,136,130,270,6798,3242,8350,314,195,115,318,9292,747,181,130,85,219,1362,0.0894610778443114,0.576433121019108,0.666666666666667,0.739130434782609,0.688679245283019,0.146577701248386
E02001897,Sparkbrook North,Birmingham,West Midlands,2248,5352,194,146,124,258,6074,2642,6953,245,184,131,254,7767,612,138,143,98,173,1164,0.0880195599022005,0.563265306122449,0.777173913043478,0.748091603053435,0.681102362204724,0.149864812668984
E02001898,Lyndon Green,Birmingham,West Midlands,1143,3895,311,323,240,372,5141,1229,4203,336,320,287,364,5510,837,300,294,275,337,2043,0.199143468950749,0.892857142857143,0.91875,0.958188153310105,0.925824175824176,0.370780399274047
E02001899,Harborne West,Birmingham,West Midlands,1506,4864,428,469,358,711,6830,1678,5686,493,503,409,686,7777,1854,425,459,386,625,3749,0.326064016883574,0.862068965517241,0.912524850894632,0.943765281173594,0.911078717201166,0.482062491963482
E02001900,Five Ways South & Calthorpe Park,Birmingham,West Midlands,1377,4932,253,243,153,349,5930,1465,5273,265,252,208,306,6304,863,184,212,173,247,1679,0.163663948416461,0.694339622641509,0.841269841269841,0.831730769230769,0.80718954248366,0.26633883248731
E02001901,Harborne East,Birmingham,West Midlands,1483,5817,319,259,198,343,6936,1587,6576,359,315,213,333,7796,2009,309,288,192,297,3095,0.305504866180049,0.860724233983287,0.914285714285714,0.901408450704225,0.891891891891892,0.396998460749102
E02001902,Yardley South,Birmingham,West Midlands,1317,3791,288,202,189,278,4748,1379,4150,269,235,184,261,5099,820,230,210,174,239,1673,0.197590361445783,0.855018587360595,0.893617021276596,0.945652173913043,0.915708812260536,0.32810354971563
E02001903,Sparkbrook South,Birmingham,West Midlands,2037,4858,201,130,101,148,5438,2432,6581,264,185,113,208,7351,490,132,106,68,135,931,0.0744567694879198,0.5,0.572972972972973,0.601769911504425,0.649038461538462,0.126649435450959
E02001904,Hay Mills & Tyseley,Birmingham,West Midlands,2177,4868,230,176,110,222,5606,2285,5832,259,199,138,243,6671,742,191,163,118,202,1416,0.127229080932785,0.737451737451737,0.819095477386935,0.855072463768116,0.831275720164609,0.212262029680708
E02001905,Edgbaston South & University,Birmingham,West Midlands,1238,9761,279,245,197,361,10843,1320,12560,275,277,243,380,13735,1457,233,257,219,335,2501,0.116003184713376,0.847272727272727,0.927797833935018,0.901234567901234,0.881578947368421,0.182089552238806
E02001906,Quinton Ridgacre,Birmingham,West Midlands,1936,5732,384,392,262,454,7224,1976,6634,425,418,320,434,8231,1580,356,384,293,396,3009,0.238167018390112,0.83764705882353,0.91866028708134,0.915625,0.912442396313364,0.365569189648888
E02001907,Sheldon South,Birmingham,West Midlands,1926,6198,440,496,389,579,8102,1979,6834,466,467,392,537,8696,1334,397,439,369,480,3019,0.195200468247,0.851931330472103,0.940042826552462,0.941326530612245,0.893854748603352,0.347171113155474
E02001908,Sparkhill North,Birmingham,West Midlands,2520,5682,243,131,119,221,6396,2753,7647,298,182,138,238,8503,573,175,124,99,155,1126,0.0749313456257356,0.587248322147651,0.681318681318681,0.717391304347826,0.651260504201681,0.132423850405739
E02001909,Balsall Heath East,Birmingham,West Midlands,2326,5247,186,127,114,228,5902,2513,6684,235,135,110,231,7395,518,141,93,87,153,992,0.0774985038898863,0.6,0.688888888888889,0.790909090909091,0.662337662337662,0.134144692359703
E02001910,Balsall Heath West & Kingswood Road,Birmingham,West Midlands,1895,4640,196,143,124,212,5315,2040,5564,251,165,122,234,6336,542,152,117,95,161,1067,0.097411933860532,0.605577689243028,0.709090909090909,0.778688524590164,0.688034188034188,0.168402777777778
E02001911,Quinton East,Birmingham,West Midlands,2330,5151,248,273,205,272,6149,2399,6037,310,284,220,301,7152,1162,246,245,188,260,2101,0.192479708464469,0.793548387096774,0.862676056338028,0.854545454545455,0.863787375415283,0.293763982102908
E02001913,Metchley,Birmingham,West Midlands,1344,6329,300,283,204,323,7439,1420,8681,302,281,225,355,9844,1570,233,244,199,321,2567,0.1808547402373,0.771523178807947,0.868327402135231,0.884444444444445,0.904225352112676,0.260767980495733
E02001914,Moor Green & Cannon Hill,Birmingham,West Midlands,1412,4633,268,205,131,247,5484,1515,5171,299,241,139,245,6095,947,218,201,123,193,1682,0.183136724037904,0.729096989966555,0.83402489626556,0.884892086330935,0.787755102040816,0.275963904840033
E02001915,Acocks Green East,Birmingham,West Midlands,2549,7977,482,408,326,518,9711,2528,8593,489,430,318,511,10341,1486,383,370,286,446,2971,0.172931455836146,0.783231083844581,0.86046511627907,0.89937106918239,0.87279843444227,0.28730296876511
E02001916,Acocks Green West,Birmingham,West Midlands,2675,6004,261,242,173,285,6965,2731,6888,321,265,191,275,7940,849,245,231,166,227,1718,0.123257839721254,0.763239875389408,0.871698113207547,0.869109947643979,0.825454545454545,0.216372795969773
E02001918,Moseley Village,Birmingham,West Midlands,1413,6300,445,327,196,303,7571,1518,6837,440,409,200,345,8231,1301,353,349,170,291,2464,0.190288138072254,0.802272727272727,0.853300733496333,0.85,0.843478260869565,0.299356092819828
E02001919,Moseley,Birmingham,West Midlands,1130,4574,324,215,151,352,5616,1322,5161,344,231,162,337,6235,843,250,193,140,287,1713,0.163340437899632,0.726744186046512,0.835497835497836,0.864197530864198,0.851632047477745,0.274739374498797
E02001920,Woodgate Valley,Birmingham,West Midlands,1828,4563,364,408,213,222,5770,1829,5292,368,397,280,249,6586,1259,297,356,256,214,2382,0.237906273620559,0.807065217391304,0.896725440806045,0.914285714285714,0.859437751004016,0.361676283024598
E02001921,California,Birmingham,West Midlands,1837,5022,315,303,257,325,6222,1893,5704,347,317,246,295,6909,1412,267,277,216,264,2436,0.247545582047686,0.769452449567723,0.873817034700316,0.878048780487805,0.894915254237288,0.35258358662614
E02001922,Selly Oak,Birmingham,West Midlands,649,16848,74,54,79,97,17152,667,15404,84,76,48,121,15733,1343,60,69,45,104,1621,0.0871851467151389,0.714285714285714,0.907894736842105,0.9375,0.859504132231405,0.103031843894998
E02001923,Springfield & Hall Green West,Birmingham,West Midlands,2698,6855,426,334,268,414,8297,2980,8358,458,379,272,441,9908,1017,336,303,232,361,2249,0.121679827709978,0.733624454148472,0.799472295514512,0.852941176470588,0.81859410430839,0.226988292289059
E02001924,Hall Green East,Birmingham,West Midlands,1505,4184,259,203,150,297,5093,1576,4836,335,217,163,259,5810,803,281,188,145,227,1644,0.166046319272126,0.838805970149254,0.866359447004608,0.889570552147239,0.876447876447877,0.282960413080895
E02001925,Selly Oak Park & Lodge Hill,Birmingham,West Midlands,1302,4273,352,291,254,393,5563,1395,5224,322,329,254,422,6551,1028,281,304,241,383,2237,0.196784073506891,0.872670807453416,0.924012158054711,0.948818897637795,0.907582938388625,0.341474584032972
E02001926,Stirchley North & Selly Park,Birmingham,West Midlands,1260,5577,271,224,199,372,6643,1442,6344,303,263,205,375,7490,1162,254,235,191,344,2186,0.183165195460277,0.838283828382838,0.893536121673004,0.931707317073171,0.917333333333333,0.291855807743658
E02001927,Weoley Castle,Birmingham,West Midlands,1973,4766,330,314,184,376,5970,1982,5472,349,285,219,365,6690,1292,274,229,201,331,2327,0.236111111111111,0.785100286532951,0.803508771929825,0.917808219178082,0.906849315068493,0.347832585949178
E02001928,Woodgate,Birmingham,West Midlands,1501,4094,369,420,212,256,5351,1525,4519,393,415,250,287,5864,1136,322,374,236,264,2332,0.251383049347201,0.819338422391857,0.901204819277108,0.944,0.9198606271777,0.397680763983629
E02001929,Fox Hollies,Birmingham,West Midlands,2808,6273,289,253,212,267,7294,2970,7195,327,268,174,275,8239,1085,265,233,153,245,1981,0.150799166087561,0.81039755351682,0.869402985074627,0.879310344827586,0.890909090909091,0.240441801189465
E02001930,Kings Heath,Birmingham,West Midlands,1543,5284,399,262,157,229,6331,1574,5768,393,292,211,234,6898,1317,341,258,194,205,2315,0.228328710124827,0.867684478371501,0.883561643835616,0.919431279620853,0.876068376068376,0.335604523050159
E02001931,Wake Green East & Moseley Bog,Birmingham,West Midlands,1708,4938,470,360,272,419,6459,1808,5663,470,437,302,420,7292,1095,394,393,270,379,2531,0.19336040967685,0.838297872340426,0.899313501144165,0.894039735099338,0.902380952380952,0.347092704333516
E02001932,Bartley Green & Shenley Fields,Birmingham,West Midlands,1911,4678,288,236,179,291,5672,1921,5353,323,269,163,243,6351,1218,259,244,151,208,2080,0.227535961143284,0.801857585139319,0.907063197026022,0.92638036809816,0.8559670781893,0.327507479137144
E02001933,Kings Heath Park & Stirchley East,Birmingham,West Midlands,1540,4661,271,290,205,309,5736,1709,5608,336,298,226,306,6774,1217,267,255,203,277,2219,0.217011412268188,0.794642857142857,0.855704697986577,0.898230088495575,0.905228758169935,0.327576025981695
E02001934,Hall Green Central,Birmingham,West Midlands,1545,4290,305,280,218,330,5423,1603,4794,331,288,224,325,5962,890,283,270,204,295,1942,0.185648727576137,0.854984894259819,0.9375,0.910714285714286,0.907692307692308,0.325729620932573
E02001935,Shenley Lane,Birmingham,West Midlands,1776,4602,371,352,298,555,6178,1829,5407,391,382,322,557,7059,1316,340,352,289,516,2813,0.243388200480858,0.869565217391304,0.921465968586387,0.897515527950311,0.926391382405745,0.398498370874062
E02001936,Brandwood North,Birmingham,West Midlands,1401,3831,341,334,253,369,5128,1301,4161,356,346,293,400,5556,992,309,316,275,367,2259,0.238404229752463,0.867977528089888,0.913294797687861,0.938566552901024,0.9175,0.40658747300216
E02001937,Billesley Common,Birmingham,West Midlands,2028,4952,349,265,204,355,6125,2106,5696,363,305,209,351,6924,1234,298,270,190,299,2291,0.216643258426966,0.820936639118457,0.885245901639344,0.909090909090909,0.851851851851852,0.330878105141537
E02001938,Bournville East & Stirchley West,Birmingham,West Midlands,1491,5416,321,254,189,294,6474,1496,5893,358,276,183,273,6983,1292,306,253,174,245,2270,0.219243169862549,0.854748603351955,0.916666666666667,0.950819672131147,0.897435897435897,0.325075182586281
E02001939,Bournville West,Birmingham,West Midlands,1137,3498,376,373,301,521,5069,1157,3952,363,404,328,538,5585,1095,309,375,308,508,2595,0.277074898785425,0.851239669421488,0.928217821782178,0.939024390243902,0.944237918215613,0.464637421665175
E02001941,Yardley Wood West,Birmingham,West Midlands,1488,3667,241,245,180,333,4666,1591,4219,272,241,179,319,5230,822,211,208,157,289,1687,0.194832898791183,0.775735294117647,0.863070539419087,0.877094972067039,0.905956112852665,0.322562141491396
E02001942,Cotteridge,Birmingham,West Midlands,1374,4237,344,282,214,361,5438,1396,4644,336,316,246,366,5908,1145,290,285,223,332,2275,0.246554694229113,0.863095238095238,0.901898734177215,0.90650406504065,0.907103825136612,0.385071090047393
E02001943,Brandwood East,Birmingham,West Midlands,1369,3983,289,223,198,295,4988,1456,4446,301,288,174,266,5475,995,242,264,152,241,1894,0.223796671165092,0.803986710963455,0.916666666666667,0.873563218390805,0.906015037593985,0.345936073059361
E02001944,Brandwood End,Birmingham,West Midlands,1691,5254,350,328,243,288,6463,1656,5408,386,362,244,300,6700,1328,339,342,223,278,2510,0.245562130177515,0.878238341968912,0.94475138121547,0.913934426229508,0.926666666666667,0.374626865671642
E02001945,Allens Cross,Birmingham,West Midlands,1911,4746,295,248,172,209,5670,2066,5721,346,264,193,225,6749,1179,272,225,168,188,2032,0.206082852648138,0.786127167630058,0.852272727272727,0.870466321243523,0.835555555555556,0.3010816417247
E02001946,Northfield Victoria Common,Birmingham,West Midlands,1436,4591,431,412,276,434,6144,1384,5150,431,455,281,427,6744,1423,372,428,269,399,2891,0.276310679611651,0.863109048723898,0.940659340659341,0.95729537366548,0.934426229508197,0.42867734282325
E02001947,Druids Heath,Birmingham,West Midlands,1571,3739,248,187,218,313,4705,1627,4108,271,202,196,290,5067,749,218,172,174,268,1581,0.182327166504382,0.804428044280443,0.851485148514852,0.887755102040816,0.924137931034483,0.312018946121966
E02001948,Highter's Heath & Maypole,Birmingham,West Midlands,1492,4491,351,317,231,406,5796,1484,4763,363,333,244,386,6089,1012,304,300,230,346,2192,0.212471131639723,0.837465564738292,0.900900900900901,0.942622950819672,0.896373056994819,0.359993430776811
E02001949,Lifford & Walkers Heath,Birmingham,West Midlands,1478,3641,235,223,167,305,4571,1371,3879,246,233,182,334,4874,865,209,208,166,314,1762,0.222995617427172,0.849593495934959,0.892703862660944,0.912087912087912,0.940119760479042,0.361510053344276
E02001950,Longbridge North,Birmingham,West Midlands,1612,5143,424,404,298,431,6700,1649,5596,455,467,342,438,7298,1506,399,440,328,396,3069,0.269120800571837,0.876923076923077,0.942184154175589,0.95906432748538,0.904109589041096,0.42052617155385
E02001951,Frankley,Birmingham,West Midlands,2299,5237,496,389,216,230,6568,2357,6097,518,451,241,235,7542,1218,419,411,225,214,2487,0.199770378874857,0.808880308880309,0.911308203991131,0.933609958506224,0.91063829787234,0.32975338106603
E02001952,Turves Green,Birmingham,West Midlands,2174,5776,402,333,241,330,7082,2247,6359,449,369,239,302,7718,1638,363,320,212,272,2805,0.257587671017456,0.808463251670379,0.867208672086721,0.887029288702929,0.900662251655629,0.363436123348018
E02001953,King's Norton,Birmingham,West Midlands,1365,3944,441,446,289,498,5618,1295,4534,391,476,309,473,6183,1091,353,452,290,444,2630,0.240626378473754,0.902813299232737,0.949579831932773,0.938511326860841,0.938689217758985,0.425359857674268
E02001954,Hawkesley,Birmingham,West Midlands,1865,4382,407,380,211,260,5640,2003,5198,360,396,230,257,6441,1014,293,355,205,238,2105,0.195075028857253,0.813888888888889,0.896464646464647,0.891304347826087,0.926070038910506,0.326812606738084
E02001955,Longbridge South,Birmingham,West Midlands,1648,4521,258,292,228,401,5700,1731,5106,313,273,246,454,6392,1134,267,257,233,428,2319,0.222091656874266,0.853035143769968,0.941391941391941,0.947154471544715,0.94273127753304,0.362797246558198
E02001956,Rubery East,Birmingham,West Midlands,1518,4212,299,297,153,284,5245,1504,4660,315,285,198,233,5691,1062,265,264,188,219,1998,0.227896995708155,0.841269841269841,0.926315789473684,0.949494949494949,0.939914163090129,0.35108065366368
E02001957,West Heath,Birmingham,West Midlands,1491,4786,347,390,295,368,6186,1460,5131,371,361,335,386,6584,1330,323,337,318,374,2682,0.259208731241473,0.870619946091644,0.933518005540166,0.949253731343284,0.968911917098446,0.407351154313487
E02006807,Yardley Wood East,Birmingham,West Midlands,1697,4791,371,334,221,408,6125,1774,5323,409,333,271,395,6731,1074,354,318,256,366,2368,0.201765921472854,0.865525672371638,0.954954954954955,0.944649446494465,0.926582278481013,0.351805080968652
E02006809,Handsworth Wood,Birmingham,West Midlands,1995,6675,525,346,246,492,8284,2074,7626,586,430,242,498,9382,1911,477,366,208,431,3393,0.250590086546027,0.813993174061434,0.851162790697675,0.859504132231405,0.865461847389558,0.361649968023876
E02006895,Attwood Green & Park Central,Birmingham,West Midlands,1633,7664,171,112,88,150,8185,1937,8581,171,138,90,170,9150,892,86,102,64,116,1260,0.103950588509498,0.502923976608187,0.739130434782609,0.711111111111111,0.682352941176471,0.137704918032787
E02006896,Digbeth,Birmingham,West Midlands,783,6326,98,92,52,83,6651,784,5496,120,75,61,82,5834,531,71,55,43,59,759,0.0966157205240175,0.591666666666667,0.733333333333333,0.704918032786885,0.719512195121951,0.130099417209462
E02006897,Five Ways North,Birmingham,West Midlands,1315,6740,133,97,69,79,7118,1472,7406,151,110,73,74,7814,691,91,73,57,58,970,0.0933027275182285,0.602649006622517,0.663636363636364,0.780821917808219,0.783783783783784,0.124136165856156
E02006898,Ladywood -Summer Hill,Birmingham,West Midlands,1125,6686,145,95,76,68,7070,1137,6700,194,98,67,83,7142,813,109,66,49,57,1094,0.12134328358209,0.561855670103093,0.673469387755102,0.73134328358209,0.686746987951807,0.153178381405769
E02006899,Central,Birmingham,West Midlands,361,7820,62,60,39,44,8025,401,6334,57,52,23,20,6486,639,41,43,20,14,757,0.10088411746132,0.719298245614035,0.826923076923077,0.869565217391304,0.7,0.116712920135677
E02006900,Bordesley,Birmingham,West Midlands,4748,9653,409,227,233,402,10924,5356,12705,457,262,198,436,14058,1158,273,181,148,306,2066,0.0911452184179457,0.597374179431072,0.690839694656489,0.747474747474748,0.701834862385321,0.146962583582302
E02006901,Greet & Sparkhill South,Birmingham,West Midlands,4817,9613,366,218,225,322,10744,5256,12384,481,283,223,373,13744,966,292,202,160,272,1892,0.0780038759689923,0.607068607068607,0.713780918727915,0.717488789237668,0.729222520107239,0.137660069848661
E02001958,Longford,Coventry,West Midlands,1619,5360,313,303,259,256,6491,1682,5893,359,310,256,293,7111,1236,299,280,239,270,2324,0.209740369930426,0.832869080779944,0.903225806451613,0.93359375,0.921501706484642,0.326817606525102
E02001959,Keresley,Coventry,West Midlands,1431,4249,268,302,251,358,5428,1565,4814,293,290,233,395,6025,1179,253,273,219,367,2291,0.244910677191525,0.863481228668942,0.941379310344828,0.939914163090129,0.929113924050633,0.380248962655602
E02001961,Bell Green,Coventry,West Midlands,2067,5406,312,247,218,248,6431,2095,6108,325,267,219,277,7196,1188,263,235,197,229,2112,0.194499017681729,0.809230769230769,0.880149812734083,0.899543378995434,0.826714801444043,0.293496386881601
E02001962,Little Heath,Coventry,West Midlands,1968,4627,204,155,112,195,5293,2193,5652,232,196,120,227,6427,885,176,164,98,192,1515,0.156581740976645,0.758620689655172,0.836734693877551,0.816666666666667,0.845814977973568,0.235724288159328
E02001963,Whitmore Park,Coventry,West Midlands,1126,3911,355,274,206,341,5087,1112,4123,353,297,225,322,5320,1073,325,277,211,293,2179,0.260247392675237,0.920679886685553,0.932659932659933,0.937777777777778,0.909937888198758,0.409586466165414
E02001964,Henley Green & Wood End,Coventry,West Midlands,3156,6007,351,247,192,301,7098,3451,7782,397,267,211,290,8947,1379,310,215,180,249,2333,0.177203803649447,0.780856423173804,0.805243445692884,0.853080568720379,0.858620689655172,0.260757795909243
E02001965,Walsgrave & Woodway Park,Coventry,West Midlands,1611,5246,432,392,271,425,6766,1708,5769,493,404,309,433,7408,1555,439,377,291,402,3064,0.269544115097937,0.890466531440162,0.933168316831683,0.941747572815534,0.928406466512702,0.413606911447084
E02001966,Foleshill West,Coventry,West Midlands,2248,4969,182,119,110,189,5569,2372,6257,210,156,114,199,6936,841,145,118,90,139,1333,0.134409461403228,0.690476190476191,0.756410256410256,0.789473684210526,0.698492462311558,0.192185697808535
E02001967,Brownshill Green,Coventry,West Midlands,1187,3864,395,463,379,461,5562,1202,4390,411,462,408,545,6216,1125,367,432,393,514,2831,0.25626423690205,0.89294403892944,0.935064935064935,0.963235294117647,0.943119266055046,0.45543758043758
E02001968,Radford East,Coventry,West Midlands,2151,5397,275,199,145,220,6236,2210,6048,315,230,188,249,7030,1131,260,198,160,228,1977,0.187003968253968,0.825396825396825,0.860869565217391,0.851063829787234,0.91566265060241,0.28122332859175
E02001969,Radford West,Coventry,West Midlands,1584,4540,260,256,166,362,5584,1536,4914,250,272,197,321,5954,1030,204,244,181,291,1950,0.20960520960521,0.816,0.897058823529412,0.918781725888325,0.906542056074766,0.327510917030568
E02001970,Wyken Croft,Coventry,West Midlands,1143,3623,225,316,292,486,4942,1190,3819,276,273,294,493,5155,876,245,249,285,462,2117,0.229379418695994,0.88768115942029,0.912087912087912,0.969387755102041,0.937119675456389,0.410669253152279
E02001971,Coundon,Coventry,West Midlands,1301,3771,240,290,210,264,4775,1229,4159,271,286,238,289,5243,1012,238,269,213,263,1995,0.243327723010339,0.878228782287823,0.94055944055944,0.894957983193277,0.910034602076125,0.380507343124166
E02001972,Foleshill East,Coventry,West Midlands,3472,7917,301,193,154,161,8726,3657,9834,361,259,165,277,10896,1171,250,197,119,200,1937,0.119076672767948,0.692520775623269,0.760617760617761,0.721212121212121,0.72202166064982,0.177771659324523
E02001973,Stoke Heath,Coventry,West Midlands,2107,6148,305,273,216,239,7181,2206,6572,324,311,202,262,7671,1195,256,282,180,226,2139,0.181832014607425,0.790123456790123,0.906752411575563,0.891089108910891,0.862595419847328,0.278842393429801
E02001974,Sherbourne,Coventry,West Midlands,1926,6141,426,439,353,501,7860,1809,6351,431,432,363,545,8122,1398,379,396,327,496,2996,0.220122815304676,0.879350348027842,0.916666666666667,0.900826446280992,0.910091743119266,0.368874661413445
E02001975,Ravensdale,Coventry,West Midlands,1846,5384,338,281,225,291,6519,1757,5565,336,275,228,312,6716,1385,300,254,213,289,2441,0.248876909254268,0.892857142857143,0.923636363636364,0.93421052631579,0.926282051282051,0.363460393091126
E02001976,Clifford Park,Coventry,West Midlands,1606,4842,397,379,232,406,6256,1605,5273,388,411,275,427,6774,1286,334,381,260,395,2656,0.243883937037739,0.860824742268041,0.927007299270073,0.945454545454546,0.925058548009368,0.392087392973133
E02001977,Naul's Mill & Bishopsgate Green,Coventry,West Midlands,1975,8783,288,241,192,265,9769,1931,8243,304,259,197,251,9254,1008,228,215,161,195,1807,0.122285575639937,0.75,0.83011583011583,0.817258883248731,0.776892430278885,0.195266911605792
E02001978,Barras Heath,Coventry,West Midlands,1367,4733,270,222,160,285,5670,1444,5018,296,245,180,263,6002,1005,251,217,167,232,1872,0.200278995615783,0.847972972972973,0.885714285714286,0.927777777777778,0.88212927756654,0.311896034655115
E02001979,Allesley Park,Coventry,West Midlands,1112,3484,251,296,252,493,4776,1068,3631,250,276,249,511,4917,912,225,259,239,488,2123,0.251170476452768,0.9,0.938405797101449,0.959839357429719,0.954990215264188,0.431767337807606
E02001980,Allesley Green & Lower Eastern Green,Coventry,West Midlands,844,3302,379,488,384,493,5046,842,3435,345,460,406,508,5154,770,318,444,391,487,2410,0.224163027656477,0.921739130434783,0.965217391304348,0.963054187192118,0.958661417322835,0.467597982149787
E02001981,Hillfields,Coventry,West Midlands,2895,12220,236,152,148,168,12924,3356,12987,294,199,141,216,13837,1228,202,161,117,155,1863,0.0945560945560945,0.687074829931973,0.809045226130653,0.829787234042553,0.717592592592593,0.13463901134639
E02001982,Eastern Green & Tanyard Farm,Coventry,West Midlands,1675,5720,366,372,296,439,7193,1620,5376,379,366,308,489,6918,970,324,343,286,454,2377,0.180431547619048,0.854881266490765,0.937158469945355,0.928571428571429,0.928425357873211,0.343596415148887
E02001983,Whoberley,Coventry,West Midlands,1495,5227,393,350,239,390,6599,1456,5443,414,353,253,363,6826,1137,364,332,237,336,2406,0.208892155061547,0.879227053140097,0.940509915014164,0.936758893280632,0.925619834710744,0.352475827717551
E02001984,Copsewood,Coventry,West Midlands,2118,7474,364,336,264,346,8784,2212,7977,381,360,309,361,9388,1641,326,326,290,330,2913,0.205716434749906,0.855643044619423,0.905555555555556,0.938511326860841,0.914127423822715,0.31028973157222
E02001985,Lower Stoke & Gosford Park,Coventry,West Midlands,1226,11181,126,98,105,105,11615,1335,9485,141,101,96,144,9967,744,98,82,78,121,1123,0.0784396415392725,0.695035460992908,0.811881188118812,0.8125,0.840277777777778,0.112671816996087
E02001986,Tile Hill,Coventry,West Midlands,1906,5624,312,366,269,378,6949,1783,5561,365,350,274,359,6909,978,304,320,246,318,2166,0.175867649703291,0.832876712328767,0.914285714285714,0.897810218978102,0.885793871866295,0.313504125054277
E02001987,Chapelfields,Coventry,West Midlands,777,5660,180,194,119,220,6373,777,5066,183,193,156,274,5872,743,150,176,141,243,1453,0.146664034741413,0.819672131147541,0.911917098445596,0.903846153846154,0.886861313868613,0.247445504087193
E02001988,Central Coventry,Coventry,West Midlands,1142,15538,220,169,136,204,16267,1057,12459,238,209,133,228,13267,783,175,171,123,195,1447,0.0628461353238623,0.735294117647059,0.818181818181818,0.924812030075188,0.855263157894737,0.109067611366549
E02001989,Earl Place & Lime Tree Park,Coventry,West Midlands,1314,4363,246,240,185,227,5261,1315,4603,262,278,173,250,5566,726,224,247,157,225,1579,0.157723223984358,0.854961832061069,0.888489208633094,0.907514450867052,0.9,0.283686669062163
E02001990,Binley,Coventry,West Midlands,1652,5682,543,497,364,571,7657,1659,6116,554,529,396,632,8227,1610,508,503,376,584,3581,0.26324395029431,0.916967509025271,0.950850661625709,0.949494949494949,0.924050632911392,0.435274097483895
E02001991,Earlsdon & Canley Gardens,Coventry,West Midlands,1219,5874,540,530,308,538,7790,1183,5895,578,524,375,597,7969,1250,524,491,347,548,3160,0.212044105173876,0.906574394463668,0.937022900763359,0.925333333333333,0.917922948073702,0.396536579244573
E02001992,Ernesford Grange & Stoke Aldermoor,Coventry,West Midlands,2665,6599,388,431,279,346,8043,2903,7784,436,417,322,321,9280,1640,388,381,302,292,3003,0.210688591983556,0.889908256880734,0.913669064748201,0.937888198757764,0.909657320872274,0.323599137931035
E02001993,Canley & Westwood Heath,Coventry,West Midlands,1738,5687,334,353,216,338,6928,1655,6532,376,344,253,318,7823,863,318,315,232,263,1991,0.132118799755052,0.845744680851064,0.915697674418605,0.91699604743083,0.827044025157233,0.254505944011249
E02001994,Cheylesmore Daventry Road,Coventry,West Midlands,1774,5769,374,413,285,420,7261,1823,6173,366,422,305,437,7703,1269,310,387,290,395,2651,0.205572655110967,0.846994535519126,0.917061611374408,0.950819672131147,0.903890160183066,0.344151629235363
E02001995,Whitley & Tollbar End,Coventry,West Midlands,2058,7518,282,306,241,389,8736,2109,7474,344,296,252,368,8734,1166,284,267,232,338,2287,0.156007492641156,0.825581395348837,0.902027027027027,0.920634920634921,0.918478260869565,0.261850240439661
E02001996,Willenhall,Coventry,West Midlands,1907,4647,267,218,196,242,5570,2082,5501,304,236,178,272,6491,1071,257,213,158,245,1944,0.19469187420469,0.845394736842105,0.902542372881356,0.887640449438202,0.900735294117647,0.299491603759051
E02001997,Stivichall & Finham,Coventry,West Midlands,1561,5112,504,497,426,658,7197,1544,5348,508,481,408,685,7430,1554,472,451,396,652,3525,0.290575916230367,0.929133858267716,0.937629937629938,0.970588235294118,0.951824817518248,0.47442799461642
E02001998,Finham Park,Coventry,West Midlands,1089,3488,275,333,284,392,4772,1099,3828,294,341,312,419,5194,1059,265,315,301,397,2337,0.276645768025078,0.901360544217687,0.923753665689149,0.96474358974359,0.947494033412888,0.449942241047362
E02001999,Cannon Park & University,Coventry,West Midlands,818,7867,331,346,266,339,9149,968,18864,365,336,274,373,20212,1095,325,301,253,343,2317,0.0580470737913486,0.89041095890411,0.895833333333333,0.923357664233577,0.919571045576408,0.114634870374035
E02006805,Holbrooks,Coventry,West Midlands,2409,6051,302,232,207,311,7103,2380,6837,343,276,199,349,8004,1437,258,241,173,298,2407,0.210179903466433,0.752186588921283,0.873188405797101,0.869346733668342,0.853868194842407,0.300724637681159
E02002000,Coseley Wallbrook,Dudley,West Midlands,1654,4866,384,360,293,418,6321,1753,5191,411,364,285,450,6701,942,348,340,270,415,2315,0.181467925255249,0.846715328467153,0.934065934065934,0.947368421052632,0.922222222222222,0.345470825249963
E02002001,Sedgley East,Dudley,West Midlands,1095,3777,298,311,247,340,4973,1067,3892,327,291,239,359,5108,844,289,275,230,351,1989,0.216855087358684,0.883792048929664,0.945017182130584,0.96234309623431,0.977715877437326,0.389389193422083
E02002002,Sedgley West,Dudley,West Midlands,920,3615,488,607,475,739,5924,930,3862,485,563,546,769,6225,912,446,543,531,741,3173,0.236147074054894,0.919587628865979,0.964476021314387,0.972527472527472,0.963589076723017,0.509718875502008
E02002003,West Coseley,Dudley,West Midlands,1616,5454,469,481,397,676,7477,1579,5698,469,474,390,655,7686,1130,413,445,381,617,2986,0.198315198315198,0.880597014925373,0.938818565400844,0.976923076923077,0.941984732824428,0.388498568826438
E02002004,Woodsetton,Dudley,West Midlands,1568,4603,317,309,259,413,5901,1592,5047,371,327,262,409,6416,993,331,306,248,388,2266,0.196750544878145,0.892183288409704,0.935779816513761,0.946564885496183,0.948655256723716,0.353179551122195
E02002005,Dudley Priory & Wrens Nest,Dudley,West Midlands,2629,5635,364,303,315,298,6915,2633,6345,386,304,283,326,7644,973,328,271,262,291,2125,0.153349093774626,0.849740932642487,0.891447368421053,0.925795053003534,0.892638036809816,0.277995813710099
E02002006,Upper Gornal & Ruiton,Dudley,West Midlands,1261,4084,321,277,220,324,5226,1259,4204,321,271,227,311,5334,881,285,261,220,294,1941,0.209562321598478,0.88785046728972,0.96309963099631,0.969162995594714,0.945337620578778,0.363892013498313
E02002007,Lower Gornal & The Straits,Dudley,West Midlands,1558,5081,488,603,510,776,7458,1527,5297,477,570,522,793,7659,1138,439,545,497,757,3376,0.214838587879932,0.920335429769392,0.956140350877193,0.952107279693487,0.954602774274905,0.440788614701658
E02002008,Dibdale,Dudley,West Midlands,1476,5630,372,302,234,328,6866,1421,5637,397,311,239,362,6946,1180,357,294,226,335,2392,0.209331204541423,0.899244332493703,0.945337620578778,0.94560669456067,0.925414364640884,0.344370860927152
E02002009,Kates Hill,Dudley,West Midlands,1869,4210,273,227,142,208,5060,1890,4888,290,235,172,213,5798,617,213,196,145,167,1338,0.126227495908347,0.73448275862069,0.834042553191489,0.843023255813954,0.784037558685446,0.230769230769231
E02002010,New Dock & Eve Hill,Dudley,West Midlands,1792,5158,315,239,232,370,6314,1768,5905,331,276,245,400,7157,830,260,224,212,341,1867,0.140558848433531,0.785498489425982,0.811594202898551,0.86530612244898,0.8525,0.260863490289227
E02002011,Kingswinford North,Dudley,West Midlands,871,3148,401,397,326,438,4710,920,3433,413,430,369,449,5094,723,375,413,360,423,2294,0.210602971162249,0.907990314769976,0.96046511627907,0.975609756097561,0.942093541202673,0.450333725952101
E02002012,Russell's Hall,Dudley,West Midlands,1781,5214,365,337,298,501,6715,1787,5620,355,363,301,530,7169,1145,295,316,271,482,2509,0.20373665480427,0.830985915492958,0.870523415977961,0.900332225913621,0.909433962264151,0.349979076579718
E02002013,Wall Heath,Dudley,West Midlands,981,3565,416,493,401,606,5481,909,3815,402,457,446,650,5770,888,363,441,435,628,2755,0.232765399737877,0.902985074626866,0.964989059080963,0.975336322869955,0.966153846153846,0.477469670710572
E02002014,Dixons Green,Dudley,West Midlands,1948,4929,280,260,198,292,5959,2071,5687,286,292,188,284,6737,853,220,261,165,233,1732,0.149991208018287,0.769230769230769,0.893835616438356,0.877659574468085,0.820422535211268,0.257087724506457
E02002015,Pensett & Kingswinford East,Dudley,West Midlands,1301,3988,334,333,263,372,5290,1264,4303,310,363,262,371,5609,924,280,346,250,345,2145,0.214733906576807,0.903225806451613,0.953168044077135,0.954198473282443,0.929919137466307,0.382421108932073
E02002016,Brockmoor & Woodside,Dudley,West Midlands,1995,4794,337,284,239,321,5975,1842,5087,326,323,232,359,6327,1063,263,302,215,331,2174,0.208964025948496,0.806748466257669,0.934984520123839,0.926724137931035,0.922005571030641,0.343606764659396
E02002017,Netherton,Dudley,West Midlands,1679,5502,396,391,311,435,7035,1731,5367,409,369,279,431,6855,944,348,350,264,395,2301,0.175889696292156,0.850855745721271,0.948509485094851,0.946236559139785,0.916473317865429,0.335667396061269
E02002018,Kingswinford South,Dudley,West Midlands,1502,4847,557,672,561,711,7348,1423,5335,519,683,598,765,7900,1162,470,655,587,741,3615,0.217806935332709,0.905587668593449,0.95900439238653,0.981605351170569,0.968627450980392,0.457594936708861
E02002019,Dudley Wood & Saltwells,Dudley,West Midlands,1795,4887,366,336,279,361,6229,1793,5115,365,328,274,351,6433,1018,324,308,262,326,2238,0.199022482893451,0.887671232876712,0.939024390243902,0.956204379562044,0.928774928774929,0.347893673247319
E02002020,Wordsley & Buckpool,Dudley,West Midlands,1599,5707,540,635,575,654,8111,1498,5658,508,641,551,692,8050,1249,462,617,532,663,3523,0.220749381406858,0.909448818897638,0.962558502340094,0.96551724137931,0.958092485549133,0.437639751552795
E02002021,Brierley Hill,Dudley,West Midlands,1632,5090,299,260,215,267,6131,1537,5054,322,292,215,319,6202,936,238,261,193,287,1915,0.185199841709537,0.739130434782609,0.893835616438356,0.897674418604651,0.899686520376176,0.308771364076105
E02002022,Hawbush,Dudley,West Midlands,2019,5532,429,323,215,304,6803,1932,5672,434,362,229,300,6997,1251,369,340,211,269,2440,0.22055712270804,0.850230414746544,0.939226519337017,0.921397379912664,0.896666666666667,0.348720880377305
E02002023,Ashwood,Dudley,West Midlands,940,3190,312,373,377,253,4505,870,3229,265,352,381,273,4500,716,234,343,368,262,1923,0.221740476927841,0.883018867924528,0.974431818181818,0.965879265091863,0.95970695970696,0.427333333333333
E02002024,Quarry Bank,Dudley,West Midlands,1837,5347,447,428,345,458,7025,1688,5446,464,426,344,443,7123,1016,402,399,332,404,2553,0.186558942343004,0.866379310344828,0.936619718309859,0.965116279069768,0.91196388261851,0.358416397585287
E02002025,Shell Corner & Hurst Green,Dudley,West Midlands,1643,5177,353,342,295,405,6572,1773,5752,391,354,304,382,7183,1230,319,330,281,348,2508,0.213838664812239,0.815856777493606,0.932203389830508,0.924342105263158,0.910994764397906,0.349157733537519
E02002026,Amblecote East,Dudley,West Midlands,1117,4082,457,477,289,286,5591,1103,4188,427,487,338,342,5782,959,377,463,327,324,2450,0.228987583572111,0.882903981264637,0.950718685831622,0.967455621301775,0.947368421052632,0.423728813559322
E02002027,Withymoor Village,Dudley,West Midlands,877,3510,409,318,154,133,4524,805,3581,439,350,199,143,4712,859,398,337,185,134,1913,0.239877129293493,0.906605922551253,0.962857142857143,0.92964824120603,0.937062937062937,0.405984719864177
E02002028,Wollaston,Dudley,West Midlands,882,3396,337,351,344,564,4992,892,3447,369,359,317,530,5022,747,310,345,307,512,2221,0.216710182767624,0.840108401084011,0.96100278551532,0.968454258675079,0.966037735849057,0.442254082039028
E02002029,Quinton West,Dudley,West Midlands,988,3513,342,365,296,506,5022,1007,3655,350,350,320,506,5181,871,302,320,307,478,2278,0.238303693570451,0.862857142857143,0.914285714285714,0.959375,0.944664031620553,0.439683458791739
E02002030,Amblecote West & Stambermill,Dudley,West Midlands,1282,4041,347,338,236,307,5269,1272,4304,351,375,296,343,5669,889,293,344,275,321,2122,0.206552044609665,0.834757834757835,0.917333333333333,0.929054054054054,0.935860058309038,0.374316457929088
E02002031,Cradley West & Hayes Lane,Dudley,West Midlands,1142,3927,368,290,186,233,5004,1216,4054,379,318,206,243,5200,631,298,297,190,210,1626,0.155648741983226,0.786279683377309,0.933962264150943,0.922330097087379,0.864197530864198,0.312692307692308
E02002032,Cradley East,Dudley,West Midlands,2237,6285,458,459,318,423,7943,2140,6424,434,473,361,423,8115,1248,341,436,324,388,2737,0.194271481942715,0.785714285714286,0.921775898520085,0.897506925207756,0.91725768321513,0.337276648182378
E02002033,Hawne,Dudley,West Midlands,1518,4715,474,500,325,438,6452,1463,4893,439,515,372,436,6655,1049,382,485,357,416,2689,0.21438790108318,0.870159453302961,0.941747572815534,0.959677419354839,0.954128440366972,0.404057099924869
E02002034,Stourbridge Town & Old Quarter,Dudley,West Midlands,1383,5127,462,389,321,416,6715,1380,5409,463,456,329,462,7119,1050,355,410,312,425,2552,0.194120909595119,0.766738660907127,0.899122807017544,0.948328267477204,0.91991341991342,0.358477314229527
E02002035,Halesowen East,Dudley,West Midlands,1078,3573,433,441,296,429,5172,1047,3721,433,457,337,446,5394,949,400,441,326,427,2543,0.25503896801935,0.92378752886836,0.964989059080963,0.967359050445104,0.957399103139013,0.471449758991472
E02002036,Lye & Wynall,Dudley,West Midlands,1432,4128,337,300,246,251,5262,1495,4356,364,318,243,288,5569,576,254,299,237,259,1625,0.132231404958678,0.697802197802198,0.940251572327044,0.975308641975309,0.899305555555556,0.291793858861555
E02002037,Norton North,Dudley,West Midlands,1096,3507,394,413,249,320,4883,999,3584,377,402,285,349,4997,724,300,377,273,328,2002,0.202008928571429,0.795755968169761,0.937810945273632,0.957894736842105,0.939828080229226,0.400640384230538
E02002038,Halesowen Town,Dudley,West Midlands,1691,5843,478,624,458,484,7887,1670,6008,507,560,533,514,8122,1252,436,531,507,491,3217,0.208388814913449,0.859960552268245,0.948214285714286,0.951219512195122,0.955252918287938,0.396084708199951
E02002039,Oldswinford & Pedmore,Dudley,West Midlands,1215,3692,330,365,306,495,5188,1033,3702,336,379,296,535,5248,704,278,363,277,500,2122,0.190167477039438,0.827380952380952,0.95778364116095,0.935810810810811,0.934579439252336,0.404344512195122
E02002040,Norton South,Dudley,West Midlands,939,3323,472,470,366,532,5163,905,3390,441,490,381,541,5243,718,386,466,371,516,2457,0.211799410029499,0.875283446712018,0.951020408163265,0.973753280839895,0.953789279112754,0.468624833110814
E02002041,Pedmore Fields,Dudley,West Midlands,1061,3291,382,502,371,573,5119,1019,3535,390,437,407,601,5370,765,339,418,393,567,2482,0.216407355021216,0.869230769230769,0.956521739130435,0.965601965601966,0.94342762063228,0.46219739292365
E02002042,Hayley Green,Dudley,West Midlands,1458,4654,519,529,423,604,6729,1415,4774,531,528,433,583,6849,1045,473,507,419,557,3001,0.21889400921659,0.890772128060264,0.960227272727273,0.967667436489607,0.955403087478559,0.43816615564316
E02002043,Wood Green & Old Park,Sandwell,West Midlands,1995,5444,420,298,223,352,6737,1914,5804,464,309,229,339,7145,1274,420,283,207,297,2481,0.219503790489318,0.905172413793103,0.915857605177994,0.903930131004367,0.876106194690266,0.347235829251225
E02002044,Yew Tree & Tamebridge,Sandwell,West Midlands,1851,4908,299,267,178,227,5879,1931,5475,304,312,185,240,6516,1071,241,276,172,209,1969,0.195616438356164,0.792763157894737,0.884615384615385,0.92972972972973,0.870833333333333,0.302179251074279
E02002045,Woods & Mesty Croft,Sandwell,West Midlands,1739,4806,339,301,262,378,6086,1738,5273,367,298,247,372,6557,1218,323,265,229,346,2381,0.23098805234212,0.880108991825613,0.889261744966443,0.927125506072874,0.93010752688172,0.363123379594327
E02002046,Friar Park,Sandwell,West Midlands,1556,3427,260,167,120,138,4112,1621,3931,274,183,150,149,4687,815,225,170,145,139,1494,0.207326380055965,0.821167883211679,0.92896174863388,0.966666666666667,0.932885906040269,0.318754000426712
E02002047,Wednesbury,Sandwell,West Midlands,1247,4012,374,355,345,466,5552,1292,4491,401,397,340,443,6072,988,336,368,313,413,2418,0.219995546648853,0.837905236907731,0.926952141057935,0.920588235294118,0.932279909706546,0.398221343873518
E02002048,Great Barr,Sandwell,West Midlands,1010,3970,365,339,324,472,5470,1112,4335,391,348,329,519,5922,1035,356,326,312,483,2512,0.238754325259516,0.910485933503836,0.936781609195402,0.948328267477204,0.930635838150289,0.424181019925701
E02002049,Princes End & Willingsworth,Sandwell,West Midlands,1271,3880,267,295,211,229,4882,1216,3972,283,285,226,244,5010,791,246,270,213,231,1751,0.199144008056395,0.869257950530035,0.947368421052632,0.942477876106195,0.94672131147541,0.349500998003992
E02002051,Ocker Hill,Sandwell,West Midlands,1523,3420,228,206,149,166,4169,1621,3928,235,219,157,173,4712,809,201,200,144,158,1512,0.205957230142566,0.85531914893617,0.91324200913242,0.917197452229299,0.913294797687861,0.32088285229202
E02002052,Stone Cross & Hateley Heath,Sandwell,West Midlands,2767,7133,427,408,307,525,8800,2623,7723,466,432,287,493,9401,1363,361,382,242,437,2785,0.176485821571928,0.774678111587983,0.884259259259259,0.843205574912892,0.886409736308317,0.296245080310605
E02002053,Hamstead East,Sandwell,West Midlands,1313,4257,370,313,267,379,5586,1259,4184,323,273,248,352,5380,767,252,239,232,328,1818,0.183317399617591,0.780185758513932,0.875457875457876,0.935483870967742,0.931818181818182,0.337918215613383
E02002054,Hamstead West,Sandwell,West Midlands,1035,3394,252,299,285,343,4573,1091,3745,250,304,264,369,4932,737,207,274,249,330,1797,0.196795727636849,0.828,0.901315789473684,0.943181818181818,0.894308943089431,0.364355231143552
E02002055,Wednesbury South,Sandwell,West Midlands,2200,6351,484,358,262,408,7863,2412,7632,521,433,295,418,9299,1324,430,387,257,368,2766,0.173480083857442,0.825335892514396,0.893764434180139,0.871186440677966,0.880382775119617,0.29745133885364
E02002056,Tibbington,Sandwell,West Midlands,2324,5797,339,326,240,307,7009,2512,6552,371,336,254,323,7836,1252,308,311,235,286,2392,0.191086691086691,0.830188679245283,0.925595238095238,0.925196850393701,0.885448916408669,0.305257784583971
E02002057,Tipton,Sandwell,West Midlands,2081,6245,426,341,324,420,7756,2378,7231,461,408,299,435,8834,1249,366,358,265,385,2623,0.172728529940534,0.793926247288503,0.877450980392157,0.88628762541806,0.885057471264368,0.296920987095314
E02002058,Great Bridge & Dudley Port,Sandwell,West Midlands,2768,8446,464,332,274,326,9842,2912,9229,523,410,301,394,10857,1468,410,361,266,348,2853,0.159063820565608,0.783938814531549,0.880487804878049,0.883720930232558,0.883248730964467,0.262779773418071
E02002059,West Bromwich North,Sandwell,West Midlands,2411,7079,483,409,331,493,8795,2483,8571,553,488,336,526,10474,1381,416,427,300,440,2964,0.161124722902812,0.752260397830018,0.875,0.892857142857143,0.836501901140684,0.282986442619821
E02002060,Greets Green West,Sandwell,West Midlands,1785,4242,228,189,180,291,5130,1935,5236,295,211,141,282,6165,760,229,188,122,238,1537,0.14514896867838,0.776271186440678,0.890995260663507,0.865248226950355,0.843971631205674,0.249310624493106
E02002061,Greets Green East,Sandwell,West Midlands,1426,3792,239,208,190,338,4767,1682,5038,292,235,179,323,6067,632,227,181,148,253,1441,0.125446605795951,0.777397260273973,0.770212765957447,0.826815642458101,0.78328173374613,0.23751442228449
E02002062,West Bromwich East & Kenrick Park,Sandwell,West Midlands,2155,5422,332,288,248,366,6656,2189,7122,389,329,239,396,8475,865,280,261,197,308,1911,0.121454647570907,0.719794344473008,0.793313069908815,0.824267782426778,0.777777777777778,0.225486725663717
E02002063,North Tividale,Sandwell,West Midlands,2450,6540,350,312,206,317,7725,2494,7239,390,350,216,312,8507,1082,293,297,181,276,2129,0.14946815858544,0.751282051282051,0.848571428571429,0.837962962962963,0.884615384615385,0.250264488068649
E02002064,Tividale,Sandwell,West Midlands,2858,7728,472,472,379,488,9539,2924,8268,492,496,390,498,10144,1492,412,455,354,452,3165,0.180454765360426,0.83739837398374,0.917338709677419,0.907692307692308,0.907630522088353,0.312007097791798
E02002065,Smethwick North & West,Sandwell,West Midlands,3625,8424,384,270,303,397,9778,3885,11757,505,362,300,442,13366,1537,347,270,229,340,2723,0.130730628561708,0.687128712871287,0.74585635359116,0.763333333333333,0.769230769230769,0.203725871614544
E02002066,Oldbury & Rood End,Sandwell,West Midlands,2087,5038,317,242,199,242,6038,2217,6136,336,268,198,279,7217,838,253,215,164,230,1700,0.136571056062581,0.752976190476191,0.802238805970149,0.828282828282828,0.824372759856631,0.235554939725648
E02002067,Rowley West,Sandwell,West Midlands,1148,3233,246,303,292,354,4428,1295,3794,273,292,279,388,5026,754,232,268,270,365,1889,0.198734844491302,0.84981684981685,0.917808219178082,0.967741935483871,0.940721649484536,0.375845602865101
E02002068,Smethwick East,Sandwell,West Midlands,4302,9005,320,236,170,287,10018,4570,11715,396,298,189,295,12893,1404,259,215,121,194,2193,0.119846350832266,0.654040404040404,0.721476510067114,0.64021164021164,0.657627118644068,0.170092298146281
E02002069,Whiteheath,Sandwell,West Midlands,1457,4230,329,328,256,358,5501,1502,4655,312,320,243,365,5895,762,242,281,232,337,1854,0.163694951664876,0.775641025641026,0.878125,0.954732510288066,0.923287671232877,0.314503816793893
E02002070,Smethwick South,Sandwell,West Midlands,2503,6036,297,283,276,419,7311,2877,7924,376,296,276,455,9327,1081,270,235,236,347,2169,0.136420999495204,0.718085106382979,0.793918918918919,0.855072463768116,0.762637362637363,0.232550659376005
E02002071,Rowley East,Sandwell,West Midlands,1535,3947,295,315,253,259,5069,1527,4291,295,312,259,269,5426,822,247,288,246,258,1861,0.191563738056397,0.83728813559322,0.923076923076923,0.94980694980695,0.95910780669145,0.342978252856616
E02002072,Langley Green,Sandwell,West Midlands,1713,5629,363,354,244,375,6965,1745,6143,444,378,287,399,7651,1126,382,347,255,341,2451,0.183298062835748,0.86036036036036,0.917989417989418,0.888501742160279,0.854636591478697,0.320350281009018
E02002073,Warley East,Sandwell,West Midlands,1918,4798,310,358,244,294,6004,2086,5938,342,352,243,347,7222,1125,273,320,217,290,2225,0.189457729875379,0.798245614035088,0.909090909090909,0.893004115226337,0.835734870317003,0.308086402658543
E02002074,Warley West,Sandwell,West Midlands,1815,4929,362,356,294,349,6290,1853,5751,382,358,295,352,7138,1130,323,330,273,321,2377,0.196487567379586,0.845549738219895,0.921787709497207,0.925423728813559,0.911931818181818,0.33300644438218
E02002075,Blackheath,Sandwell,West Midlands,1734,5498,384,409,303,411,7005,1717,5833,395,418,309,394,7349,1093,318,384,284,360,2439,0.187382136122064,0.805063291139241,0.91866028708134,0.919093851132686,0.913705583756345,0.331881888692339
E02002076,Bearwood & Warley Woods,Sandwell,West Midlands,2383,7636,344,301,219,355,8855,2455,8373,407,346,251,361,9738,1419,318,300,226,300,2563,0.169473307058402,0.781326781326781,0.867052023121387,0.900398406374502,0.831024930747922,0.26319572807558
E02002077,Old Hill,Sandwell,West Midlands,2210,6387,471,490,364,499,8211,2189,6772,485,444,391,454,8546,1383,404,401,347,404,2939,0.204223272297696,0.83298969072165,0.903153153153153,0.887468030690537,0.889867841409692,0.343903580622513
E02002078,Warley South,Sandwell,West Midlands,1171,3790,265,362,254,370,5041,1297,4324,285,349,293,369,5620,983,258,323,274,339,2177,0.227335800185014,0.905263157894737,0.925501432664757,0.935153583617747,0.91869918699187,0.387366548042705
E02002079,Brandhall,Sandwell,West Midlands,1701,5109,388,404,267,458,6626,1960,5900,427,425,306,404,7462,1108,376,382,288,367,2521,0.187796610169492,0.88056206088993,0.898823529411765,0.941176470588235,0.908415841584158,0.337845081747521
E02002080,Cradley Heath,Sandwell,West Midlands,1435,4256,302,305,230,346,5439,1557,4643,364,308,238,350,5903,863,314,286,221,330,2014,0.185871203962955,0.862637362637363,0.928571428571429,0.928571428571429,0.942857142857143,0.341182449601897
E02006810,Charlemont,Sandwell,West Midlands,2004,6337,563,541,433,563,8437,2018,7015,581,614,423,594,9227,1353,495,556,391,551,3346,0.192872416250891,0.85197934595525,0.905537459283387,0.92434988179669,0.927609427609428,0.362631407824862
E02002081,Castle Bromwich West,Solihull,West Midlands,834,3180,415,404,229,355,4583,872,3396,404,427,294,346,4867,782,350,407,276,322,2137,0.230270906949352,0.866336633663366,0.953161592505855,0.938775510204082,0.930635838150289,0.439079515101705
E02002082,Smith's Wood North,Solihull,West Midlands,1427,3563,252,277,213,131,4436,1441,4049,223,272,212,141,4897,826,198,259,201,125,1609,0.204000987898246,0.887892376681614,0.952205882352941,0.94811320754717,0.886524822695036,0.32856851133347
E02002083,Castle Bromwich East,Solihull,West Midlands,964,3581,362,362,280,424,5009,1005,3900,333,397,283,418,5331,834,318,384,272,405,2213,0.213846153846154,0.954954954954955,0.967254408060453,0.96113074204947,0.9688995215311,0.415119114612643
E02002084,Smith's Wood South,Solihull,West Midlands,1587,3965,298,302,224,251,5040,1665,4440,305,316,217,255,5533,918,262,286,200,234,1900,0.206756756756757,0.859016393442623,0.905063291139241,0.921658986175115,0.917647058823529,0.343394180372312
E02002085,Kingshurst,Solihull,West Midlands,1674,3876,288,260,186,286,4896,1662,4296,274,290,187,280,5327,834,239,265,176,255,1769,0.194134078212291,0.872262773722628,0.913793103448276,0.941176470588235,0.910714285714286,0.332081847193542
E02002086,Chelmsley Wood West,Solihull,West Midlands,1354,3641,258,301,204,207,4611,1291,3976,254,299,231,217,4977,749,225,276,215,198,1663,0.188380281690141,0.885826771653543,0.923076923076923,0.930735930735931,0.912442396313364,0.334137030339562
E02002087,Fordbridge,Solihull,West Midlands,1548,3811,216,274,216,238,4755,1570,4318,214,259,208,246,5245,843,182,236,194,230,1685,0.195229272811487,0.850467289719626,0.911196911196911,0.932692307692308,0.934959349593496,0.321258341277407
E02002088,Chelmsley Wood East,Solihull,West Midlands,2409,5785,344,420,337,345,7231,2268,6436,337,431,385,400,7989,1244,280,399,356,345,2624,0.193287756370416,0.830860534124629,0.925754060324826,0.924675324675325,0.8625,0.328451620978846
E02002089,Marston Green & Airport,Solihull,West Midlands,1391,4831,394,494,343,368,6430,1450,5243,368,484,386,414,6895,1112,337,464,365,386,2664,0.212092313560938,0.915760869565217,0.958677685950413,0.94559585492228,0.932367149758454,0.386366932559826
E02002090,Lyndon North,Solihull,West Midlands,1259,3710,247,277,181,255,4670,1257,4034,276,240,212,275,5037,858,252,220,200,257,1787,0.212692117005454,0.91304347826087,0.916666666666667,0.943396226415094,0.934545454545455,0.35477466746079
E02002091,Elmdon Park,Solihull,West Midlands,1306,4464,319,395,320,631,6129,1430,4936,345,357,322,567,6527,1000,317,335,299,544,2495,0.20259319286872,0.918840579710145,0.938375350140056,0.928571428571429,0.959435626102293,0.38225831162862
E02002092,Lyndon South,Solihull,West Midlands,1411,4355,380,385,309,471,5900,1404,4805,370,353,326,454,6308,977,332,331,308,417,2365,0.203329864724246,0.897297297297297,0.937677053824363,0.94478527607362,0.918502202643172,0.374920735573874
E02002093,Olton & Kineton Green,Solihull,West Midlands,1184,4307,311,344,310,462,5734,1123,4378,360,327,292,499,5856,952,320,304,274,461,2311,0.217450890817725,0.888888888888889,0.929663608562691,0.938356164383562,0.923847695390782,0.394637978142077
E02002094,Ulverley Green & Langley,Solihull,West Midlands,1083,3532,376,353,271,577,5109,982,3752,376,379,314,530,5351,893,344,352,300,508,2397,0.238006396588486,0.914893617021277,0.928759894459103,0.955414012738854,0.958490566037736,0.447953653522706
E02002095,Elmdon Heath & Catherine-de-Barnes,Solihull,West Midlands,1726,5449,527,549,358,459,7342,1579,5549,531,564,420,474,7538,1376,481,536,391,442,3226,0.247972607677059,0.905838041431262,0.950354609929078,0.930952380952381,0.932489451476793,0.427964977447599
E02002096,Lode Heath,Solihull,West Midlands,1961,5894,545,596,525,1014,8574,2082,6769,533,638,547,961,9448,1529,484,600,505,918,4036,0.22588270054661,0.908067542213884,0.940438871473354,0.923217550274223,0.95525494276795,0.427180355630821
E02002097,"Meriden, Hampton-in-Arden & Temple Balsall",Solihull,West Midlands,1251,4312,446,495,325,439,6017,1273,4764,463,512,395,457,6591,1248,417,484,379,439,2967,0.261964735516373,0.900647948164147,0.9453125,0.959493670886076,0.960612691466083,0.450159308147474
E02002098,Shirley East,Solihull,West Midlands,2059,5764,436,465,372,760,7797,2048,6410,448,505,380,741,8484,1347,404,458,352,691,3252,0.210140405616225,0.901785714285714,0.906930693069307,0.926315789473684,0.932523616734143,0.383309759547383
E02002099,Central Solihull & Sharmans Cross,Solihull,West Midlands,1217,3984,416,403,338,596,5737,1232,4299,432,401,357,626,6115,922,390,374,334,601,2621,0.214468481042103,0.902777777777778,0.932668329177057,0.935574229691877,0.960063897763578,0.428618152085037
E02002101,Solihull Lodge,Solihull,West Midlands,1083,3719,317,361,278,478,5153,1128,4042,341,359,311,468,5521,811,292,328,299,439,2169,0.200643245917862,0.856304985337243,0.913649025069638,0.961414790996785,0.938034188034188,0.392863611664554
E02002102,Blossomfield,Solihull,West Midlands,1856,5266,433,458,312,685,7154,1801,5703,457,465,347,673,7645,1136,407,437,319,625,2924,0.199193406978783,0.890590809628009,0.939784946236559,0.919308357348703,0.928677563150074,0.382472204054938
E02002103,Shirley Heath,Solihull,West Midlands,1054,3473,380,477,290,483,5103,972,3714,397,461,323,526,5421,826,355,437,301,497,2416,0.222401723209478,0.894206549118388,0.947939262472885,0.931888544891641,0.944866920152091,0.445674229846892
E02002104,Monkspath North,Solihull,West Midlands,992,3722,417,349,221,263,4972,985,4077,405,394,263,322,5461,771,376,379,254,309,2089,0.189109639440765,0.928395061728395,0.961928934010152,0.965779467680608,0.959627329192547,0.382530672038088
E02002105,Balsall Common,Solihull,West Midlands,1492,4820,497,528,412,606,6863,1457,5056,476,544,456,607,7139,1191,443,520,445,587,3186,0.23556170886076,0.930672268907563,0.955882352941176,0.975877192982456,0.967051070840198,0.446280991735537
E02002106,Knowle,Solihull,West Midlands,1791,5105,650,804,567,854,7980,1775,5747,613,749,636,916,8661,1274,580,723,615,892,4084,0.221680876979294,0.946166394779772,0.965287049399199,0.966981132075472,0.973799126637555,0.471539083246738
E02002107,Monkspath South,Solihull,West Midlands,968,3459,377,367,206,320,4729,1022,3646,376,402,255,281,4960,669,347,377,239,263,1895,0.183488754799781,0.922872340425532,0.937810945273632,0.937254901960784,0.935943060498221,0.382056451612903
E02002108,Dorridge,Solihull,West Midlands,2025,5621,547,611,455,759,7993,1999,6193,546,625,490,753,8607,1384,496,599,478,722,3679,0.223478120458582,0.908424908424908,0.9584,0.975510204081633,0.958831341301461,0.427442779133264
E02002109,"Dickens Heath, Cheswick Green & Hockley Heath",Solihull,West Midlands,2215,6963,514,568,318,378,8741,2356,7666,508,594,403,397,9568,1423,465,558,388,373,3207,0.185624836942343,0.915354330708661,0.939393939393939,0.962779156327543,0.939546599496222,0.335179765886288
E02006808,Shirley West,Solihull,West Midlands,1443,4028,303,268,210,313,5122,1479,4462,284,287,218,325,5576,846,255,274,203,307,1885,0.189601075750784,0.897887323943662,0.954703832752613,0.931192660550459,0.944615384615385,0.338055954088953
E02002110,Brownhills West & Clayhanger,Walsall,West Midlands,1490,4606,306,316,256,261,5745,1410,4681,283,335,279,296,5874,1171,249,311,260,282,2273,0.250160222174749,0.879858657243816,0.928358208955224,0.931899641577061,0.952702702702703,0.3869594824651
E02002111,Brownhills,Walsall,West Midlands,1225,3686,307,370,282,343,4988,1331,4020,308,366,301,391,5386,1008,281,337,293,377,2296,0.250746268656716,0.912337662337662,0.920765027322404,0.973421926910299,0.964194373401535,0.426290382473078
E02002112,Pelsall North,Walsall,West Midlands,933,3161,302,382,271,311,4427,903,3381,312,336,277,299,4605,846,289,316,265,284,2000,0.250221827861579,0.926282051282051,0.940476190476191,0.956678700361011,0.949832775919733,0.434310532030402
E02002113,Walsall Wood,Walsall,West Midlands,1200,3962,336,330,226,312,5166,1221,4100,336,333,252,358,5379,885,292,320,242,340,2079,0.215853658536585,0.869047619047619,0.960960960960961,0.96031746031746,0.949720670391061,0.386503067484663
E02002114,Pelsall South,Walsall,West Midlands,918,3431,298,435,350,595,5109,968,3607,305,394,350,597,5253,908,281,380,328,584,2481,0.251732741890768,0.921311475409836,0.964467005076142,0.937142857142857,0.97822445561139,0.472301541976014
E02002115,Little Bloxwich,Walsall,West Midlands,1364,3960,331,360,327,442,5420,1439,4390,335,360,283,450,5818,948,291,335,274,427,2275,0.215945330296128,0.86865671641791,0.930555555555556,0.968197879858657,0.948888888888889,0.391027844620144
E02002116,Aldridge North,Walsall,West Midlands,1099,3810,437,472,401,463,5583,1057,4107,447,468,405,520,5947,1028,404,454,392,504,2782,0.250304358412467,0.903803131991051,0.97008547008547,0.967901234567901,0.969230769230769,0.467798890196738
E02002117,Bloxwich Central & North,Walsall,West Midlands,1126,4103,376,367,223,311,5380,1129,4109,399,376,219,315,5418,1037,365,354,206,302,2264,0.252372840107082,0.914786967418546,0.941489361702128,0.940639269406393,0.958730158730159,0.417866371354743
E02002118,Bloxwich North West,Walsall,West Midlands,1641,4476,312,294,258,478,5818,1740,4832,319,311,242,446,6150,1004,291,292,230,429,2246,0.207781456953642,0.912225705329154,0.938906752411576,0.950413223140496,0.961883408071749,0.36520325203252
E02002119,Shelfield,Walsall,West Midlands,1057,3579,296,309,274,358,4816,1130,3964,307,311,269,350,5201,930,263,294,259,340,2086,0.234611503531786,0.856677524429968,0.945337620578778,0.962825278810409,0.971428571428571,0.401076716016151
E02002120,Ashmore,Walsall,West Midlands,1182,3750,394,299,235,210,4888,1193,3960,416,346,213,228,5163,965,385,320,197,211,2078,0.243686868686869,0.925480769230769,0.92485549132948,0.924882629107981,0.925438596491228,0.402479178772032
E02002121,Blakenall North,Walsall,West Midlands,1706,3927,280,271,211,413,5102,1733,4371,284,256,199,337,5447,839,252,243,184,312,1830,0.191946922900938,0.887323943661972,0.94921875,0.924623115577889,0.925816023738872,0.335964751239214
E02002122,Blakenall South,Walsall,West Midlands,2062,4002,238,195,152,169,4756,2310,4678,231,204,117,208,5438,727,187,178,107,192,1391,0.155408294142796,0.80952380952381,0.872549019607843,0.914529914529914,0.923076923076923,0.255792570798088
E02002123,New Invention,Walsall,West Midlands,1345,3899,307,332,297,366,5201,1382,4121,317,327,290,403,5458,879,283,313,272,377,2124,0.213297743266198,0.892744479495268,0.957186544342508,0.937931034482759,0.935483870967742,0.389153536093807
E02002124,Aldridge Central,Walsall,West Midlands,1179,3982,339,461,357,780,5919,1143,4106,367,422,359,718,5972,1063,337,395,348,696,2839,0.258889430102289,0.918256130790191,0.936018957345972,0.969359331476323,0.969359331476323,0.475385130609511
E02002125,Rushall,Walsall,West Midlands,1248,3858,311,306,214,351,5040,1290,4115,317,330,215,344,5321,921,281,311,198,326,2037,0.223815309842041,0.886435331230284,0.942424242424242,0.92093023255814,0.947674418604651,0.38282277767337
E02002126,Bloxwich South,Walsall,West Midlands,1716,4227,290,228,169,227,5141,1712,4273,324,244,166,225,5232,880,274,223,155,203,1735,0.205944301427568,0.845679012345679,0.913934426229508,0.933734939759036,0.902222222222222,0.331613149847095
E02002127,Walsall Ryecroft,Walsall,West Midlands,2770,6018,364,261,185,287,7115,2771,6519,369,281,196,292,7657,860,267,239,170,257,1793,0.131922073937721,0.723577235772358,0.850533807829182,0.86734693877551,0.88013698630137,0.234164816507771
E02002128,Short Heath East,Walsall,West Midlands,974,3243,351,342,297,347,4580,968,3238,327,352,323,406,4646,818,294,331,314,390,2147,0.252625077208153,0.89908256880734,0.940340909090909,0.972136222910217,0.960591133004926,0.462117950925527
E02002129,Short Heath West,Walsall,West Midlands,1046,3455,417,368,269,343,4852,1042,3743,393,373,295,346,5150,900,351,345,280,326,2202,0.240448837830617,0.893129770992367,0.924932975871314,0.949152542372881,0.942196531791908,0.427572815533981
E02002130,Leamore,Walsall,West Midlands,1858,4339,297,230,193,224,5283,1791,4653,276,242,202,250,5623,857,241,223,194,218,1733,0.184182248012035,0.873188405797101,0.921487603305785,0.96039603960396,0.872,0.308198470567313
E02002131,Aldridge South,Walsall,West Midlands,1282,4490,469,572,454,571,6556,1254,4808,462,500,464,630,6864,1286,435,475,452,612,3260,0.267470881863561,0.941558441558442,0.95,0.974137931034483,0.971428571428571,0.474941724941725
E02002132,Bentley,Walsall,West Midlands,1557,3906,396,263,193,325,5083,1484,4144,354,299,199,292,5288,975,291,273,187,277,2003,0.235279922779923,0.822033898305085,0.91304347826087,0.939698492462312,0.948630136986301,0.378782148260212
E02002133,Walsall North East,Walsall,West Midlands,1197,4504,344,338,246,338,5770,1268,4689,389,348,254,379,6059,866,315,317,232,341,2071,0.18468756664534,0.809768637532134,0.910919540229885,0.913385826771654,0.899736147757256,0.341805578478297
E02002134,Willenhall Park,Walsall,West Midlands,2027,5779,342,307,251,305,6984,2209,6283,372,308,258,318,7539,1300,325,283,246,290,2444,0.206907528250836,0.873655913978495,0.918831168831169,0.953488372093023,0.911949685534591,0.324180925852235
E02002135,Walsall West,Walsall,West Midlands,2221,5242,269,204,143,181,6039,2185,5812,302,215,172,206,6707,884,222,193,147,170,1616,0.152099105299381,0.735099337748344,0.897674418604651,0.854651162790698,0.825242718446602,0.240942299090503
E02002136,Willenhall Town,Walsall,West Midlands,1823,5274,333,277,217,241,6342,1781,5462,358,300,219,237,6576,1116,294,281,202,217,2110,0.204320761625778,0.82122905027933,0.936666666666667,0.922374429223744,0.915611814345992,0.320863746958637
E02002137,Streetly North,Walsall,West Midlands,940,3447,339,394,393,637,5210,995,3613,351,378,381,635,5358,1069,322,355,364,607,2717,0.29587600332134,0.917378917378917,0.939153439153439,0.955380577427822,0.955905511811024,0.50709219858156
E02002138,Walsall East,Walsall,West Midlands,1413,4159,282,292,166,333,5232,1364,4234,279,268,221,332,5334,852,236,248,199,299,1834,0.201228153046764,0.845878136200717,0.925373134328358,0.900452488687783,0.900602409638554,0.343832020997375
E02002139,Walsall Central,Walsall,West Midlands,2482,7501,324,247,172,334,8578,2651,8048,382,284,180,316,9210,1201,281,247,161,266,2156,0.149229622266402,0.735602094240838,0.869718309859155,0.894444444444445,0.841772151898734,0.234093376764387
E02002140,Pleck,Walsall,West Midlands,2345,5402,301,265,193,320,6481,2381,6323,327,316,201,311,7478,833,256,275,175,255,1794,0.131741262059149,0.782874617737003,0.870253164556962,0.870646766169154,0.819935691318328,0.239903717571543
E02002141,Streetly South,Walsall,West Midlands,1190,3814,329,410,370,475,5398,1192,4010,312,359,362,512,5555,1111,284,343,351,489,2578,0.277057356608479,0.91025641025641,0.955431754874652,0.969613259668508,0.955078125,0.464086408640864
E02002142,Darlaston East,Walsall,West Midlands,1954,4578,253,234,125,220,5410,1950,5144,296,250,143,212,6045,885,232,224,127,180,1648,0.172045101088647,0.783783783783784,0.896,0.888111888111888,0.849056603773585,0.27262200165426
E02002143,Palfrey,Walsall,West Midlands,3167,6597,282,230,230,255,7594,3222,7697,319,265,206,273,8760,1152,243,221,170,203,1989,0.149668702091724,0.761755485893417,0.833962264150943,0.825242718446602,0.743589743589744,0.227054794520548
E02002144,Walsall South East,Walsall,West Midlands,1222,3849,428,385,367,532,5561,1210,4199,446,447,347,549,5988,1201,400,421,324,504,2850,0.286020481066921,0.896860986547085,0.941834451901566,0.93371757925072,0.918032786885246,0.475951903807615
E02002145,Darlaston Central,Walsall,West Midlands,2245,4905,305,230,198,218,5856,2232,5516,343,255,194,258,6566,1076,271,223,176,227,1973,0.195068890500363,0.790087463556851,0.874509803921569,0.907216494845361,0.87984496124031,0.300487359122754
E02002146,The Delves,Walsall,West Midlands,1565,4111,304,211,163,272,5061,1565,4552,294,241,182,276,5545,930,248,217,165,253,1813,0.204305799648506,0.843537414965986,0.900414937759336,0.906593406593407,0.916666666666667,0.326961226330027
E02002147,Darlaston West,Walsall,West Midlands,2225,5393,322,299,264,326,6604,2306,5825,331,329,219,362,7066,1151,279,289,201,329,2249,0.197596566523605,0.842900302114804,0.878419452887538,0.917808219178082,0.908839779005525,0.318284743843759
E02002148,Pheasey & Sutton Road,Walsall,West Midlands,2047,6891,534,525,512,887,9349,2093,7260,495,528,495,875,9653,1576,430,504,464,820,3794,0.217079889807163,0.868686868686869,0.954545454545455,0.937373737373737,0.937142857142857,0.393038433647571
E02002149,Bushbury,Wolverhampton,West Midlands,1880,5769,533,551,463,605,7921,2013,6659,571,531,435,631,8827,1532,447,486,403,585,3453,0.230064574260399,0.782837127845884,0.915254237288136,0.926436781609195,0.927099841521395,0.391186133454175
E02002150,Fordhouses,Wolverhampton,West Midlands,1177,3530,285,227,183,262,4487,1249,3977,291,232,169,286,4955,804,228,214,153,260,1659,0.202162433995474,0.783505154639175,0.922413793103448,0.905325443786982,0.909090909090909,0.33481331987891
E02002151,Pendeford,Wolverhampton,West Midlands,1227,3674,311,247,141,168,4541,1171,3911,321,251,163,174,4820,776,247,219,144,153,1539,0.198414727691128,0.769470404984424,0.872509960159363,0.883435582822086,0.879310344827586,0.319294605809129
E02002152,Bushbury Hill,Wolverhampton,West Midlands,1695,3735,232,216,151,282,4616,1636,4387,249,220,163,308,5327,932,185,198,151,271,1737,0.212445862776385,0.742971887550201,0.9,0.92638036809816,0.87987012987013,0.326074713722546
E02002153,Ashmore Park,Wolverhampton,West Midlands,1327,4363,313,361,335,576,5948,1398,4864,349,337,319,582,6451,1235,282,303,301,552,2673,0.25390625,0.808022922636103,0.899109792284867,0.943573667711599,0.948453608247423,0.414354363664548
E02002154,Oxley Park,Wolverhampton,West Midlands,1538,4034,261,209,140,245,4889,1749,4899,286,235,148,229,5797,926,219,210,132,189,1676,0.189018166972852,0.765734265734266,0.893617021276596,0.891891891891892,0.825327510917031,0.289115059513542
E02002155,Low Hill,Wolverhampton,West Midlands,2021,3629,217,156,143,162,4307,2148,4602,237,190,140,240,5409,820,140,162,120,188,1430,0.178183398522382,0.590717299578059,0.852631578947369,0.857142857142857,0.783333333333333,0.264374191162877
E02002156,Wood End,Wolverhampton,West Midlands,1572,5121,387,360,270,436,6574,1716,5660,459,377,310,481,7287,1443,352,347,287,453,2882,0.254946996466431,0.766884531590414,0.920424403183024,0.925806451612903,0.941787941787942,0.395498833539179
E02002157,Tettenhall North,Wolverhampton,West Midlands,1438,4645,385,359,282,493,6164,1477,5306,384,375,304,496,6865,1225,317,353,288,471,2654,0.230870712401055,0.825520833333333,0.941333333333333,0.947368421052632,0.949596774193548,0.386598689002185
E02002158,Wednesfield North East,Wolverhampton,West Midlands,1350,4196,401,382,374,590,5943,1475,4836,383,404,325,600,6548,1093,319,387,306,564,2669,0.22601323407775,0.83289817232376,0.957920792079208,0.941538461538462,0.94,0.407605375687233
E02002159,Park Lane,Wolverhampton,West Midlands,1766,4024,192,169,118,149,4652,1809,4846,213,186,121,167,5533,717,125,149,97,124,1212,0.147957078002476,0.586854460093897,0.801075268817204,0.801652892561983,0.74251497005988,0.219049340321706
E02002160,Wednesfield Town,Wolverhampton,West Midlands,1546,4622,379,329,291,336,5957,1575,5160,390,371,303,362,6586,1232,327,342,295,335,2531,0.238759689922481,0.838461538461539,0.921832884097035,0.973597359735974,0.925414364640884,0.384300030367446
E02002161,Whitmore Reans & Dunstall Hill,Wolverhampton,West Midlands,1918,4685,198,156,118,164,5321,2054,5637,241,171,125,167,6341,727,160,139,97,126,1249,0.128969309916622,0.663900414937759,0.812865497076023,0.776,0.754491017964072,0.1969720864217
E02002162,Tettenhall South,Wolverhampton,West Midlands,1227,4152,463,473,478,903,6469,1259,4544,493,488,467,919,6911,1198,429,461,448,884,3420,0.263644366197183,0.870182555780933,0.944672131147541,0.9593147751606,0.961915125136017,0.494863261467226
E02002163,Heath Town,Wolverhampton,West Midlands,3235,8415,413,304,249,401,9782,3229,9167,430,313,241,318,10469,1385,257,254,183,243,2322,0.151085415075815,0.597674418604651,0.811501597444089,0.759336099585062,0.764150943396226,0.221797688413411
E02002164,Waterloo Road,Wolverhampton,West Midlands,1638,5817,159,113,89,160,6338,1806,6855,161,118,98,150,7382,463,88,90,75,102,818,0.0675419401896426,0.546583850931677,0.76271186440678,0.76530612244898,0.68,0.110810078569493
E02002165,West Park,Wolverhampton,West Midlands,1364,5798,293,186,172,352,6801,1427,6212,335,244,157,322,7270,949,264,207,136,257,1813,0.152768834513844,0.788059701492537,0.848360655737705,0.866242038216561,0.798136645962733,0.249381017881706
E02002166,East Park,Wolverhampton,West Midlands,2216,5879,416,386,358,408,7447,2351,6926,421,389,356,451,8543,1076,311,335,302,400,2424,0.155356627201848,0.738717339667459,0.861182519280206,0.848314606741573,0.886917960088692,0.283741074563971
E02002167,Castlecroft,Wolverhampton,West Midlands,1085,3832,413,403,335,471,5454,1101,4123,432,413,343,456,5767,971,358,389,328,433,2479,0.235508125151589,0.828703703703704,0.941888619854721,0.956268221574344,0.949561403508772,0.429859545691001
E02002168,Wolverhampton Central,Wolverhampton,West Midlands,2663,8755,339,223,215,320,9852,2939,9895,397,270,183,365,11110,1150,264,214,150,279,2057,0.11622031328954,0.664987405541562,0.792592592592593,0.819672131147541,0.764383561643836,0.185148514851485
E02002169,Compton & Merryhill North,Wolverhampton,West Midlands,1447,4926,612,597,409,743,7287,1507,5481,610,603,430,746,7870,1369,535,569,403,697,3573,0.249771939427112,0.877049180327869,0.943615257048093,0.937209302325581,0.934316353887399,0.454002541296061
E02002170,Bilston North West,Wolverhampton,West Midlands,1281,3894,286,261,206,331,4978,1412,4375,319,285,211,322,5512,868,279,266,192,288,1893,0.1984,0.87460815047022,0.933333333333333,0.909952606635071,0.894409937888199,0.343432510885341
E02002171,Bilston North East,Wolverhampton,West Midlands,1572,4413,395,382,304,379,5873,1796,5190,394,404,290,374,6652,973,330,371,268,312,2254,0.18747591522158,0.83756345177665,0.918316831683168,0.924137931034483,0.834224598930481,0.338845460012027
E02002174,Bradmore,Wolverhampton,West Midlands,1366,4711,441,427,269,437,6285,1353,5221,439,437,294,420,6811,1231,357,404,278,383,2653,0.235778586477686,0.813211845102506,0.924485125858124,0.945578231292517,0.911904761904762,0.389516957862282
E02002175,Bilston Lunt & Loxdale,Wolverhampton,West Midlands,1786,4625,347,304,226,291,5793,1901,5533,376,347,223,340,6819,862,286,295,193,292,1928,0.155792517621543,0.76063829787234,0.85014409221902,0.865470852017937,0.858823529411765,0.282739404604781
E02002176,Merryhill South,Wolverhampton,West Midlands,1469,4500,412,406,295,365,5978,1497,5123,429,431,328,355,6666,1112,357,392,304,319,2484,0.217060316220964,0.832167832167832,0.909512761020882,0.926829268292683,0.898591549295775,0.372637263726373
E02002177,Ettingshall,Wolverhampton,West Midlands,2681,6760,427,288,274,333,8082,2928,8008,425,346,265,358,9402,1149,337,305,226,290,2307,0.143481518481519,0.792941176470588,0.88150289017341,0.852830188679245,0.810055865921788,0.245373324824505
E02002178,Goldthorn Park,Wolverhampton,West Midlands,1472,4900,447,397,341,593,6678,1519,5657,547,445,316,568,7533,1234,438,399,283,494,2848,0.21813682163691,0.80073126142596,0.896629213483146,0.895569620253165,0.869718309859155,0.3780698260985
E02002179,Upper Penn,Wolverhampton,West Midlands,1144,3696,344,366,240,412,5058,1209,4166,375,361,255,447,5604,990,315,334,237,427,2303,0.237638022083533,0.84,0.925207756232687,0.929411764705882,0.955257270693512,0.410956459671663
E02002180,Ettingshall Park,Wolverhampton,West Midlands,1285,3788,286,299,267,504,5144,1266,4208,323,319,262,481,5593,778,274,288,249,434,2023,0.184885931558935,0.848297213622291,0.90282131661442,0.950381679389313,0.902286902286902,0.361702127659575
E02002181,Bradley,Wolverhampton,West Midlands,1974,5139,358,286,220,298,6301,2077,5607,335,328,241,311,6822,1055,282,301,233,280,2151,0.188157660067772,0.841791044776119,0.917682926829268,0.966804979253112,0.90032154340836,0.315303430079156
E02002182,Woodcross,Wolverhampton,West Midlands,1321,3952,369,253,217,324,5115,1349,4506,373,312,212,339,5742,908,319,283,196,304,2010,0.201509098979139,0.855227882037534,0.907051282051282,0.924528301886792,0.896755162241888,0.350052246603971
E02006894,Blakenhall,Wolverhampton,West Midlands,3822,9013,524,407,372,503,10819,4071,11473,616,480,327,581,13477,1204,429,390,273,464,2760,0.104942037827944,0.696428571428571,0.8125,0.834862385321101,0.798623063683305,0.204793351636121
E02002652,Kingswood,"Kingston upon Hull, City of",Yorkshire and the Humber,3927,9985,442,293,142,159,11021,4342,11319,493,389,181,177,12559,2450,440,366,174,164,3594,0.216450216450216,0.892494929006085,0.940874035989717,0.961325966850829,0.926553672316384,0.28616928099371
E02002653,Bransholme Central,"Kingston upon Hull, City of",Yorkshire and the Humber,1989,4824,351,315,239,289,6018,2066,5464,342,360,231,319,6716,1142,280,330,210,297,2259,0.20900439238653,0.818713450292398,0.916666666666667,0.909090909090909,0.931034482758621,0.336360929124479
E02002654,Orchard Park,"Kingston upon Hull, City of",Yorkshire and the Humber,2542,4721,263,219,114,238,5555,2573,5408,272,221,125,234,6260,905,190,191,111,216,1613,0.167344674556213,0.698529411764706,0.864253393665159,0.888,0.923076923076923,0.257667731629393
E02002655,Bransholme East,"Kingston upon Hull, City of",Yorkshire and the Humber,2170,5350,342,374,236,238,6540,2150,5994,363,401,242,278,7278,1325,292,378,223,264,2482,0.221054387721054,0.804407713498623,0.942643391521197,0.921487603305785,0.949640287769784,0.341027754877714
E02002656,Haworth Park,"Kingston upon Hull, City of",Yorkshire and the Humber,597,2781,357,408,331,479,4356,603,2881,382,436,301,518,4518,707,338,417,291,502,2255,0.245400902464422,0.884816753926702,0.956422018348624,0.966777408637874,0.969111969111969,0.499114652501107
E02002657,Bransholme West,"Kingston upon Hull, City of",Yorkshire and the Humber,1309,4197,520,521,295,334,5867,1262,4625,540,541,331,383,6420,1095,481,512,322,365,2775,0.236756756756757,0.890740740740741,0.946395563770795,0.972809667673716,0.953002610966058,0.432242990654206
E02002658,Sutton North,"Kingston upon Hull, City of",Yorkshire and the Humber,953,3942,465,385,228,383,5403,937,4021,491,428,252,443,5635,1002,413,415,243,433,2506,0.249191743347426,0.841140529531568,0.969626168224299,0.964285714285714,0.977426636568849,0.44472049689441
E02002659,Greenwood,"Kingston upon Hull, City of",Yorkshire and the Humber,2736,6678,432,354,239,425,8128,2771,7547,492,390,249,403,9081,1650,401,346,225,374,2996,0.218629919173181,0.815040650406504,0.887179487179487,0.903614457831325,0.928039702233251,0.329919612377491
E02002660,Bilton Grange,"Kingston upon Hull, City of",Yorkshire and the Humber,1397,4016,420,369,208,299,5312,1455,4593,426,411,237,366,6033,1097,351,383,223,348,2402,0.238841715654256,0.823943661971831,0.931873479318735,0.940928270042194,0.950819672131147,0.398143543842201
E02002661,Longhill,"Kingston upon Hull, City of",Yorkshire and the Humber,1858,4800,413,380,236,543,6372,1865,5381,479,398,269,449,6976,1237,385,375,255,417,2669,0.229882921390076,0.803757828810021,0.942211055276382,0.947955390334572,0.928730512249443,0.38259747706422
E02002662,Ings,"Kingston upon Hull, City of",Yorkshire and the Humber,1230,4040,366,402,285,492,5585,1352,4642,444,447,285,482,6300,1155,343,423,266,449,2636,0.248815165876777,0.772522522522523,0.946308724832215,0.933333333333333,0.931535269709544,0.418412698412698
E02002663,University & Newland North,"Kingston upon Hull, City of",Yorkshire and the Humber,820,5456,226,219,115,130,6146,826,6056,249,223,144,144,6816,1008,217,205,135,136,1701,0.166446499339498,0.8714859437751,0.919282511210762,0.9375,0.944444444444444,0.24955985915493
E02002664,Sutton South,"Kingston upon Hull, City of",Yorkshire and the Humber,1261,4317,405,475,249,312,5758,1242,4736,427,493,293,346,6295,1072,373,477,284,334,2540,0.226351351351351,0.873536299765808,0.967545638945233,0.969283276450512,0.965317919075144,0.403494837172359
E02002665,Bricknell East,"Kingston upon Hull, City of",Yorkshire and the Humber,1583,4913,430,417,275,390,6425,1566,5273,450,442,304,391,6860,1345,397,415,288,368,2813,0.255073013464821,0.882222222222222,0.938914027149321,0.947368421052632,0.941176470588235,0.410058309037901
E02002666,Newland South,"Kingston upon Hull, City of",Yorkshire and the Humber,1066,7209,224,185,119,219,7956,1226,7384,265,191,138,193,8171,709,171,159,118,172,1329,0.0960184182015168,0.645283018867925,0.832460732984293,0.855072463768116,0.89119170984456,0.162648390649859
E02002667,Stoneferry & Sutton Fields,"Kingston upon Hull, City of",Yorkshire and the Humber,1278,4666,394,325,186,250,5821,1324,4908,387,350,215,277,6137,980,306,333,208,261,2088,0.199674001629992,0.790697674418605,0.951428571428571,0.967441860465116,0.942238267148014,0.340231383412091
E02002668,Southcoates East,"Kingston upon Hull, City of",Yorkshire and the Humber,2113,4893,402,370,268,378,6311,2175,5578,411,399,257,370,7015,1166,276,365,226,336,2369,0.209035496593761,0.671532846715328,0.914786967418546,0.879377431906615,0.908108108108108,0.337704918032787
E02002669,Newland Avenues,"Kingston upon Hull, City of",Yorkshire and the Humber,1154,6192,284,202,125,159,6962,1254,6653,345,250,152,168,7568,1040,279,223,129,149,1820,0.15632045693672,0.808695652173913,0.892,0.848684210526316,0.886904761904762,0.240486257928118
E02002670,Bricknell West,"Kingston upon Hull, City of",Yorkshire and the Humber,1524,4768,361,426,247,474,6276,1482,5047,397,421,283,457,6605,1340,330,388,271,425,2754,0.26550425995641,0.831234256926952,0.921615201900238,0.957597173144876,0.929978118161926,0.416956850870553
E02002671,Southcoates Central & Docks,"Kingston upon Hull, City of",Yorkshire and the Humber,1650,5985,350,310,213,311,7169,1707,6794,380,324,212,325,8035,1316,274,298,194,298,2380,0.193700323815131,0.721052631578947,0.919753086419753,0.915094339622642,0.916923076923077,0.296204107031736
E02002672,Greatfield,"Kingston upon Hull, City of",Yorkshire and the Humber,2105,4316,269,248,151,276,5260,2166,4921,299,252,144,277,5893,909,183,227,138,268,1725,0.184718553139606,0.612040133779264,0.900793650793651,0.958333333333333,0.967509025270758,0.29272017648057
E02002673,Southcoates West,"Kingston upon Hull, City of",Yorkshire and the Humber,1368,4856,341,324,226,282,6029,1426,5129,377,370,221,304,6401,1013,294,355,206,287,2155,0.197504386820043,0.779840848806366,0.959459459459459,0.932126696832579,0.944078947368421,0.336666145914701
E02002674,Derringham,"Kingston upon Hull, City of",Yorkshire and the Humber,1151,4164,330,331,218,275,5318,1135,4377,344,346,225,312,5604,1156,309,328,219,296,2308,0.264107836417638,0.898255813953488,0.947976878612717,0.973333333333333,0.948717948717949,0.411848679514632
E02002675,Sculcoates,"Kingston upon Hull, City of",Yorkshire and the Humber,1830,6400,352,260,165,200,7377,1859,7212,366,299,165,216,8258,872,223,247,146,189,1677,0.120909595119246,0.609289617486339,0.826086956521739,0.884848484848485,0.875,0.203075805279729
E02002676,Chanterlands Avenue,"Kingston upon Hull, City of",Yorkshire and the Humber,1246,5080,300,271,174,249,6074,1273,5543,309,291,186,258,6587,1038,237,255,171,224,1925,0.187263214865596,0.766990291262136,0.876288659793815,0.919354838709677,0.868217054263566,0.292242295430393
E02002677,Drypool & Victoria Dock,"Kingston upon Hull, City of",Yorkshire and the Humber,1408,5761,377,342,187,278,6945,1382,5910,382,369,218,255,7134,1133,283,334,201,233,2184,0.1917089678511,0.740837696335079,0.905149051490515,0.922018348623853,0.913725490196078,0.306139613120269
E02002678,Newington,"Kingston upon Hull, City of",Yorkshire and the Humber,1643,5421,288,256,189,232,6386,1716,6186,323,297,184,237,7227,1275,255,277,174,221,2202,0.206110572259942,0.789473684210526,0.932659932659933,0.945652173913043,0.932489451476793,0.304690743046907
E02002679,East Ella,"Kingston upon Hull, City of",Yorkshire and the Humber,1416,4438,452,389,301,442,6022,1394,4852,495,452,300,437,6536,1253,419,419,286,412,2789,0.258244023083265,0.846464646464647,0.926991150442478,0.953333333333333,0.94279176201373,0.42671358629131
E02002680,Hull City Centre,"Kingston upon Hull, City of",Yorkshire and the Humber,1348,7300,323,314,191,316,8444,1413,7593,356,312,190,288,8739,1027,225,266,160,260,1938,0.135256156986698,0.632022471910112,0.852564102564103,0.842105263157895,0.902777777777778,0.22176450394782
E02002681,Boulevard & St Andrew's Quay,"Kingston upon Hull, City of",Yorkshire and the Humber,1966,6081,274,263,154,230,7002,2135,7360,373,246,185,251,8415,1004,245,207,161,218,1835,0.136413043478261,0.656836461126005,0.841463414634146,0.87027027027027,0.868525896414343,0.218062982768865
E02002682,Gipsyville,"Kingston upon Hull, City of",Yorkshire and the Humber,2131,6032,447,343,252,268,7342,2403,7177,481,406,257,291,8612,1510,371,368,234,267,2750,0.210394315173471,0.771309771309771,0.906403940886699,0.910505836575875,0.917525773195876,0.319321876451463
E02006813,Anlaby Park & Pickering,"Kingston upon Hull, City of",Yorkshire and the Humber,1470,4634,427,423,306,569,6359,1597,5257,456,491,322,545,7071,1332,366,463,301,517,2979,0.253376450447023,0.802631578947369,0.942973523421589,0.934782608695652,0.948623853211009,0.421298260500636
E02002684,Bridlington North & Bempton,East Riding of Yorkshire,Yorkshire and the Humber,1250,4675,991,1153,843,1032,8694,1282,4990,989,1180,930,1048,9137,1490,723,1112,892,989,5206,0.298597194388778,0.731041456016178,0.942372881355932,0.959139784946237,0.943702290076336,0.569771259713254
E02002685,Bridlington East & Flamborough,East Riding of Yorkshire,Yorkshire and the Humber,1064,3857,720,879,605,726,6787,1047,4058,709,845,650,772,7034,1248,521,806,626,738,3939,0.307540660423854,0.734837799717913,0.953846153846154,0.963076923076923,0.955958549222798,0.559994313335229
E02002686,Bridlington West,East Riding of Yorkshire,Yorkshire and the Humber,1793,4361,513,572,359,547,6352,1762,4536,471,564,388,562,6521,1237,316,528,362,518,2961,0.272707231040564,0.670912951167728,0.936170212765957,0.93298969072165,0.921708185053381,0.454071461432296
E02002687,Bridlington Central,East Riding of Yorkshire,Yorkshire and the Humber,973,3361,445,483,301,416,5006,938,3619,432,439,358,445,5293,1047,299,403,338,410,2497,0.289306438242608,0.69212962962963,0.917995444191344,0.94413407821229,0.921348314606742,0.471755148309088
E02002688,Bridlington Hilderthorpe,East Riding of Yorkshire,Yorkshire and the Humber,868,3346,377,358,253,331,4665,936,3685,379,363,266,311,5004,952,259,342,238,290,2081,0.258344640434193,0.683377308707124,0.942148760330578,0.894736842105263,0.932475884244373,0.415867306155076
E02002689,"Burton Agnes, Rudston & Langtoft",East Riding of Yorkshire,Yorkshire and the Humber,763,3155,482,494,316,458,4905,773,3253,514,498,367,450,5082,791,359,454,348,439,2391,0.243160159852444,0.698443579766537,0.911646586345381,0.948228882833788,0.975555555555555,0.470484061393152
E02002691,Driffield West & Huggate,East Riding of Yorkshire,Yorkshire and the Humber,1361,4467,606,681,485,590,6829,1301,4677,614,687,514,613,7105,886,427,664,497,592,3066,0.189437673722472,0.695439739413681,0.966521106259098,0.96692607003891,0.965742251223491,0.431527093596059
E02002692,Stamford Bridge & Sutton Upon Derwent,East Riding of Yorkshire,Yorkshire and the Humber,1430,5426,629,666,424,504,7649,1517,5740,593,681,482,580,8076,1089,546,646,466,555,3302,0.189721254355401,0.920741989881956,0.948604992657856,0.966804979253112,0.956896551724138,0.408865775136206
E02002693,"Skipsea, Beeford & Brandesburton",East Riding of Yorkshire,Yorkshire and the Humber,1037,4034,614,656,384,431,6119,1030,4248,622,652,468,479,6469,962,385,613,431,445,2836,0.226459510357815,0.618971061093248,0.940184049079755,0.920940170940171,0.92901878914405,0.438398515999382
E02002694,Pocklington,East Riding of Yorkshire,Yorkshire and the Humber,1995,7031,789,883,596,830,10129,1991,7894,833,933,665,796,11121,1495,756,885,654,781,4571,0.189384342538637,0.907563025210084,0.948553054662379,0.983458646616541,0.981155778894472,0.41102418847226
E02002695,Hornsea,East Riding of Yorkshire,Yorkshire and the Humber,1133,4288,773,785,582,744,7172,1127,4533,736,866,607,801,7543,1070,499,751,576,748,3644,0.236046768144717,0.677989130434783,0.867205542725173,0.948929159802306,0.933832709113608,0.483096911043351
E02002696,"Cherry Burton, Leconfield & Middleton",East Riding of Yorkshire,Yorkshire and the Humber,905,3493,432,424,279,374,5002,870,3991,406,453,310,350,5510,618,293,436,299,334,1980,0.15484840892007,0.721674876847291,0.962472406181016,0.964516129032258,0.954285714285714,0.35934664246824
E02002697,Leven & Tickton,East Riding of Yorkshire,Yorkshire and the Humber,1208,4271,611,672,405,511,6470,1154,4468,598,681,470,569,6786,910,439,645,459,553,3006,0.20367054610564,0.734113712374582,0.947136563876652,0.976595744680851,0.971880492091388,0.442970822281167
E02002698,Market Weighton,East Riding of Yorkshire,Yorkshire and the Humber,1564,4906,538,617,380,500,6941,1516,5020,487,615,414,510,7046,884,399,574,396,462,2715,0.17609561752988,0.819301848049281,0.933333333333333,0.956521739130435,0.905882352941176,0.385325007096225
E02002699,Molescroft,East Riding of Yorkshire,Yorkshire and the Humber,1649,5523,623,677,531,731,8085,1611,5922,635,734,566,796,8653,1011,483,719,548,774,3535,0.170719351570415,0.760629921259843,0.979564032697548,0.968197879858657,0.972361809045226,0.408528833930429
E02002700,Beverley North,East Riding of Yorkshire,Yorkshire and the Humber,1399,3722,315,327,217,332,4913,1230,3883,322,306,230,330,5071,587,181,287,217,312,1584,0.151171774401236,0.562111801242236,0.937908496732026,0.943478260869565,0.945454545454546,0.31236442516269
E02002701,"Holme, Melbourne & Bubwith",East Riding of Yorkshire,Yorkshire and the Humber,1376,5000,644,638,324,442,7048,1378,5374,694,677,421,458,7624,1039,586,657,407,441,3130,0.193338295496837,0.844380403458213,0.970457902511078,0.966745843230404,0.962882096069869,0.410545645330535
E02002702,Beverley South,East Riding of Yorkshire,Yorkshire and the Humber,1314,6127,664,682,469,804,8746,1204,6101,715,714,503,821,8854,1013,496,689,475,795,3468,0.166038354368136,0.693706293706294,0.964985994397759,0.944333996023857,0.968331303288672,0.391687372938785
E02002703,"Walkington, Bishop Burton & Woodmansey",East Riding of Yorkshire,Yorkshire and the Humber,1454,5327,633,581,386,583,7510,1288,5765,660,617,429,586,8057,980,501,589,413,574,3057,0.169991326973114,0.759090909090909,0.954619124797407,0.962703962703963,0.979522184300341,0.379421620950726
E02002704,Aldbrough & Sproatley,East Riding of Yorkshire,Yorkshire and the Humber,978,4013,622,681,392,441,6149,993,4247,664,744,425,478,6558,1064,536,703,412,465,3180,0.250529785731104,0.807228915662651,0.94489247311828,0.969411764705882,0.972803347280335,0.484903934126258
E02002705,Cottingham West,East Riding of Yorkshire,Yorkshire and the Humber,864,3505,496,554,381,620,5556,1067,4625,502,581,391,632,6731,1016,414,552,375,605,2962,0.219675675675676,0.824701195219124,0.950086058519793,0.959079283887468,0.957278481012658,0.440053483880553
E02002706,Cottingham East,East Riding of Yorkshire,Yorkshire and the Humber,1187,4166,484,464,323,539,5976,1173,4617,444,500,351,604,6516,1181,379,475,334,582,2951,0.255793805501408,0.853603603603604,0.95,0.951566951566952,0.963576158940397,0.452885205647637
E02002707,"South Cave, Newbald & Little Weighton",East Riding of Yorkshire,Yorkshire and the Humber,1008,4500,466,561,327,469,6323,989,5139,457,510,388,501,6995,1027,355,499,376,491,2748,0.199844327690212,0.776805251641138,0.97843137254902,0.969072164948454,0.980039920159681,0.392852037169407
E02002708,Cottingham South & North Ella,East Riding of Yorkshire,Yorkshire and the Humber,916,3640,463,500,341,758,5702,754,3196,429,512,359,729,5225,813,355,481,342,708,2699,0.254380475594493,0.827505827505827,0.939453125,0.952646239554318,0.97119341563786,0.516555023923445
E02002709,Gilberdyke & North Cave,East Riding of Yorkshire,Yorkshire and the Humber,1249,4802,523,544,326,476,6671,1182,4750,519,542,361,492,6664,1236,446,530,349,487,3048,0.260210526315789,0.859344894026975,0.977859778597786,0.966759002770083,0.989837398373984,0.457382953181273
E02002710,Willerby,East Riding of Yorkshire,Yorkshire and the Humber,1300,4288,422,483,351,603,6147,1153,4469,408,458,374,587,6296,1257,371,437,364,565,2994,0.281270977847393,0.909313725490196,0.954148471615721,0.973262032085561,0.96252129471891,0.475540025412961
E02002711,Kirk Ella,East Riding of Yorkshire,Yorkshire and the Humber,1118,4063,573,656,428,792,6512,1198,4389,565,661,449,768,6832,1215,499,639,442,755,3550,0.276828434723172,0.883185840707965,0.966717095310136,0.984409799554566,0.983072916666667,0.519613583138173
E02002712,Hedon & Preston,East Riding of Yorkshire,Yorkshire and the Humber,1061,4306,601,651,416,575,6549,997,4261,547,664,444,601,6517,1102,376,639,432,585,3134,0.25862473597747,0.687385740402194,0.962349397590361,0.972972972972973,0.973377703826955,0.480896117845635
E02002714,Withernsea West & Keyingham,East Riding of Yorkshire,Yorkshire and the Humber,1194,4433,673,657,419,447,6629,1202,4669,634,673,447,507,6930,1154,430,637,435,491,3147,0.247162133219105,0.678233438485805,0.946508172362556,0.973154362416107,0.968441814595661,0.454112554112554
E02002715,Brough,East Riding of Yorkshire,Yorkshire and the Humber,2788,8319,613,656,468,659,10715,2656,8740,592,676,507,701,11216,2170,448,651,485,692,4446,0.248283752860412,0.756756756756757,0.96301775147929,0.956607495069034,0.98716119828816,0.396398002853067
E02002716,Burstwick & Thorngumbald,East Riding of Yorkshire,Yorkshire and the Humber,1453,4935,576,633,441,523,7108,1360,5117,560,648,431,589,7345,1285,396,619,419,577,3296,0.251123705296072,0.707142857142857,0.955246913580247,0.97215777262181,0.979626485568761,0.448740639891082
E02002717,Hessle East & Anlaby South,East Riding of Yorkshire,Yorkshire and the Humber,1459,4844,432,420,298,503,6497,1384,5040,441,415,281,469,6646,1312,375,385,258,445,2775,0.26031746031746,0.850340136054422,0.927710843373494,0.918149466192171,0.948827292110874,0.417544387601565
E02002718,North Ferriby & Swanland,East Riding of Yorkshire,Yorkshire and the Humber,1362,4251,595,653,430,668,6597,1324,4650,512,644,486,673,6965,1246,440,625,471,640,3422,0.267956989247312,0.859375,0.970496894409938,0.969135802469136,0.950965824665676,0.491313711414214
E02002719,Hessle West,East Riding of Yorkshire,Yorkshire and the Humber,1054,3741,399,350,260,531,5281,1107,4088,392,364,263,584,5691,1165,331,347,251,553,2647,0.284980430528376,0.844387755102041,0.953296703296703,0.954372623574145,0.946917808219178,0.465120365489369
E02002720,Howden South & Goole North,East Riding of Yorkshire,Yorkshire and the Humber,1206,4586,504,477,307,486,6360,1172,4771,459,495,341,530,6596,984,429,482,334,516,2745,0.206246070006288,0.934640522875817,0.973737373737374,0.979472140762463,0.973584905660377,0.416161309884779
E02002721,"Howden North, Eastrington & Swinefleet",East Riding of Yorkshire,Yorkshire and the Humber,964,3889,458,412,274,420,5453,1005,4193,465,434,304,431,5827,933,421,412,291,418,2475,0.222513713331743,0.905376344086022,0.949308755760369,0.957236842105263,0.969837587006961,0.424746868028145
E02002722,Withernsea East & Patrington,East Riding of Yorkshire,Yorkshire and the Humber,1538,4655,752,714,471,569,7161,1436,5153,774,833,497,562,7819,1283,454,772,463,525,3497,0.248981176013972,0.58656330749354,0.926770708283313,0.93158953722334,0.934163701067616,0.447243893080957
E02002723,Goole West,East Riding of Yorkshire,Yorkshire and the Humber,1634,5452,434,445,344,535,7210,1530,5673,431,475,366,509,7454,921,374,440,352,477,2564,0.16234796404019,0.867749419953596,0.926315789473684,0.961748633879781,0.93713163064833,0.343976388516233
E02002724,Goole East,East Riding of Yorkshire,Yorkshire and the Humber,2258,6134,444,389,237,296,7500,2108,6453,444,420,253,323,7893,1114,388,389,242,307,2440,0.172632883929955,0.873873873873874,0.926190476190476,0.956521739130435,0.95046439628483,0.309134676295452
E02002725,Snaith,East Riding of Yorkshire,Yorkshire and the Humber,1080,4052,446,481,292,358,5629,1087,4253,478,456,312,416,5915,825,382,436,301,408,2352,0.193980719492123,0.799163179916318,0.956140350877193,0.96474358974359,0.980769230769231,0.397633136094675
E02006814,Anlaby Common,East Riding of Yorkshire,Yorkshire and the Humber,1467,4797,519,551,335,467,6669,1337,4960,478,554,354,478,6824,1340,420,530,343,457,3090,0.270161290322581,0.878661087866109,0.956678700361011,0.968926553672316,0.956066945606695,0.452813599062134
E02006891,Driffield East & Nafferton,East Riding of Yorkshire,Yorkshire and the Humber,1203,4495,549,579,359,517,6499,1203,4761,570,589,440,552,6912,1058,398,562,419,531,2968,0.222222222222222,0.698245614035088,0.954159592529711,0.952272727272727,0.96195652173913,0.429398148148148
E02006892,Driffield Central,East Riding of Yorkshire,Yorkshire and the Humber,1093,3621,415,445,320,487,5288,979,3649,352,457,356,561,5375,777,219,425,342,539,2302,0.212935050698822,0.622159090909091,0.929978118161926,0.960674157303371,0.96078431372549,0.428279069767442
E02002726,Immingham & Habrough,North East Lincolnshire,Yorkshire and the Humber,2064,6190,613,601,476,544,8424,2025,6715,635,622,452,583,9007,1585,542,591,427,556,3701,0.236038719285182,0.853543307086614,0.95016077170418,0.944690265486726,0.95368782161235,0.410902631286777
E02002727,Grimsby East Marsh & Port,North East Lincolnshire,Yorkshire and the Humber,1081,3592,252,218,118,255,4435,1138,3792,250,213,135,204,4594,599,167,190,122,185,1263,0.157964135021097,0.668,0.892018779342723,0.903703703703704,0.906862745098039,0.274923813670004
E02002728,Grimsby West Marsh,North East Lincolnshire,Yorkshire and the Humber,1685,5033,283,266,178,245,6005,1699,5495,326,289,158,228,6496,834,226,266,145,199,1670,0.151774340309372,0.693251533742331,0.920415224913495,0.917721518987342,0.87280701754386,0.257081280788177
E02002729,Great Coates & The Willows,North East Lincolnshire,Yorkshire and the Humber,1039,3544,346,403,220,251,4764,1021,3624,377,386,248,258,4893,792,308,369,238,246,1953,0.218543046357616,0.816976127320955,0.955958549222798,0.959677419354839,0.953488372093023,0.399141630901288
E02002730,Sidney Park,North East Lincolnshire,Yorkshire and the Humber,1971,4761,255,251,115,196,5578,1846,5047,287,246,151,157,5888,782,193,224,142,139,1480,0.154943530810382,0.672473867595819,0.910569105691057,0.940397350993378,0.885350318471338,0.251358695652174
E02002731,New Clee,North East Lincolnshire,Yorkshire and the Humber,1586,3886,222,158,86,126,4478,1529,4036,192,158,101,117,4604,638,132,133,90,104,1097,0.158077304261645,0.6875,0.841772151898734,0.891089108910891,0.888888888888889,0.238271068635969
E02002732,"Laceby, Healing & Stallingborough",North East Lincolnshire,Yorkshire and the Humber,1459,4668,489,475,306,497,6435,1401,4972,508,473,368,490,6811,1097,455,453,357,478,2840,0.220635559131134,0.895669291338583,0.957716701902748,0.970108695652174,0.975510204081633,0.416972544413449
E02002733,Littlefield North,North East Lincolnshire,Yorkshire and the Humber,976,3654,297,284,216,321,4772,973,3799,312,310,203,359,4983,764,247,290,189,343,1833,0.201105554093182,0.791666666666667,0.935483870967742,0.931034482758621,0.955431754874652,0.367850692354004
E02002734,Yarborough,North East Lincolnshire,Yorkshire and the Humber,1094,3322,262,300,219,317,4420,1094,3455,275,295,226,358,4609,672,216,274,212,343,1717,0.194500723589001,0.785454545454545,0.928813559322034,0.938053097345133,0.958100558659218,0.372532002603602
E02002735,Cleethorpes North,North East Lincolnshire,Yorkshire and the Humber,958,3227,270,207,133,250,4087,909,3433,276,238,163,297,4407,617,211,218,153,277,1476,0.179726187008447,0.764492753623188,0.915966386554622,0.938650306748466,0.932659932659933,0.334921715452689
E02002736,Holme Hill,North East Lincolnshire,Yorkshire and the Humber,1449,4011,180,126,100,128,4545,1435,4203,202,165,91,116,4777,728,132,131,81,103,1175,0.173209612181775,0.653465346534654,0.793939393939394,0.89010989010989,0.887931034482759,0.245970274230689
E02002737,Weelsby & Old Clee,North East Lincolnshire,Yorkshire and the Humber,1351,4358,406,340,245,454,5803,1305,4741,450,370,237,431,6229,972,353,345,227,406,2303,0.205020037966674,0.784444444444445,0.932432432432432,0.957805907172996,0.94199535962877,0.369722266816503
E02002738,Laceby Acres & Wybers Wood,North East Lincolnshire,Yorkshire and the Humber,1398,4180,451,447,222,283,5583,1333,4396,439,460,281,311,5887,912,364,436,271,294,2277,0.207461328480437,0.829157175398633,0.947826086956522,0.9644128113879,0.945337620578778,0.386784440292169
E02002739,Cleethorpes Beacon Hill,North East Lincolnshire,Yorkshire and the Humber,1085,3445,369,290,241,398,4743,1073,3654,385,349,226,375,4989,743,326,320,216,357,1962,0.203338806787083,0.846753246753247,0.916905444126075,0.955752212389381,0.952,0.393265183403488
E02002740,Littlefield South & Grange,North East Lincolnshire,Yorkshire and the Humber,1204,3295,307,250,179,309,4340,1137,3546,278,277,177,296,4574,797,231,247,166,283,1724,0.224760293288212,0.830935251798561,0.891696750902527,0.937853107344633,0.956081081081081,0.376912986445125
E02002741,Wellow,North East Lincolnshire,Yorkshire and the Humber,1739,5503,445,441,286,593,7268,1762,5844,481,447,294,507,7573,1316,398,417,274,481,2886,0.225188227241615,0.827442827442827,0.932885906040269,0.931972789115646,0.948717948717949,0.381090717020996
E02002742,Cleethorpes Haverstoe,North East Lincolnshire,Yorkshire and the Humber,868,3157,414,434,298,421,4724,785,3147,373,436,299,408,4663,558,321,414,293,391,1977,0.177311725452812,0.86058981233244,0.94954128440367,0.979933110367893,0.958333333333333,0.423975981128029
E02002743,Cleethorpes West,North East Lincolnshire,Yorkshire and the Humber,753,2767,408,544,391,678,4788,759,2931,403,535,355,615,4839,647,350,505,339,595,2436,0.220743773456158,0.86848635235732,0.94392523364486,0.954929577464789,0.967479674796748,0.503409795412275
E02002744,Nunsthorpe,North East Lincolnshire,Yorkshire and the Humber,2014,4249,378,259,131,203,5220,1969,4713,346,302,154,222,5737,966,282,265,138,211,1862,0.204964990451941,0.815028901734104,0.877483443708609,0.896103896103896,0.95045045045045,0.324559874498867
E02002745,Humberston,North East Lincolnshire,Yorkshire and the Humber,911,3900,512,692,527,675,6306,855,4084,488,654,577,705,6508,851,412,632,565,681,3141,0.208374142997062,0.844262295081967,0.966360856269113,0.979202772963605,0.965957446808511,0.482636754763368
E02002746,Scartho,North East Lincolnshire,Yorkshire and the Humber,1853,5686,516,556,464,688,7910,1798,5890,523,552,455,700,8120,1502,454,530,439,677,3602,0.255008488964346,0.868068833652008,0.960144927536232,0.964835164835165,0.967142857142857,0.4435960591133
E02002747,New Waltham,North East Lincolnshire,Yorkshire and the Humber,1373,4915,519,610,492,638,7174,1465,5478,526,630,521,731,7886,1150,460,607,509,697,3423,0.209930631617379,0.874524714828897,0.963492063492063,0.976967370441459,0.953488372093023,0.434060360131879
E02002748,Waltham & East Ravendale,North East Lincolnshire,Yorkshire and the Humber,1124,4314,630,607,449,726,6726,1109,4607,626,628,468,754,7083,1028,555,606,455,728,3372,0.223138701975255,0.886581469648562,0.964968152866242,0.972222222222222,0.96551724137931,0.476069462092334
E02002749,Barton upon Humber,North Lincolnshire,Yorkshire and the Humber,2043,7071,779,702,494,581,9627,2027,7347,794,736,518,642,10037,2106,616,705,497,616,4540,0.286647611269906,0.775818639798489,0.957880434782609,0.959459459459459,0.959501557632399,0.452326392348311
E02002750,"Goxhill, Barrow & New Holland",North Lincolnshire,Yorkshire and the Humber,1085,3750,463,431,261,318,5223,1043,3918,429,473,294,345,5459,1114,312,452,284,326,2488,0.284328739152629,0.727272727272727,0.955602536997886,0.965986394557823,0.944927536231884,0.455761128411797
E02002751,Winterton & Winteringham,North Lincolnshire,Yorkshire and the Humber,1181,3740,408,511,304,331,5294,1091,3924,415,482,326,348,5495,1205,379,463,312,336,2695,0.307084607543323,0.913253012048193,0.960580912863071,0.957055214723926,0.96551724137931,0.490445859872612
E02002752,"Barnetby, Ulceby & Killingholme",North Lincolnshire,Yorkshire and the Humber,1260,4261,510,444,275,347,5837,1245,4376,492,456,308,330,5962,1193,418,436,302,320,2669,0.272623400365631,0.849593495934959,0.956140350877193,0.980519480519481,0.96969696969697,0.447668567594767
E02002753,"Burton upon Stather, Alkborough & Gunness",North Lincolnshire,Yorkshire and the Humber,1254,4990,609,635,482,690,7406,1229,5066,588,643,521,723,7541,1418,497,611,496,693,3715,0.27990525069088,0.845238095238095,0.950233281493002,0.952015355086372,0.95850622406639,0.492640233390797
E02002754,Crowle & Keadby,North Lincolnshire,Yorkshire and the Humber,1457,5146,520,517,317,455,6955,1407,5179,527,546,368,446,7066,1375,490,514,353,426,3158,0.265495269357019,0.929791271347249,0.941391941391941,0.959239130434783,0.955156950672646,0.446928955561846
E02002755,Scunthorpe North,North Lincolnshire,Yorkshire and the Humber,1506,5288,357,256,208,284,6393,1636,5797,310,298,211,364,6980,928,233,264,194,332,1951,0.160082801449025,0.751612903225806,0.885906040268456,0.919431279620853,0.912087912087912,0.279512893982808
E02002756,Scunthorpe Central & Crosby,North Lincolnshire,Yorkshire and the Humber,2209,6520,294,217,141,237,7409,2274,7972,329,259,152,260,8972,1011,213,218,136,226,1804,0.126818866031109,0.64741641337386,0.841698841698842,0.894736842105263,0.869230769230769,0.201069995541685
E02002757,Scunthorpe Berkeley,North Lincolnshire,Yorkshire and the Humber,1353,3955,298,268,232,364,5117,1299,4268,280,295,259,366,5468,1024,215,272,249,359,2119,0.239925023430178,0.767857142857143,0.922033898305085,0.961389961389961,0.980874316939891,0.387527432333577
E02002758,Scunthorpe Frodingham,North Lincolnshire,Yorkshire and the Humber,1317,4065,299,219,168,212,4963,1356,4297,333,250,178,215,5273,923,250,229,171,201,1774,0.214801023970212,0.750750750750751,0.916,0.960674157303371,0.934883720930232,0.336430874265124
E02002759,Brigg & South Ferriby,North Lincolnshire,Yorkshire and the Humber,1487,5531,712,714,448,653,8058,1484,5874,676,771,497,708,8526,1883,615,737,482,674,4391,0.320565202587675,0.909763313609468,0.955901426718547,0.969818913480885,0.951977401129944,0.515012901712409
E02002760,Scunthorpe Central Park,North Lincolnshire,Yorkshire and the Humber,1037,3586,399,356,212,343,4896,1006,3708,408,385,229,345,5075,923,327,374,224,328,2176,0.248921251348436,0.801470588235294,0.971428571428571,0.978165938864629,0.950724637681159,0.428768472906404
E02002761,Broughton & Appleby,North Lincolnshire,Yorkshire and the Humber,1057,3965,411,430,309,417,5532,937,3992,397,438,336,406,5569,1255,365,421,325,389,2755,0.31437875751503,0.919395465994962,0.961187214611872,0.967261904761905,0.958128078817734,0.49470281917759
E02002762,Scunthorpe Lincoln Gardens,North Lincolnshire,Yorkshire and the Humber,1363,4038,356,299,209,436,5338,1242,4238,385,301,211,436,5571,1011,277,278,191,422,2179,0.238555922605002,0.71948051948052,0.92358803986711,0.90521327014218,0.967889908256881,0.391132651229582
E02002763,Scunthorpe Lakeside,North Lincolnshire,Yorkshire and the Humber,2189,5470,332,299,201,328,6630,2103,5676,364,309,240,311,6900,1361,254,285,220,284,2404,0.239781536293164,0.697802197802198,0.922330097087379,0.916666666666667,0.913183279742765,0.348405797101449
E02002764,Scunthorpe Westcliff,North Lincolnshire,Yorkshire and the Humber,1577,3569,255,233,177,226,4460,1552,3963,245,250,186,229,4873,828,167,222,177,212,1606,0.20893262679788,0.681632653061224,0.888,0.951612903225806,0.925764192139738,0.329571106094808
E02002765,Scunthorpe Ashby,North Lincolnshire,Yorkshire and the Humber,1369,3738,318,355,213,376,5000,1224,3942,345,317,229,368,5201,931,244,287,209,351,2022,0.236174530695079,0.707246376811594,0.905362776025237,0.912663755458515,0.953804347826087,0.388771390117285
E02002766,Scunthorpe Bottesford,North Lincolnshire,Yorkshire and the Humber,1809,5194,560,516,403,567,7240,1783,5503,492,567,424,603,7589,1345,381,539,412,583,3260,0.244412138833364,0.774390243902439,0.950617283950617,0.971698113207547,0.966832504145937,0.429569113190144
E02002767,Scunthorpe Yaddlethorpe,North Lincolnshire,Yorkshire and the Humber,955,3807,507,497,364,472,5647,935,3916,488,507,362,505,5778,996,410,483,352,491,2732,0.254341164453524,0.84016393442623,0.952662721893491,0.972375690607735,0.972277227722772,0.472827968155071
E02002768,Epworth & Bracon,North Lincolnshire,Yorkshire and the Humber,1294,4524,582,519,313,454,6392,1233,4616,523,552,381,455,6527,986,462,523,372,436,2779,0.213604852686309,0.883365200764818,0.947463768115942,0.976377952755906,0.958241758241758,0.425769878964302
E02002769,Messingham & Scawby,North Lincolnshire,Yorkshire and the Humber,838,3178,415,487,360,446,4886,778,3255,416,457,412,468,5008,881,341,439,400,447,2508,0.270660522273426,0.819711538461539,0.960612691466083,0.970873786407767,0.955128205128205,0.500798722044728
E02002770,Kirton in Lindsey & Hibaldstow,North Lincolnshire,Yorkshire and the Humber,1186,4162,498,483,332,396,5871,1133,4284,520,509,373,463,6149,1127,473,487,362,437,2886,0.263071895424837,0.909615384615385,0.956777996070727,0.970509383378016,0.943844492440605,0.469344608879493
E02002771,"Westwoodside, Haxey & Owston Ferry",North Lincolnshire,Yorkshire and the Humber,1126,4136,558,606,394,472,6166,1023,4314,522,607,397,479,6319,962,483,577,384,464,2870,0.222994900324525,0.925287356321839,0.950576606260297,0.967254408060453,0.968684759916493,0.454185788890647
E02002772,Strensall,York,Yorkshire and the Humber,1397,4244,383,387,235,325,5574,1363,4354,403,413,281,370,5821,981,369,398,266,353,2367,0.225310059715204,0.915632754342432,0.963680387409201,0.946619217081851,0.954054054054054,0.406631163030407
E02002773,Haxby,York,Yorkshire and the Humber,888,2917,493,542,360,544,4856,855,3190,447,569,408,529,5143,823,410,555,395,519,2702,0.257993730407524,0.917225950782998,0.975395430579965,0.968137254901961,0.98109640831758,0.525374295158468
E02002774,Wigginton,York,Yorkshire and the Humber,982,3252,475,488,306,596,5117,991,3589,472,497,363,585,5506,886,440,478,356,561,2721,0.246865422123154,0.932203389830508,0.961770623742455,0.980716253443526,0.958974358974359,0.494188158372684
E02002775,New Earswick,York,Yorkshire and the Humber,909,3159,341,440,319,584,4843,942,3407,367,434,344,593,5145,889,341,412,334,581,2557,0.260933372468447,0.929155313351499,0.949308755760369,0.970930232558139,0.979763912310287,0.496987366375122
E02002776,Huntington,York,Yorkshire and the Humber,1102,4194,346,452,296,482,5770,1047,4312,372,443,342,481,5950,957,337,419,325,469,2507,0.221938775510204,0.905913978494624,0.945823927765237,0.950292397660819,0.975051975051975,0.421344537815126
E02002777,Clifton Without & Skelton,York,Yorkshire and the Humber,1593,5757,362,344,226,226,6915,1651,6207,431,381,262,365,7646,1214,391,362,244,345,2556,0.195585629128403,0.907192575406033,0.9501312335958,0.931297709923664,0.945205479452055,0.33429244049176
E02002778,Rawcliffe & Clifton South,York,Yorkshire and the Humber,1272,5231,470,460,349,625,7135,1108,5601,441,481,353,566,7442,984,413,442,334,541,2714,0.175682913765399,0.936507936507937,0.918918918918919,0.946175637393768,0.95583038869258,0.364686912120398
E02002779,Heworth North & Stockton,York,Yorkshire and the Humber,1471,5835,578,642,443,754,8252,1448,6262,580,657,484,692,8675,1162,533,626,464,665,3450,0.185563717662089,0.918965517241379,0.952815829528158,0.958677685950413,0.960982658959538,0.397694524495677
E02002780,Clifton North,York,Yorkshire and the Humber,1413,6278,263,263,199,253,7256,1411,6297,299,271,168,243,7278,1094,248,241,157,226,1966,0.17373352390027,0.82943143812709,0.88929889298893,0.934523809523809,0.930041152263374,0.270129156361638
E02002781,Heworth South & The Groves,York,Yorkshire and the Humber,1496,8781,321,273,214,359,9948,1379,7812,324,286,190,308,8920,1082,262,257,168,282,2051,0.138504864311316,0.808641975308642,0.898601398601399,0.884210526315789,0.915584415584416,0.229932735426009
E02002782,"Poppleton, Rufforth & Askham",York,Yorkshire and the Humber,1110,3543,365,431,317,608,5264,1063,3793,380,435,332,619,5559,892,354,413,324,600,2583,0.235170050092275,0.931578947368421,0.949425287356322,0.975903614457831,0.969305331179321,0.464651915812197
E02002783,Acomb,York,Yorkshire and the Humber,1962,6476,551,535,360,585,8507,1900,6862,552,552,385,565,8916,1405,493,524,365,547,3334,0.204750801515593,0.893115942028986,0.949275362318841,0.948051948051948,0.968141592920354,0.373934499775684
E02002784,York City Centre,York,Yorkshire and the Humber,1114,10863,430,388,286,394,12361,1032,10908,482,437,305,378,12510,1078,374,381,280,343,2456,0.0988265493215988,0.775933609958506,0.871853546910755,0.918032786885246,0.907407407407407,0.196322941646683
E02002785,Osbaldwick,York,Yorkshire and the Humber,1294,5467,379,394,293,578,7111,1268,5317,344,395,317,546,6919,901,314,380,306,519,2420,0.169456460410006,0.912790697674419,0.962025316455696,0.965299684542587,0.950549450549451,0.349761526232115
E02002786,Tang Hall,York,Yorkshire and the Humber,1567,8843,285,258,177,214,9777,1474,7692,277,293,172,231,8665,966,242,271,162,216,1857,0.125585023400936,0.873646209386282,0.924914675767918,0.941860465116279,0.935064935064935,0.214310444316215
E02002787,Holgate West,York,Yorkshire and the Humber,1655,6027,422,423,287,555,7714,1508,6331,436,433,291,505,7996,1180,387,400,275,487,2729,0.186384457431685,0.887614678899083,0.92378752886836,0.945017182130584,0.964356435643564,0.341295647823912
E02002788,Holgate East,York,Yorkshire and the Humber,1534,6396,343,343,211,262,7555,1324,6455,372,388,232,241,7688,1084,319,358,219,219,2199,0.167931835786212,0.85752688172043,0.922680412371134,0.943965517241379,0.908713692946058,0.286030176899063
E02002789,"Westfield, Chapelfields & Foxwood",York,Yorkshire and the Humber,2028,5799,394,392,213,403,7201,2052,6491,393,392,237,348,7861,1279,325,363,224,324,2515,0.197042058234479,0.826972010178117,0.926020408163265,0.945147679324895,0.931034482758621,0.319933850655133
E02002790,Fulford Road & Clementhorpe,York,Yorkshire and the Humber,1661,10056,389,379,255,427,11506,1515,10104,405,418,302,428,11657,1136,337,377,280,403,2533,0.11243072050673,0.832098765432099,0.901913875598086,0.927152317880795,0.941588785046729,0.217294329587372
E02002791,"Dunnington, Elvington & Wheldrake",York,Yorkshire and the Humber,1224,3503,373,505,350,524,5255,1112,3856,408,492,384,590,5730,661,385,476,374,575,2471,0.171421161825726,0.943627450980392,0.967479674796748,0.973958333333333,0.974576271186441,0.431239092495637
E02002792,South Bank & Dringhouses,York,Yorkshire and the Humber,1318,5013,382,342,283,463,6483,1328,5441,395,363,299,485,6983,963,353,339,277,459,2391,0.176989523984562,0.893670886075949,0.933884297520661,0.926421404682274,0.94639175257732,0.342402978662466
E02002793,Woodthorpe & Acomb Park,York,Yorkshire and the Humber,1490,5618,590,631,435,578,7852,1462,5968,564,657,417,576,8182,1172,517,630,402,558,3279,0.196380697050938,0.916666666666667,0.958904109589041,0.964028776978417,0.96875,0.400757760938646
E02002794,"Fulford, Heslington & University",York,Yorkshire and the Humber,877,7362,303,347,269,432,8713,972,11215,294,339,264,414,12526,886,257,317,255,390,2105,0.0790013374944271,0.874149659863946,0.935103244837758,0.965909090909091,0.942028985507246,0.168050455053489
E02002795,Bishopthorpe & Copmanthorpe,York,Yorkshire and the Humber,1465,4447,628,733,460,563,6831,1451,4854,638,735,502,628,7357,1073,601,707,486,609,3476,0.221054800164813,0.942006269592476,0.961904761904762,0.968127490039841,0.969745222929936,0.472475193693081
E02005742,Ingleton & High Bentham,Craven,Yorkshire and the Humber,1024,4238,552,616,443,566,6415,1031,4341,619,598,480,565,6603,1195,568,568,470,547,3348,0.275282193043078,0.917609046849758,0.949832775919733,0.979166666666667,0.968141592920354,0.507042253521127
E02005743,"Grassington, Upper Wharfedale & Gargrave",Craven,Yorkshire and the Humber,587,2687,453,454,340,540,4474,548,2809,426,444,382,554,4615,517,364,416,370,527,2194,0.184051263794945,0.854460093896714,0.936936936936937,0.968586387434555,0.951263537906137,0.475406283856988
E02005744,"Settle, Hellifield & Horton",Craven,Yorkshire and the Humber,1010,4441,644,675,505,695,6960,998,4619,629,709,523,720,7200,1286,498,661,502,694,3641,0.278415241394241,0.791732909379968,0.932299012693935,0.959847036328872,0.963888888888889,0.505694444444444
E02005745,Skipton North & Barden Fell,Craven,Yorkshire and the Humber,849,2893,389,457,304,409,4452,822,3105,412,452,336,409,4714,496,348,426,320,393,1983,0.159742351046699,0.844660194174757,0.942477876106195,0.952380952380952,0.960880195599022,0.420661858294442
E02005746,Skipton Town & East,Craven,Yorkshire and the Humber,1186,3841,500,426,330,478,5575,1062,4224,488,453,331,464,5960,700,385,429,317,448,2279,0.165719696969697,0.788934426229508,0.947019867549669,0.957703927492447,0.96551724137931,0.38238255033557
E02005747,Skipton South,Craven,Yorkshire and the Humber,1238,4344,363,343,236,395,5681,1232,4722,379,397,266,392,6156,705,281,362,247,372,1967,0.149301143583227,0.741424802110818,0.91183879093199,0.928571428571429,0.948979591836735,0.319525666016894
E02005748,"Carleton, Cowling & Cononley",Craven,Yorkshire and the Humber,1259,4516,559,478,324,466,6343,1309,4789,582,543,349,425,6688,832,471,503,330,397,2533,0.173731467947379,0.809278350515464,0.926335174953959,0.945558739255014,0.934117647058823,0.378738038277512
E02005749,Sutton & Crosshills,Craven,Yorkshire and the Humber,1733,5681,660,710,507,798,8356,1678,6008,676,688,555,738,8665,1167,527,641,532,707,3574,0.194241011984021,0.779585798816568,0.931686046511628,0.958558558558559,0.9579945799458,0.412463935372187
E02005750,Great Ayton & Stokesley,Hambleton,Yorkshire and the Humber,1121,4332,527,642,437,660,6598,1139,4559,515,619,524,708,6925,1048,411,590,510,683,3242,0.229874972581707,0.798058252427184,0.953150242326333,0.973282442748092,0.964689265536723,0.468158844765343
E02005751,Rudby & Ingleby,Hambleton,Yorkshire and the Humber,1133,4550,715,871,667,728,7531,1059,4911,690,821,719,786,7927,1183,547,790,700,768,3988,0.240887802891468,0.792753623188406,0.962241169305725,0.973574408901252,0.977099236641221,0.503090702661789
E02005752,"Brompton, Appleton & Thimbleby",Hambleton,Yorkshire and the Humber,964,3833,564,577,330,381,5685,993,4158,544,555,367,395,6019,972,391,539,356,383,2641,0.233766233766234,0.71875,0.971171171171171,0.970027247956403,0.969620253164557,0.438777205515866
E02005753,Northallerton,Hambleton,Yorkshire and the Humber,2460,7918,781,789,591,947,11026,2368,8072,821,823,578,980,11274,2310,563,792,560,948,5173,0.28617443012884,0.685749086479903,0.962332928311057,0.968858131487889,0.96734693877551,0.458843356395246
E02005754,Northallerton South & Leeming Bar,Hambleton,Yorkshire and the Humber,1069,4074,662,660,451,658,6505,981,4170,624,695,501,650,6640,1051,452,672,492,617,3284,0.252038369304556,0.724358974358974,0.966906474820144,0.982035928143713,0.949230769230769,0.494578313253012
E02005755,Bedale & Snape,Hambleton,Yorkshire and the Humber,1025,4011,462,440,345,545,5803,984,3976,454,479,332,566,5807,904,326,459,314,547,2550,0.227364185110664,0.718061674008811,0.958246346555324,0.945783132530121,0.96643109540636,0.439125193731703
E02005756,"Leeming, Pickhill & Thornton",Hambleton,Yorkshire and the Humber,1242,4216,475,424,273,283,5671,988,4035,444,427,287,308,5501,748,336,414,277,303,2078,0.185377942998761,0.756756756756757,0.969555035128806,0.965156794425087,0.983766233766234,0.377749500090893
E02005757,Thirsk North,Hambleton,Yorkshire and the Humber,1307,5167,557,566,423,670,7383,1214,5178,596,580,437,667,7458,1230,476,553,425,649,3333,0.237543453070684,0.798657718120805,0.953448275862069,0.97254004576659,0.973013493253373,0.446902654867257
E02005758,Thirsk South & Coxwold,Hambleton,Yorkshire and the Humber,1693,5233,599,585,407,569,7393,1655,5341,573,621,435,606,7576,1315,467,603,428,584,3397,0.246208575173189,0.815008726003491,0.971014492753623,0.983908045977012,0.963696369636964,0.448389651531151
E02005759,Easingwold & Stillington,Hambleton,Yorkshire and the Humber,1443,5119,682,711,502,775,7789,1319,5193,648,727,555,807,7930,1258,568,696,548,798,3868,0.242249181590603,0.876543209876543,0.957359009628611,0.987387387387387,0.988847583643123,0.487767969735183
E02005760,"Linton, Tollerton & Raskelf",Hambleton,Yorkshire and the Humber,1195,4256,358,413,215,316,5558,981,3944,373,415,233,320,5285,869,332,397,224,309,2131,0.220334685598377,0.890080428954424,0.956626506024096,0.96137339055794,0.965625,0.40321665089877
E02005761,"Masham, Kirkby Malzeard & North Stainley",Harrogate,Yorkshire and the Humber,963,3039,427,427,289,349,4531,878,3364,407,471,322,379,4943,688,330,438,310,372,2138,0.204518430439952,0.810810810810811,0.929936305732484,0.962732919254658,0.981530343007915,0.432530851709488
E02005762,Ripon North & West,Harrogate,Yorkshire and the Humber,1093,3598,314,393,253,500,5058,1026,3372,314,406,283,476,4851,717,274,393,269,465,2118,0.212633451957295,0.872611464968153,0.967980295566502,0.950530035335689,0.976890756302521,0.43661100803958
E02005763,"Dishforth, Baldersby & Markington",Harrogate,Yorkshire and the Humber,1180,3658,401,472,332,376,5239,1100,4660,439,456,354,382,6291,770,378,431,341,372,2292,0.165236051502146,0.861047835990888,0.945175438596491,0.963276836158192,0.973821989528796,0.364329995231283
E02005764,Ripon South & East,Harrogate,Yorkshire and the Humber,1847,5790,608,688,525,795,8406,1689,6391,610,663,557,827,9048,1451,510,633,536,791,3921,0.227038022218745,0.836065573770492,0.954751131221719,0.96229802513465,0.956469165659008,0.433355437665783
E02005765,Boroughbridge & Marton-cum-Grafton,Harrogate,Yorkshire and the Humber,1020,3766,461,481,357,525,5590,1100,4334,497,495,368,547,6241,932,434,478,352,536,2732,0.215043839409322,0.873239436619718,0.965656565656566,0.956521739130435,0.979890310786106,0.437750360519148
E02005766,Pateley Bridge & Nidd Valley,Harrogate,Yorkshire and the Humber,933,3440,489,508,267,420,5124,904,3742,471,530,338,416,5497,755,378,499,327,399,2358,0.201763762693747,0.802547770700637,0.941509433962264,0.967455621301775,0.959134615384615,0.428961251591777
E02005767,Knaresborough North,Harrogate,Yorkshire and the Humber,1264,3940,477,540,333,524,5814,1324,4596,509,530,366,513,6514,1030,456,504,342,499,2831,0.224107919930374,0.895874263261297,0.950943396226415,0.934426229508197,0.97270955165692,0.434602394841879
E02005768,Killinghall & Hampsthwaite,Harrogate,Yorkshire and the Humber,1287,4401,329,378,218,347,5673,1317,5272,388,379,263,327,6629,861,324,365,248,309,2107,0.163315629742033,0.835051546391753,0.963060686015831,0.94296577946768,0.944954128440367,0.317845828933474
E02005769,Knaresborough Central,Harrogate,Yorkshire and the Humber,1205,3997,413,424,351,547,5732,1135,4510,430,453,343,545,6281,1091,364,438,323,522,2738,0.241906873614191,0.846511627906977,0.966887417218543,0.941690962099125,0.957798165137615,0.435917847476517
E02005770,Bilton,Harrogate,Yorkshire and the Humber,1581,5336,530,569,407,606,7448,1534,5897,544,594,434,577,8046,1333,454,567,410,547,3311,0.226047142614889,0.834558823529412,0.954545454545455,0.944700460829493,0.948006932409012,0.411508824260502
E02005771,Saltergate,Harrogate,Yorkshire and the Humber,1543,4712,344,368,218,304,5946,1569,5265,409,367,239,314,6594,1155,318,336,221,287,2317,0.219373219373219,0.777506112469438,0.915531335149864,0.924686192468619,0.914012738853503,0.351380042462845
E02005772,Knaresborough South & Follifoot,Harrogate,Yorkshire and the Humber,922,3136,478,508,327,468,4917,943,3718,478,536,375,466,5573,891,422,510,360,451,2634,0.239644970414201,0.882845188284519,0.951492537313433,0.96,0.967811158798283,0.472635923201148
E02005773,Harrogate East,Harrogate,Yorkshire and the Humber,1705,5777,404,400,247,447,7275,1560,6488,469,444,260,483,8144,1554,360,402,233,452,3001,0.239519112207152,0.767590618336887,0.905405405405405,0.896153846153846,0.935817805383023,0.368492141453831
E02005774,Starbeck,Harrogate,Yorkshire and the Humber,1727,5618,488,452,335,672,7565,1565,6305,488,498,337,604,8232,1638,407,463,325,570,3403,0.25979381443299,0.834016393442623,0.929718875502008,0.964391691394659,0.943708609271523,0.413386783284743
E02005775,Central Harrogate,Harrogate,Yorkshire and the Humber,1287,6641,464,442,335,606,8488,1186,7536,508,485,361,622,9512,1224,394,435,332,559,2944,0.162420382165605,0.775590551181102,0.896907216494845,0.919667590027701,0.89871382636656,0.309503784693019
E02005776,"Ouseburn, Hammerton & Tockwith",Harrogate,Yorkshire and the Humber,1885,5952,527,568,341,451,7839,1900,6858,556,573,400,435,8822,1144,479,544,384,426,2977,0.166812481773112,0.861510791366906,0.949389179755672,0.96,0.979310344827586,0.337451824982997
E02005777,Hookstone,Harrogate,Yorkshire and the Humber,1631,4721,496,550,340,683,6790,1586,5209,482,537,377,645,7250,1248,406,515,364,623,3156,0.239585333077366,0.842323651452282,0.95903165735568,0.96551724137931,0.965891472868217,0.435310344827586
E02005778,"Menwith, Beckwithshaw & Denton Moor",Harrogate,Yorkshire and the Humber,970,3432,418,439,313,387,4989,992,4013,412,447,370,454,5696,746,346,422,352,439,2305,0.185895838524794,0.839805825242718,0.94407158836689,0.951351351351351,0.966960352422907,0.404669943820225
E02005779,Stray,Harrogate,Yorkshire and the Humber,1189,4519,414,463,355,787,6538,1118,4948,441,472,367,703,6931,903,366,427,345,667,2708,0.182497978981407,0.829931972789116,0.904661016949153,0.940054495912807,0.948790896159317,0.390708411484634
E02005780,Harrogate West & Pannal,Harrogate,Yorkshire and the Humber,2113,5862,625,635,527,978,8627,2128,6814,593,686,542,983,9618,1358,497,662,515,937,3969,0.199295567948342,0.838111298482293,0.965014577259475,0.950184501845018,0.953204476093591,0.412663755458515
E02005781,"Spofforth, Burn Bridge & Huby",Harrogate,Yorkshire and the Humber,1076,3156,371,426,355,513,4821,1107,3497,401,453,359,478,5188,739,358,432,348,456,2333,0.211323991993137,0.892768079800499,0.95364238410596,0.969359331476323,0.95397489539749,0.449691595990748
E02005782,North Richmondshire,Richmondshire,Yorkshire and the Humber,931,4518,592,623,413,551,6697,978,4587,648,636,464,571,6906,682,540,607,443,553,2825,0.148681055155875,0.833333333333333,0.95440251572327,0.954741379310345,0.968476357267951,0.409064581523313
E02005783,Richmond Town,Richmondshire,Yorkshire and the Humber,1289,4776,627,582,447,657,7089,1171,4811,604,602,487,662,7166,643,344,555,459,639,2640,0.133652047391395,0.56953642384106,0.921926910299003,0.942505133470226,0.965256797583082,0.36840636338264
E02005784,Catterick & Brompton-on-Swale,Richmondshire,Yorkshire and the Humber,929,3925,340,407,216,371,5259,966,3285,335,389,250,355,4614,521,185,374,238,334,1652,0.158599695585997,0.552238805970149,0.961439588688946,0.952,0.940845070422535,0.358040745557
E02005785,Catterick Garrison & Colburn,Richmondshire,Yorkshire and the Humber,3897,11822,375,316,237,309,13059,3291,12320,375,338,230,317,13580,1119,221,297,212,281,2130,0.0908279220779221,0.589333333333333,0.878698224852071,0.921739130434783,0.886435331230284,0.156848306332842
E02005786,Upper Dales,Richmondshire,Yorkshire and the Humber,622,3474,511,598,334,428,5345,658,3486,526,580,371,436,5399,352,421,551,350,418,2092,0.100975329890993,0.800380228136882,0.95,0.943396226415094,0.958715596330275,0.387479162807927
E02005787,"Leyburn, Middleham & Tunstall",Richmondshire,Yorkshire and the Humber,1137,4929,692,719,500,636,7476,1149,5022,722,779,516,695,7734,656,483,741,503,670,3053,0.130625248904819,0.668975069252078,0.951219512195122,0.974806201550388,0.964028776978417,0.394750452547194
E02005788,Kirkbymoorside & Moors,Ryedale,Yorkshire and the Humber,944,3606,575,562,378,495,5616,810,3538,518,603,382,527,5568,720,390,583,375,515,2583,0.203504804974562,0.752895752895753,0.966832504145937,0.981675392670157,0.977229601518026,0.463900862068966
E02005789,Pickering & Thornton Dale,Ryedale,Yorkshire and the Humber,1468,5719,906,966,653,1004,9248,1399,5859,901,1000,740,1041,9541,1609,749,969,722,1022,5071,0.274620242362178,0.831298557158713,0.969,0.975675675675676,0.981748318924111,0.531495650351116
E02005790,Helmsley & Ampleforth,Ryedale,Yorkshire and the Humber,1041,3924,491,453,390,595,5853,1068,4409,528,504,441,632,6514,937,458,480,425,614,2914,0.212519845770016,0.867424242424242,0.952380952380952,0.963718820861678,0.971518987341772,0.447344181762358
E02005791,Rillington & Sherburn,Ryedale,Yorkshire and the Humber,1182,4138,529,469,333,321,5790,1147,4383,515,464,326,355,6043,1016,427,440,317,343,2543,0.231804699977185,0.829126213592233,0.948275862068965,0.97239263803681,0.966197183098592,0.42081747476419
E02005794,"Sheriff Hutton, Slingsby & Swinton",Ryedale,Yorkshire and the Humber,1406,5681,769,754,504,639,8347,1358,5591,742,742,538,628,8241,1144,653,713,522,608,3640,0.20461455911286,0.880053908355795,0.960916442048518,0.970260223048327,0.968152866242038,0.441693969178498
E02006870,Malton & Norton,Ryedale,Yorkshire and the Humber,2623,8693,802,794,584,989,11862,2647,9301,798,834,638,956,12527,2056,711,794,609,902,5072,0.221051499838727,0.890977443609023,0.952038369304556,0.954545454545455,0.943514644351465,0.404885447433544
E02005795,Whitby West,Scarborough,Yorkshire and the Humber,936,3935,559,545,347,633,6019,870,4161,540,550,396,591,6238,570,259,517,383,567,2296,0.136986301369863,0.47962962962963,0.94,0.967171717171717,0.959390862944162,0.368066688041039
E02005796,Esk Valley & Runswick Coast,Scarborough,Yorkshire and the Humber,895,3659,642,583,327,479,5690,854,3941,607,600,347,475,5970,600,342,580,338,459,2319,0.152245622938341,0.56342668863262,0.966666666666667,0.974063400576369,0.966315789473684,0.388442211055276
E02005797,Whitby South & East,Scarborough,Yorkshire and the Humber,1039,3656,483,470,253,287,5149,1037,3876,460,503,310,316,5465,533,212,473,295,305,1818,0.137512899896801,0.460869565217391,0.940357852882704,0.951612903225806,0.965189873417722,0.332662397072278
E02005798,"Burniston, Sleights & Fylingdales",Scarborough,Yorkshire and the Humber,1100,4382,761,813,560,682,7198,1096,4656,748,807,575,653,7439,895,529,771,552,626,3373,0.192225085910653,0.707219251336898,0.955390334572491,0.96,0.958652373660031,0.453421158757898
E02005799,Newby & Scalby,Scarborough,Yorkshire and the Humber,1556,4638,699,806,597,897,7637,1474,5110,700,839,592,979,8220,1533,631,814,569,947,4494,0.3,0.901428571428571,0.970202622169249,0.961148648648649,0.967313585291113,0.546715328467153
E02005800,Scarborough Town & North Bay,Scarborough,Yorkshire and the Humber,1201,5043,488,427,264,357,6579,1151,5404,478,412,283,371,6948,1121,364,363,263,340,2451,0.207438934122872,0.761506276150628,0.881067961165049,0.929328621908127,0.91644204851752,0.352763385146805
E02005801,Barrowcliff & Northstead,Scarborough,Yorkshire and the Humber,1232,3118,271,345,217,345,4296,1197,3546,269,326,230,329,4700,922,209,305,220,312,1968,0.260011280315849,0.776951672862453,0.93558282208589,0.956521739130435,0.948328267477204,0.418723404255319
E02005802,Scarborough Central,Scarborough,Yorkshire and the Humber,1662,5038,404,316,244,301,6303,1529,5427,354,346,245,329,6701,1274,281,316,235,313,2419,0.234752165100424,0.793785310734463,0.913294797687861,0.959183673469388,0.951367781155015,0.360990896881063
E02005803,Falsgrave,Scarborough,Yorkshire and the Humber,1537,5209,633,588,411,812,7653,1449,5672,624,657,477,744,8174,1600,510,621,463,706,3900,0.282087447108604,0.817307692307692,0.945205479452055,0.970649895178197,0.948924731182796,0.4771225838023
E02005804,Ramshill & South Cliff,Scarborough,Yorkshire and the Humber,735,5041,606,573,375,751,7346,741,5597,600,589,385,701,7872,1137,482,532,353,653,3157,0.203144541718778,0.803333333333333,0.903225806451613,0.916883116883117,0.931526390870185,0.401041666666667
E02005805,Wheatcroft & Cayton,Scarborough,Yorkshire and the Humber,1080,3959,562,683,502,612,6318,1076,4430,566,667,560,604,6827,1225,489,637,542,584,3477,0.276523702031603,0.863957597173145,0.955022488755622,0.967857142857143,0.966887417218543,0.509301303647283
E02005806,"Eastfield, Crossgates & Seamer",Scarborough,Yorkshire and the Humber,1814,4412,369,381,291,343,5796,2000,5129,377,414,269,336,6525,1431,301,385,258,321,2696,0.279001754728017,0.798408488063661,0.929951690821256,0.95910780669145,0.955357142857143,0.413180076628353
E02005807,Ayton & Snainton,Scarborough,Yorkshire and the Humber,1047,3421,509,574,353,482,5339,1010,3750,554,571,396,495,5766,1072,463,549,389,476,2949,0.285866666666667,0.835740072202166,0.961471103327496,0.982323232323232,0.961616161616162,0.511446409989594
E02005808,Filey & Hummanby,Scarborough,Yorkshire and the Humber,1588,5884,1047,1174,887,1020,10012,1580,6359,1025,1133,928,1162,10607,1698,823,1044,876,1109,5550,0.267023116842271,0.802926829268293,0.921447484554281,0.943965517241379,0.954388984509466,0.523239370227208
E02005809,Tadcaster,Selby,Yorkshire and the Humber,1329,4515,438,496,334,447,6230,1249,4529,435,487,382,486,6319,1059,406,476,370,473,2784,0.233826451755354,0.933333333333333,0.97741273100616,0.968586387434555,0.973251028806584,0.440576040512739
E02005810,"Church Fenton, Appleton & Wistow",Selby,Yorkshire and the Humber,1935,5720,547,537,315,424,7543,1747,5979,557,575,412,381,7904,1328,515,549,401,369,3162,0.22211072085633,0.9245960502693,0.954782608695652,0.973300970873786,0.968503937007874,0.400050607287449
E02005811,Barlby & Riccall,Selby,Yorkshire and the Humber,1699,5750,688,596,395,503,7932,1759,6292,666,655,438,518,8569,1163,613,633,423,495,3327,0.184837889383344,0.92042042042042,0.966412213740458,0.965753424657534,0.955598455598455,0.388260007001984
E02005812,Sherburn in Elmet & South Milford,Selby,Yorkshire and the Humber,2131,6723,564,537,296,449,8569,2188,7276,544,584,344,480,9228,1758,481,564,332,464,3599,0.241616272677295,0.884191176470588,0.965753424657534,0.965116279069768,0.966666666666667,0.390008669267447
E02005813,Selby Town,Selby,Yorkshire and the Humber,2849,8791,516,428,305,566,10606,2878,9414,489,487,299,490,11179,1465,393,459,286,451,3054,0.155619290418526,0.803680981595092,0.942505133470226,0.956521739130435,0.920408163265306,0.273190804186421
E02005814,Selby West,Selby,Yorkshire and the Humber,1076,3783,413,474,349,514,5533,1202,4273,424,472,371,490,6030,770,365,450,360,482,2427,0.180201263749122,0.860849056603774,0.953389830508475,0.970350404312669,0.983673469387755,0.402487562189055
E02005815,"Selby South, Brayton & Barlow",Selby,Yorkshire and the Humber,1423,4984,595,624,373,472,7048,1415,5354,593,630,450,551,7578,1056,530,606,441,533,3166,0.197235711617482,0.893760539629005,0.961904761904762,0.98,0.967332123411978,0.417788334652943
E02005816,"Carlton, Hemingbrough & Osgodby",Selby,Yorkshire and the Humber,1462,5425,561,554,337,368,7245,1389,5450,577,565,355,395,7342,1070,483,532,333,376,2794,0.196330275229358,0.837088388214905,0.941592920353982,0.938028169014084,0.951898734177215,0.380550258785072
E02005817,"Hambleton, Monk Fryston & Byram",Selby,Yorkshire and the Humber,1283,4429,496,470,318,359,6072,1266,4537,509,519,343,390,6298,829,454,493,332,383,2491,0.182719858937624,0.891944990176817,0.94990366088632,0.967930029154519,0.982051282051282,0.395522388059701
E02005818,"Eggborough, Kellington & Smeaton",Selby,Yorkshire and the Humber,1517,5282,528,538,347,443,7138,1485,5504,536,547,399,413,7399,1083,478,522,381,388,2852,0.196765988372093,0.891791044776119,0.954296160877514,0.954887218045113,0.939467312348668,0.385457494255981
E02001509,Royston West,Barnsley,Yorkshire and the Humber,1249,4113,379,401,244,372,5509,1312,4434,397,394,287,341,5853,812,308,375,266,325,2086,0.183130356337393,0.775818639798489,0.951776649746193,0.926829268292683,0.953079178885631,0.356398428156501
E02001510,Royston East & Carlton,Barnsley,Yorkshire and the Humber,1137,3812,330,312,234,224,4912,1149,3932,329,344,237,261,5103,720,251,319,228,247,1765,0.183112919633774,0.762917933130699,0.927325581395349,0.962025316455696,0.946360153256705,0.345874975504605
E02001511,Shafton & Upper Cudworth,Barnsley,Yorkshire and the Humber,1113,3680,408,360,284,370,5102,1069,3829,456,358,286,366,5295,767,369,328,276,337,2077,0.200313397753983,0.80921052631579,0.916201117318436,0.965034965034965,0.920765027322404,0.392256846081209
E02001512,Mapplewell & Staincross,Barnsley,Yorkshire and the Humber,1340,4869,458,501,355,601,6784,1422,5247,465,536,376,531,7155,1040,392,490,358,507,2787,0.198208500095293,0.843010752688172,0.914179104477612,0.952127659574468,0.954802259887006,0.389517819706499
E02001513,Darton & Kexborough,Barnsley,Yorkshire and the Humber,1224,4636,530,551,406,379,6502,1190,4739,486,492,406,408,6531,935,409,460,386,383,2573,0.197299008229584,0.84156378600823,0.934959349593496,0.950738916256158,0.938725490196078,0.393967233195529
E02001514,Grimethorpe & Brierley,Barnsley,Yorkshire and the Humber,1628,4881,386,349,224,293,6133,1746,5265,370,362,223,288,6508,920,291,327,211,260,2009,0.174738841405508,0.786486486486487,0.903314917127072,0.946188340807175,0.902777777777778,0.308696988322065
E02001515,Athersley,Barnsley,Yorkshire and the Humber,2351,6000,532,464,262,381,7639,2307,6481,527,483,270,346,8107,980,397,444,254,316,2391,0.151211232834439,0.753320683111955,0.919254658385093,0.940740740740741,0.913294797687861,0.294930307141976
E02001516,Cudworth Village,Barnsley,Yorkshire and the Humber,1263,3954,278,252,162,214,4860,1337,4229,299,263,192,250,5233,764,239,250,183,231,1667,0.18065736580752,0.79933110367893,0.950570342205323,0.953125,0.924,0.318555321995032
E02001517,Monk Bretton,Barnsley,Yorkshire and the Humber,1290,5003,523,525,360,472,6883,1300,5110,537,521,410,494,7072,907,448,489,393,468,2705,0.177495107632094,0.834264432029795,0.938579654510557,0.958536585365854,0.947368421052632,0.382494343891403
E02001518,Honeywell,Barnsley,Yorkshire and the Humber,1941,6798,516,514,347,488,8663,1809,7080,534,526,342,460,8942,1241,420,497,324,417,2899,0.175282485875706,0.786516853932584,0.944866920152091,0.947368421052632,0.906521739130435,0.324200402594498
E02001519,Lundwood,Barnsley,Yorkshire and the Humber,1778,5005,375,335,240,323,6278,1787,5257,369,338,240,312,6516,906,302,319,227,294,2048,0.172341639718471,0.818428184281843,0.943786982248521,0.945833333333333,0.942307692307692,0.314303253529773
E02001520,Wilthorpe & Barugh Green,Barnsley,Yorkshire and the Humber,1810,6798,662,793,558,837,9648,1850,7363,736,806,599,850,10354,1522,609,768,576,800,4275,0.206709221784599,0.827445652173913,0.952853598014888,0.961602671118531,0.941176470588235,0.412883909600155
E02001521,Barnsley Town & Park Road,Barnsley,Yorkshire and the Humber,2191,9039,499,463,250,364,10615,2217,9427,505,444,301,346,11023,1111,344,396,275,312,2438,0.117852975495916,0.681188118811881,0.891891891891892,0.913621262458472,0.901734104046243,0.221173909099156
E02001522,Thurnscoe,Barnsley,Yorkshire and the Humber,1825,5542,482,489,312,440,7265,1973,6127,509,463,353,420,7872,882,407,430,334,394,2447,0.143952994940428,0.799607072691552,0.928725701943845,0.946175637393768,0.938095238095238,0.310848577235772
E02001523,Ardsley & Stairfoot,Barnsley,Yorkshire and the Humber,1171,4692,340,394,271,358,6055,1064,4681,362,338,297,361,6039,769,306,319,281,346,2021,0.164281136509293,0.845303867403315,0.943786982248521,0.946127946127946,0.958448753462604,0.334658055969531
E02001524,"Silkstone, Hoylandswaine & Cawthorne",Barnsley,Yorkshire and the Humber,926,3465,444,550,334,424,5217,920,3646,468,511,425,421,5471,740,406,482,408,401,2437,0.202962150301701,0.867521367521368,0.943248532289628,0.96,0.95249406175772,0.445439590568452
E02001525,Worsbrough Common,Barnsley,Yorkshire and the Humber,1313,4520,346,304,236,299,5705,1321,4946,327,267,224,296,6060,626,216,245,206,267,1560,0.126566922765871,0.660550458715596,0.917602996254682,0.919642857142857,0.902027027027027,0.257425742574257
E02001526,Kendray,Barnsley,Yorkshire and the Humber,1497,3846,311,269,200,239,4865,1552,4176,278,296,217,201,5168,619,217,271,206,183,1496,0.148227969348659,0.780575539568345,0.915540540540541,0.949308755760369,0.91044776119403,0.289473684210526
E02001527,Dodworth,Barnsley,Yorkshire and the Humber,1029,3693,383,385,263,371,5095,1000,3748,354,412,300,342,5156,712,276,388,283,309,1968,0.189967982924226,0.779661016949153,0.941747572815534,0.943333333333333,0.903508771929825,0.381691233514352
E02001528,Darfield & Great Houghton,Barnsley,Yorkshire and the Humber,1996,6405,648,636,422,573,8684,2034,6892,678,669,463,575,9277,1029,511,632,450,554,3176,0.149303540336622,0.753687315634218,0.944693572496263,0.971922246220302,0.963478260869565,0.34235205346556
E02001529,Worsbrough,Barnsley,Yorkshire and the Humber,1764,5684,566,527,394,586,7757,1741,6134,555,514,413,614,8230,984,434,465,389,587,2859,0.160417345940659,0.781981981981982,0.904669260700389,0.941888619854721,0.956026058631922,0.347387606318348
E02001530,Goldthorpe,Barnsley,Yorkshire and the Humber,1416,4375,301,252,195,204,5327,1498,4898,335,253,214,240,5940,678,256,231,199,221,1585,0.138423846467946,0.764179104477612,0.91304347826087,0.929906542056075,0.920833333333333,0.266835016835017
E02001531,Wombwell North,Barnsley,Yorkshire and the Humber,1390,5031,433,372,271,324,6431,1394,5159,385,421,295,336,6596,630,290,396,279,323,1918,0.122116689280868,0.753246753246753,0.94061757719715,0.945762711864407,0.961309523809524,0.290782292298363
E02001532,Penistone,Barnsley,Yorkshire and the Humber,2152,6429,643,604,410,514,8600,2139,6748,635,648,403,514,8948,1184,496,605,377,479,3141,0.175459395376408,0.781102362204724,0.933641975308642,0.935483870967742,0.931906614785992,0.351028162717926
E02001533,Bolton-upon-Dearne,Barnsley,Yorkshire and the Humber,1567,4827,440,360,230,326,6183,1625,5080,400,411,241,307,6439,699,307,391,225,281,1903,0.13759842519685,0.7675,0.951338199513382,0.933609958506224,0.915309446254072,0.295542786146917
E02001534,Wombwell South,Barnsley,Yorkshire and the Humber,1960,6254,454,466,289,442,7905,1867,6376,454,432,268,418,7948,895,322,409,260,395,2281,0.140370138017566,0.709251101321586,0.946759259259259,0.970149253731343,0.944976076555024,0.286990437845999
E02001535,"Ingbirchworth, Dunford Bridge & Thurgoland",Barnsley,Yorkshire and the Humber,1114,3848,473,455,322,348,5446,1019,3959,461,459,349,379,5607,662,372,439,330,365,2168,0.167213942914877,0.806941431670282,0.956427015250545,0.945558739255014,0.963060686015831,0.386659532726948
E02001536,Birdwell,Barnsley,Yorkshire and the Humber,1388,5100,515,553,426,592,7186,1347,5349,515,522,443,594,7423,843,373,495,422,563,2696,0.157599551318003,0.724271844660194,0.948275862068965,0.952595936794582,0.947811447811448,0.363195473528223
E02001537,Elsecar,Barnsley,Yorkshire and the Humber,1617,5487,461,397,259,342,6946,1523,5625,472,421,295,323,7136,869,318,399,281,301,2168,0.154488888888889,0.673728813559322,0.947743467933492,0.952542372881356,0.931888544891641,0.303811659192825
E02001538,Hoyland,Barnsley,Yorkshire and the Humber,1580,4898,462,494,374,423,6651,1483,5082,503,433,395,425,6838,763,358,416,381,410,2328,0.150137741046832,0.711729622266402,0.960739030023095,0.964556962025316,0.964705882352941,0.340450424100614
E02001539,Moorends,Doncaster,Yorkshire and the Humber,1567,3833,278,299,175,230,4815,1548,4308,299,298,217,236,5358,827,270,277,205,218,1797,0.19196843082637,0.903010033444816,0.929530201342282,0.944700460829493,0.923728813559322,0.33538633818589
E02001540,"Askern, Campsall & Norton",Doncaster,Yorkshire and the Humber,2414,6962,721,629,424,578,9314,2329,7749,700,663,466,631,10209,1093,568,630,435,599,3325,0.141050458123629,0.811428571428571,0.950226244343891,0.933476394849785,0.949286846275753,0.325693015966304
E02001541,Thorne,Doncaster,Yorkshire and the Humber,2035,6800,649,666,473,654,9242,2026,7438,687,671,539,719,10054,1650,608,625,507,671,4061,0.221833826297392,0.885007278020379,0.931445603576751,0.940630797773655,0.933240611961057,0.403918838273324
E02001542,Stainforth,Doncaster,Yorkshire and the Humber,1705,4615,440,394,273,376,6098,1820,4986,404,428,277,374,6469,928,345,400,262,341,2276,0.186121139189731,0.853960396039604,0.934579439252336,0.945848375451263,0.911764705882353,0.351831813263256
E02001543,Carcroft,Doncaster,Yorkshire and the Humber,1560,4743,456,468,305,497,6469,1608,5057,513,470,346,438,6824,678,446,447,336,422,2329,0.134071583943049,0.869395711500975,0.951063829787234,0.971098265895954,0.963470319634703,0.341295427901524
E02001544,Hatfield West,Doncaster,Yorkshire and the Humber,1813,5061,393,471,332,405,6662,1744,5358,396,453,374,439,7020,1267,343,433,364,422,2829,0.236468831653602,0.866161616161616,0.955849889624724,0.973262032085561,0.96127562642369,0.402991452991453
E02001545,Kirk Sandall & Barnby Dun,Doncaster,Yorkshire and the Humber,1350,4699,713,595,387,598,6992,1305,4934,624,678,431,603,7270,1053,581,654,418,582,3288,0.213417105796514,0.931089743589744,0.964601769911504,0.969837587006961,0.965174129353234,0.452269601100413
E02001546,Hatfield East,Doncaster,Yorkshire and the Humber,1089,6113,502,514,367,527,8023,1069,6172,514,497,371,568,8122,1168,439,475,363,536,2981,0.189241736876215,0.854085603112841,0.955734406438632,0.978436657681941,0.943661971830986,0.367027825658705
E02001547,Adwick le Street & Woodlands,Doncaster,Yorkshire and the Humber,2567,6743,482,475,255,400,8355,2510,7145,516,472,291,436,8860,932,394,433,270,414,2443,0.130440867739678,0.763565891472868,0.917372881355932,0.927835051546392,0.94954128440367,0.275733634311512
E02001548,Bentley & Toll Bar,Doncaster,Yorkshire and the Humber,1824,5118,345,339,243,284,6329,1917,5616,359,318,255,304,6852,609,263,290,229,269,1660,0.108440170940171,0.732590529247911,0.911949685534591,0.898039215686275,0.884868421052632,0.242265032107414
E02001549,Edenthorpe & Mere Lane,Doncaster,Yorkshire and the Humber,1209,3709,392,319,243,337,5000,1184,4007,398,373,265,369,5412,876,359,351,261,357,2204,0.218617419515847,0.902010050251256,0.941018766756032,0.984905660377358,0.967479674796748,0.407243163340724
E02001550,Scawthorpe,Doncaster,Yorkshire and the Humber,1538,4854,376,323,260,404,6217,1591,5205,411,367,251,375,6609,782,331,352,235,352,2052,0.150240153698367,0.805352798053528,0.959128065395095,0.936254980079681,0.938666666666667,0.310485701316387
E02001551,Bentley Rise,Doncaster,Yorkshire and the Humber,1168,3850,343,273,193,234,4893,1062,3923,329,322,180,250,5004,460,266,293,170,229,1418,0.117257201121591,0.808510638297872,0.909937888198758,0.944444444444444,0.916,0.283373301358913
E02001552,Armthorpe North,Doncaster,Yorkshire and the Humber,1640,4955,362,323,222,354,6216,1585,5160,346,349,243,361,6459,1228,313,327,230,341,2439,0.237984496124031,0.904624277456647,0.936962750716332,0.946502057613169,0.944598337950139,0.377612633534603
E02001553,Wheatley Hills,Doncaster,Yorkshire and the Humber,2152,6371,545,459,322,490,8187,2206,7014,522,497,316,480,8829,1238,449,471,297,444,2899,0.176504134587967,0.860153256704981,0.947686116700201,0.939873417721519,0.925,0.328349756484313
E02001554,Cusworth,Doncaster,Yorkshire and the Humber,1028,3620,340,341,268,423,4992,963,3894,341,325,287,407,5254,553,283,315,285,397,1833,0.142013353877761,0.829912023460411,0.969230769230769,0.993031358885017,0.975429975429975,0.348877046060145
E02001555,Armthorpe South,Doncaster,Yorkshire and the Humber,758,3059,433,382,294,363,4531,753,3151,459,433,302,378,4723,804,432,413,295,365,2309,0.255157092986354,0.941176470588235,0.953810623556582,0.97682119205298,0.965608465608465,0.488884183781495
E02001556,Intake,Doncaster,Yorkshire and the Humber,2051,6033,408,394,254,404,7493,2029,6562,420,418,243,382,8025,1076,336,384,222,348,2366,0.163974398049375,0.8,0.91866028708134,0.91358024691358,0.910994764397906,0.294828660436137
E02001557,Belle Vue & Town Fields,Doncaster,Yorkshire and the Humber,1609,7233,492,346,245,395,8711,1684,8056,521,391,256,453,9677,1118,421,353,235,398,2525,0.138778550148957,0.808061420345489,0.902813299232737,0.91796875,0.878587196467991,0.26092797354552
E02001558,"Cadeby, Hickleton & Hampole",Doncaster,Yorkshire and the Humber,838,3445,442,509,384,415,5195,787,3647,456,490,389,471,5453,598,399,468,379,451,2295,0.163970386619139,0.875,0.955102040816327,0.974293059125964,0.957537154989384,0.420869246286448
E02001559,Sprotbrough,Doncaster,Yorkshire and the Humber,1374,4524,376,541,326,479,6246,1286,4792,420,481,379,541,6613,833,374,464,370,513,2554,0.173831385642738,0.890476190476191,0.964656964656965,0.976253298153034,0.948243992606285,0.386208982307576
E02001560,Central Doncaster & Hyde Park,Doncaster,Yorkshire and the Humber,2710,9538,369,318,220,267,10712,2847,10750,376,326,203,247,11902,828,249,265,168,211,1721,0.0770232558139535,0.662234042553192,0.812883435582822,0.827586206896552,0.854251012145749,0.144597546630818
E02001561,Hexthorpe & Balby North,Doncaster,Yorkshire and the Humber,1333,4496,255,201,176,275,5403,1309,4745,264,194,165,203,5571,615,206,176,153,186,1336,0.129610115911486,0.78030303030303,0.907216494845361,0.927272727272727,0.916256157635468,0.239813318973254
E02001562,Cantley Park,Doncaster,Yorkshire and the Humber,1095,3462,342,317,229,434,4784,1092,3661,372,320,235,398,4986,832,343,307,223,387,2092,0.227260311390331,0.922043010752688,0.959375,0.948936170212766,0.972361809045226,0.419574809466506
E02001563,Bessacarr Bawtry Road,Doncaster,Yorkshire and the Humber,1447,4548,550,499,368,650,6615,1415,4799,526,550,391,678,6944,997,484,529,374,646,3030,0.207751614919775,0.920152091254753,0.961818181818182,0.956521739130435,0.952802359882006,0.436347926267281
E02001564,"Old Cantley, Auckley & Finningley",Doncaster,Yorkshire and the Humber,1404,4499,626,616,394,448,6583,1341,4922,592,630,446,518,7108,989,553,617,424,501,3084,0.200934579439252,0.934121621621622,0.979365079365079,0.95067264573991,0.967181467181467,0.433877321328081
E02001565,Bessacarr Grange & Lakeside,Doncaster,Yorkshire and the Humber,1167,4382,553,510,315,455,6215,1242,4830,537,550,379,471,6767,982,496,521,366,452,2817,0.203312629399586,0.92364990689013,0.947272727272727,0.965699208443272,0.959660297239915,0.416284912073297
E02001566,Balby Carr,Doncaster,Yorkshire and the Humber,2040,6424,279,264,129,209,7305,1987,6492,311,252,163,190,7408,966,257,226,148,172,1769,0.148798521256932,0.82636655948553,0.896825396825397,0.907975460122699,0.905263157894737,0.238795896328294
E02001567,Balby South,Doncaster,Yorkshire and the Humber,1899,5368,495,451,276,469,7059,1873,5845,518,479,299,456,7597,968,428,456,283,431,2566,0.165611633875107,0.826254826254826,0.951983298538622,0.946488294314381,0.945175438596491,0.337764907200211
E02001568,Mexborough East,Doncaster,Yorkshire and the Humber,1313,3960,343,366,263,261,5193,1406,4273,356,383,257,286,5555,679,300,366,247,272,1864,0.15890475076059,0.842696629213483,0.955613577023499,0.961089494163424,0.951048951048951,0.335553555355536
E02001569,Mexborough West,Doncaster,Yorkshire and the Humber,1789,5697,422,372,296,379,7166,1673,5774,452,389,329,395,7339,755,375,352,314,357,2153,0.130758572913059,0.829646017699115,0.904884318766067,0.954407294832827,0.90379746835443,0.293364218558387
E02001570,Conisbrough North,Doncaster,Yorkshire and the Humber,1358,4289,381,376,260,374,5680,1375,4480,392,413,252,361,5898,710,294,380,242,332,1958,0.158482142857143,0.75,0.920096852300242,0.96031746031746,0.919667590027701,0.331976941336046
E02001571,"Warmsworth, Braithwell & Stainton",Doncaster,Yorkshire and the Humber,1054,3701,361,393,303,352,5110,942,3735,363,389,302,362,5151,662,321,377,292,349,2001,0.177242302543507,0.884297520661157,0.969151670951157,0.966887417218543,0.964088397790055,0.388468258590565
E02001572,Edlington,Doncaster,Yorkshire and the Humber,1609,4625,379,339,225,308,5876,1643,5161,383,359,220,342,6465,729,300,328,205,324,1886,0.141251695407867,0.783289817232376,0.913649025069638,0.931818181818182,0.947368421052632,0.291724671307038
E02001573,Conisbrough South,Doncaster,Yorkshire and the Humber,1668,4731,392,325,251,384,6083,1637,5136,408,367,222,412,6545,891,348,348,217,387,2191,0.173481308411215,0.852941176470588,0.948228882833788,0.977477477477477,0.939320388349515,0.33475935828877
E02001574,Rossington,Doncaster,Yorkshire and the Humber,1004,3686,397,461,233,304,5081,991,3773,404,434,276,326,5213,614,340,417,266,312,1949,0.162735223959714,0.841584158415842,0.960829493087558,0.963768115942029,0.957055214723926,0.373873009783234
E02001575,New Rossington,Doncaster,Yorkshire and the Humber,1798,4560,308,331,223,351,5773,1750,5056,333,334,231,342,6296,750,247,302,211,319,1829,0.148338607594937,0.741741741741742,0.904191616766467,0.913419913419913,0.932748538011696,0.290501905972046
E02001576,"Bawtry, Austerfield & Hayfield",Doncaster,Yorkshire and the Humber,1355,4237,327,368,230,311,5473,1377,4527,342,353,258,326,5806,813,288,323,249,307,1980,0.179589131875414,0.842105263157895,0.915014164305949,0.965116279069768,0.941717791411043,0.341026524285222
E02001577,Tickhill & Wadworth,Doncaster,Yorkshire and the Humber,923,3347,514,614,451,618,5544,851,3555,483,598,505,622,5763,778,424,568,490,603,2863,0.218846694796062,0.877846790890269,0.949832775919733,0.97029702970297,0.969453376205788,0.496789866389034
E02001578,Brampton & West Melton,Rotherham,Yorkshire and the Humber,2645,7339,517,388,295,389,8928,2580,7653,581,454,295,362,9345,1158,469,436,278,351,2692,0.151313210505684,0.807228915662651,0.960352422907489,0.942372881355932,0.969613259668508,0.288068485821295
E02001579,Wath upon Dearne,Rotherham,Yorkshire and the Humber,1904,5890,553,490,385,569,7887,1887,6202,544,541,394,582,8263,1050,472,517,380,557,2976,0.169300225733634,0.867647058823529,0.955637707948244,0.964467005076142,0.957044673539519,0.360159748275445
E02001580,Swinton North,Rotherham,Yorkshire and the Humber,1343,4941,510,586,383,549,6969,1425,5321,489,565,414,520,7309,974,446,544,402,506,2872,0.183048299191881,0.912065439672802,0.96283185840708,0.971014492753623,0.973076923076923,0.392940210699138
E02001581,Swinton South,Rotherham,Yorkshire and the Humber,1179,3553,386,330,223,285,4777,1259,3935,409,362,208,283,5197,740,374,352,204,272,1942,0.188055908513342,0.914425427872861,0.972375690607735,0.980769230769231,0.96113074204947,0.373677121416202
E02001582,Rawmarsh North West,Rotherham,Yorkshire and the Humber,1472,4763,404,386,318,393,6264,1362,4999,403,401,323,390,6516,965,373,374,298,360,2370,0.193038607721544,0.925558312655087,0.932668329177057,0.922600619195046,0.923076923076923,0.363720073664825
E02001583,Rawmarsh North East,Rotherham,Yorkshire and the Humber,1194,3524,279,257,176,247,4483,1180,3631,289,256,180,232,4588,752,261,236,178,213,1640,0.207105480583861,0.903114186851211,0.921875,0.988888888888889,0.918103448275862,0.35745422842197
E02001584,Thorpe Hesley,Rotherham,Yorkshire and the Humber,976,4205,502,485,315,340,5847,916,4288,506,489,335,358,5976,897,457,472,314,343,2483,0.209188432835821,0.903162055335968,0.965235173824131,0.937313432835821,0.958100558659218,0.4154953145917
E02001585,Rawmarsh South,Rotherham,Yorkshire and the Humber,1315,4044,319,282,199,275,5119,1255,4099,323,301,210,281,5214,731,279,276,198,250,1734,0.178336179555989,0.863777089783282,0.916943521594684,0.942857142857143,0.889679715302491,0.332566168009206
E02001586,Greasborough,Rotherham,Yorkshire and the Humber,1082,4945,458,496,381,492,6772,1097,5282,432,459,399,491,7063,1193,396,435,376,473,2873,0.225861416130254,0.916666666666667,0.947712418300654,0.942355889724311,0.963340122199593,0.406767662466374
E02001587,Thrybergh & Hooton Roberts,Rotherham,Yorkshire and the Humber,1079,3496,322,328,235,290,4671,1088,3800,319,319,247,275,4960,654,282,299,236,252,1723,0.172105263157895,0.884012539184953,0.93730407523511,0.955465587044534,0.916363636363636,0.347379032258065
E02001588,Kimberworth Park,Rotherham,Yorkshire and the Humber,1545,4366,347,287,201,412,5613,1477,4760,355,307,187,379,5988,965,322,295,176,349,2107,0.202731092436975,0.907042253521127,0.960912052117264,0.941176470588235,0.920844327176781,0.35187040748163
E02001589,Ravenfield & Bramley North,Rotherham,Yorkshire and the Humber,1505,4807,464,483,301,380,6435,1399,4905,479,485,332,397,6598,1208,450,464,317,378,2817,0.246279306829766,0.939457202505219,0.956701030927835,0.954819277108434,0.952141057934509,0.426947559866626
E02001590,East Herringthorpe,Rotherham,Yorkshire and the Humber,2009,4681,299,262,211,221,5674,1920,5094,308,270,199,204,6075,825,267,250,186,178,1706,0.161955241460542,0.866883116883117,0.925925925925926,0.934673366834171,0.872549019607843,0.28082304526749
E02001591,Eastwood & East Dene,Rotherham,Yorkshire and the Humber,2170,5411,344,263,188,273,6479,2167,5935,367,292,197,284,7075,830,310,260,178,248,1826,0.139848357203033,0.844686648501362,0.89041095890411,0.903553299492386,0.873239436619718,0.258091872791519
E02001592,Kimberworth,Rotherham,Yorkshire and the Humber,1508,5337,495,551,403,412,7198,1453,5537,523,540,383,442,7425,1130,479,509,367,415,2900,0.204081632653061,0.915869980879541,0.942592592592593,0.95822454308094,0.938914027149321,0.390572390572391
E02001593,Masbrough & Bradgate,Rotherham,Yorkshire and the Humber,1777,5095,260,227,123,197,5902,1949,5680,285,219,144,188,6516,697,234,183,128,150,1392,0.122711267605634,0.821052631578947,0.835616438356164,0.888888888888889,0.797872340425532,0.213627992633517
E02001594,Rotherham Central,Rotherham,Yorkshire and the Humber,1907,5491,255,218,161,318,6443,2254,6287,258,212,164,319,7240,682,184,169,143,251,1429,0.108477811356768,0.713178294573643,0.797169811320755,0.871951219512195,0.786833855799373,0.197375690607735
E02001595,Maltby West & Hellaby,Rotherham,Yorkshire and the Humber,1347,5171,521,445,346,482,6965,1284,5339,528,497,383,493,7240,1186,495,478,363,478,3000,0.22213897733658,0.9375,0.961770623742455,0.947780678851175,0.969574036511156,0.414364640883978
E02001596,Wickersley North,Rotherham,Yorkshire and the Humber,1397,4680,553,596,453,696,6978,1429,5058,550,569,479,642,7298,1244,520,554,444,621,3383,0.245947014630289,0.945454545454546,0.973637961335677,0.926931106471816,0.967289719626168,0.46355165798849
E02001597,Maltby East,Rotherham,Yorkshire and the Humber,2077,5719,491,449,291,407,7357,2130,6088,512,460,318,413,7791,1292,484,429,298,390,2893,0.212220762155059,0.9453125,0.932608695652174,0.937106918238994,0.944309927360775,0.371325888846104
E02001598,Herringthorpe,Rotherham,Yorkshire and the Humber,1819,5602,544,559,393,646,7744,1830,6032,552,550,447,703,8284,1329,496,530,419,675,3449,0.220324933687003,0.898550724637681,0.963636363636364,0.937360178970917,0.960170697012802,0.416344760985031
E02001599,Wickersley South & Bramley South,Rotherham,Yorkshire and the Humber,1037,3817,390,414,311,426,5358,1103,4224,403,415,336,444,5822,1032,379,392,322,420,2545,0.244318181818182,0.940446650124069,0.944578313253012,0.958333333333333,0.945945945945946,0.437135005152868
E02001600,Rotherham South,Rotherham,Yorkshire and the Humber,2220,6691,584,579,434,739,9027,2241,7279,589,581,454,686,9589,1420,512,530,428,622,3512,0.195081741997527,0.869269949066214,0.912220309810671,0.94273127753304,0.906705539358601,0.366252998227135
E02001601,Whiston,Rotherham,Yorkshire and the Humber,785,2890,328,301,244,320,4083,756,3124,307,314,236,340,4321,681,275,300,222,316,1794,0.217989756722151,0.895765472312704,0.955414012738854,0.940677966101695,0.929411764705882,0.415181670909512
E02001602,Brinsworth,Rotherham,Yorkshire and the Humber,1608,5401,449,579,416,503,7348,1614,5645,438,553,448,544,7628,980,400,527,428,524,2859,0.173604960141718,0.91324200913242,0.952983725135624,0.955357142857143,0.963235294117647,0.374803356056633
E02001603,Thurcroft,Rotherham,Yorkshire and the Humber,1559,4341,393,407,245,339,5725,1535,4635,402,418,252,336,6043,959,370,405,243,319,2296,0.206903991370011,0.920398009950249,0.9688995215311,0.964285714285714,0.949404761904762,0.379943736554691
E02001604,"Catcliffe, Treeton & Waverley",Rotherham,Yorkshire and the Humber,2207,6872,403,431,269,360,8335,2409,7423,395,424,320,337,8899,1495,353,403,303,324,2878,0.201401050788091,0.893670886075949,0.950471698113208,0.946875,0.961424332344214,0.323407124396
E02001605,Laughton & Throapham,Rotherham,Yorkshire and the Humber,1398,4792,434,399,281,428,6334,1276,4777,439,401,308,402,6327,991,402,389,293,379,2454,0.207452375968181,0.915717539863326,0.970074812967581,0.951298701298701,0.942786069651741,0.387861545756283
E02001606,Dinnington,Rotherham,Yorkshire and the Humber,1591,4749,448,529,330,417,6473,1561,5193,458,498,373,460,6982,1021,417,482,368,446,2734,0.196610822260736,0.910480349344978,0.967871485943775,0.986595174262735,0.969565217391304,0.39157834431395
E02001607,Aston,Rotherham,Yorkshire and the Humber,1809,5156,526,589,403,464,7138,1779,5558,538,565,412,515,7588,1145,478,534,395,496,3048,0.206009355883411,0.888475836431227,0.945132743362832,0.95873786407767,0.963106796116505,0.401686874011597
E02001608,Swallownest & Wales,Rotherham,Yorkshire and the Humber,1344,4097,378,427,290,269,5461,1356,4410,380,429,324,323,5866,880,346,409,318,314,2267,0.199546485260771,0.910526315789474,0.953379953379953,0.981481481481481,0.972136222910217,0.386464370951245
E02001609,Anston & Woodsetts,Rotherham,Yorkshire and the Humber,1298,4701,585,733,525,544,7088,1368,5083,558,693,601,564,7499,1011,513,665,580,545,3314,0.198898288412355,0.919354838709677,0.95959595959596,0.965058236272879,0.966312056737589,0.441925590078677
E02001610,"Kiveton, Todwick & Harthill",Rotherham,Yorkshire and the Humber,1487,4952,484,614,411,482,6943,1414,5082,458,565,485,517,7107,1021,427,551,471,505,2975,0.20090515545061,0.932314410480349,0.975221238938053,0.971134020618557,0.97678916827853,0.418601378922189
E02001611,Stocksbridge,Sheffield,Yorkshire and the Humber,1314,4492,453,507,342,544,6338,1269,4806,434,533,412,557,6742,1249,378,510,400,528,3065,0.259883478984603,0.870967741935484,0.956848030018762,0.970873786407767,0.947935368043088,0.454612874517947
E02001612,Deepcar & Bolsterstone,Sheffield,Yorkshire and the Humber,926,3567,338,377,278,296,4856,899,3672,341,388,310,296,5007,926,300,364,305,283,2178,0.252178649237473,0.879765395894428,0.938144329896907,0.983870967741936,0.956081081081081,0.434991012582385
E02001613,High Green & Burncross,Sheffield,Yorkshire and the Humber,1791,6019,621,726,445,577,8388,1791,6377,683,716,488,588,8852,1369,493,674,467,548,3551,0.214677748157441,0.721815519765739,0.941340782122905,0.956967213114754,0.931972789115646,0.401152281970176
E02001614,Chapeltown,Sheffield,Yorkshire and the Humber,1671,6467,693,735,507,652,9054,1666,6944,721,754,585,758,9762,1521,536,718,568,722,4065,0.21903801843318,0.743411927877947,0.952254641909814,0.970940170940171,0.952506596306069,0.41641057160418
E02001615,Grenoside & Ecclesfield North,Sheffield,Yorkshire and the Humber,932,4097,523,592,459,589,6260,925,4374,531,615,506,614,6640,1044,425,595,490,598,3152,0.238683127572016,0.800376647834275,0.967479674796748,0.968379446640316,0.973941368078176,0.474698795180723
E02001616,Ecclesfield South,Sheffield,Yorkshire and the Humber,1288,4416,364,428,343,454,6005,1276,4542,339,434,336,480,6131,1043,259,417,322,462,2503,0.2296345222369,0.76401179941003,0.960829493087558,0.958333333333333,0.9625,0.408253139781439
E02001617,Shiregreen North,Sheffield,Yorkshire and the Humber,1563,3596,216,160,134,206,4312,1633,4004,194,154,140,227,4719,775,159,139,129,211,1413,0.193556443556444,0.819587628865979,0.902597402597403,0.921428571428571,0.929515418502203,0.29942784488239
E02001618,Oughtibridge & Bradfield,Sheffield,Yorkshire and the Humber,1840,6073,530,557,397,456,8013,1856,6546,536,581,439,483,8585,1418,432,553,424,462,3289,0.21662083715246,0.805970149253731,0.951807228915663,0.965831435079727,0.956521739130435,0.383110075713454
E02001619,Parson Cross,Sheffield,Yorkshire and the Humber,2237,5872,434,442,327,427,7502,2349,6725,462,405,290,443,8325,1459,345,377,268,418,2867,0.216951672862454,0.746753246753247,0.930864197530864,0.924137931034483,0.943566591422122,0.344384384384384
E02001620,Shiregreen South,Sheffield,Yorkshire and the Humber,1760,4205,247,283,202,255,5192,1709,4662,283,243,221,234,5643,955,226,221,210,216,1828,0.204847704847705,0.798586572438163,0.909465020576132,0.950226244343891,0.923076923076923,0.323941166046429
E02001621,Sheffield Lane Top & Longley Park,Sheffield,Yorkshire and the Humber,1441,3786,206,224,168,239,4623,1524,4093,225,214,172,229,4933,828,178,202,166,212,1586,0.202296603957977,0.791111111111111,0.94392523364486,0.965116279069768,0.925764192139738,0.32150821001419
E02001622,Southey Green West,Sheffield,Yorkshire and the Humber,1933,5463,379,342,266,484,6934,2008,5828,403,359,283,453,7326,1138,311,325,265,434,2473,0.195264241592313,0.771712158808933,0.905292479108635,0.936395759717314,0.958057395143488,0.337564837564838
E02001623,Firth Park,Sheffield,Yorkshire and the Humber,2203,5056,334,298,204,377,6269,2174,5753,363,337,230,382,7065,931,256,296,210,336,2029,0.161828611159395,0.705234159779614,0.878338278931751,0.91304347826087,0.879581151832461,0.287190375088464
E02001624,Brightside & Wincobank,Sheffield,Yorkshire and the Humber,2096,6262,396,418,344,379,7799,1950,6633,458,388,377,402,8258,1047,372,359,364,367,2509,0.157847127996382,0.812227074235808,0.925257731958763,0.96551724137931,0.912935323383085,0.303826592395253
E02001625,Southey Green East,Sheffield,Yorkshire and the Humber,1968,4754,300,305,229,301,5889,1981,5143,318,327,226,320,6334,1005,242,298,205,303,2053,0.195411238576706,0.761006289308176,0.91131498470948,0.907079646017699,0.946875,0.324123776444585
E02001626,Wadsley & Marlcliffe,Sheffield,Yorkshire and the Humber,1073,3690,271,319,222,275,4777,1040,3975,286,314,214,329,5118,803,249,296,204,310,1862,0.202012578616352,0.870629370629371,0.942675159235669,0.953271028037383,0.942249240121581,0.363813989839781
E02001627,"Hillsborough, Owlerton & Wadsley Bridge",Sheffield,Yorkshire and the Humber,1047,4222,246,233,139,218,5058,1026,4538,286,230,142,207,5403,869,239,211,132,190,1641,0.191494050242398,0.835664335664336,0.917391304347826,0.929577464788732,0.917874396135266,0.303720155469184
E02001628,Tinsley & Carbrook,Sheffield,Yorkshire and the Humber,2014,4263,227,162,173,261,5086,2172,4952,236,198,145,226,5757,483,160,166,129,194,1132,0.0975363489499192,0.677966101694915,0.838383838383838,0.889655172413793,0.858407079646018,0.196630189334723
E02001629,Shirecliffe & Parkwood Springs,Sheffield,Yorkshire and the Humber,1586,4311,257,211,234,361,5374,1632,4619,269,235,215,366,5704,744,200,192,199,335,1670,0.161073825503356,0.743494423791822,0.817021276595745,0.925581395348837,0.915300546448087,0.292776998597476
E02001630,Crabtree & Fir Vale,Sheffield,Yorkshire and the Humber,2854,5999,300,187,165,379,7030,2894,7201,316,217,186,384,8304,720,196,180,158,320,1574,0.0999861130398556,0.620253164556962,0.829493087557604,0.849462365591398,0.833333333333333,0.189547206165703
E02001631,Malin Bridge & Wisewood,Sheffield,Yorkshire and the Humber,1377,4952,327,353,273,431,6336,1322,5331,353,370,320,417,6791,1223,298,342,305,395,2563,0.229412868129807,0.844192634560907,0.924324324324324,0.953125,0.947242206235012,0.377411279634811
E02001632,Burngreave & Grimesthorpe,Sheffield,Yorkshire and the Humber,4759,9070,286,206,163,327,10052,4252,10118,329,222,175,354,11198,718,189,163,139,243,1452,0.0709626408381103,0.574468085106383,0.734234234234234,0.794285714285714,0.686440677966102,0.129666011787819
E02001633,Upper Stannington & Loxley,Sheffield,Yorkshire and the Humber,1158,4277,485,548,407,603,6320,1220,4677,498,533,429,591,6728,1115,461,506,411,567,3060,0.238400684199273,0.92570281124498,0.949343339587242,0.958041958041958,0.959390862944162,0.454815695600476
E02001634,Walkley,Sheffield,Yorkshire and the Humber,1273,6627,446,363,258,389,8083,1323,6758,455,398,276,378,8265,1379,390,376,264,348,2757,0.204054453980468,0.857142857142857,0.944723618090452,0.956521739130435,0.920634920634921,0.333575317604356
E02001635,Lower Stannington,Sheffield,Yorkshire and the Humber,1073,3574,297,360,347,469,5047,1024,3811,337,336,330,477,5291,887,294,322,318,464,2285,0.232747310417213,0.872403560830861,0.958333333333333,0.963636363636364,0.972746331236897,0.431865431865432
E02001636,"Upperthorpe, Netherthorpe & Langsett",Sheffield,Yorkshire and the Humber,1896,8062,369,337,248,413,9429,1904,9187,335,339,239,392,10492,1132,250,296,208,340,2226,0.123217590072929,0.746268656716418,0.873156342182891,0.870292887029289,0.86734693877551,0.212161646969119
E02001637,Darnall,Sheffield,Yorkshire and the Humber,2626,5182,211,169,152,203,5917,2851,6428,237,169,153,256,7243,706,137,136,131,215,1325,0.109831985065339,0.578059071729958,0.804733727810651,0.856209150326797,0.83984375,0.182935247825487
E02001638,Springvale & Steel Bank,Sheffield,Yorkshire and the Humber,514,5098,148,137,67,117,5567,509,4898,133,152,84,116,5383,854,115,143,77,110,1299,0.17435688035933,0.864661654135338,0.94078947368421,0.916666666666667,0.948275862068965,0.241315251718373
E02001639,Crookes,Sheffield,Yorkshire and the Humber,928,4327,203,238,197,340,5305,923,4170,219,244,183,350,5166,904,183,226,174,330,1817,0.216786570743405,0.835616438356164,0.926229508196721,0.950819672131147,0.942857142857143,0.351722802942315
E02001640,Broomhill & Lower Crookesmoor,Sheffield,Yorkshire and the Humber,759,6599,245,152,138,245,7379,775,6650,247,195,138,271,7501,1206,201,174,125,247,1953,0.181353383458647,0.813765182186235,0.892307692307692,0.905797101449275,0.911439114391144,0.260365284628716
E02001642,Littledale & Handsworth North,Sheffield,Yorkshire and the Humber,2057,6616,414,410,341,460,8241,2060,6918,439,457,367,522,8703,1060,362,421,343,490,2676,0.153223474992772,0.824601366742597,0.921225382932166,0.934604904632153,0.938697318007663,0.307480179248535
E02001643,Sandygate & Crosspool,Sheffield,Yorkshire and the Humber,1170,3592,399,407,297,445,5140,1204,3896,418,412,310,489,5525,923,365,393,300,466,2447,0.236909650924025,0.873205741626794,0.953883495145631,0.967741935483871,0.952965235173824,0.44289592760181
E02001646,Broomhall,Sheffield,Yorkshire and the Humber,778,7582,218,218,128,241,8387,686,7263,239,216,140,246,8104,1036,196,202,130,219,1783,0.142640782045987,0.820083682008368,0.935185185185185,0.928571428571429,0.890243902439024,0.220014807502468
E02001647,Handsworth South,Sheffield,Yorkshire and the Humber,1159,3661,315,366,304,442,5088,1132,3901,327,339,318,407,5292,712,270,327,301,390,2000,0.182517303255576,0.825688073394496,0.964601769911504,0.946540880503145,0.958230958230958,0.377928949357521
E02001648,Endcliffe & Ranmoor,Sheffield,Yorkshire and the Humber,1093,7737,323,385,178,374,8997,1027,8336,352,352,248,311,9599,1129,294,330,235,288,2276,0.135436660268714,0.835227272727273,0.9375,0.94758064516129,0.92604501607717,0.237108032086676
E02001649,Woodthorpe,Sheffield,Yorkshire and the Humber,2470,6432,394,337,284,280,7727,2631,7529,443,356,276,256,8860,1657,323,328,258,228,2794,0.22008234825342,0.729119638826185,0.921348314606742,0.934782608695652,0.890625,0.315349887133183
E02001650,Sharrow,Sheffield,Yorkshire and the Humber,1319,8374,172,107,103,182,8938,1209,9138,187,139,104,201,9769,1101,117,118,88,166,1590,0.12048588312541,0.625668449197861,0.848920863309353,0.846153846153846,0.825870646766169,0.16275975023032
E02001651,Fulwood & Lodge Moor,Sheffield,Yorkshire and the Humber,1502,4266,543,557,405,605,6376,1550,4991,526,606,448,614,7185,1324,471,573,425,589,3382,0.265277499499098,0.895437262357415,0.945544554455445,0.948660714285714,0.95928338762215,0.470702853166319
E02001652,Highfield & Lowfield,Sheffield,Yorkshire and the Humber,1715,10872,192,139,132,222,11557,1555,12292,222,160,126,199,12999,970,131,132,101,135,1469,0.0789131142206313,0.59009009009009,0.825,0.801587301587302,0.678391959798995,0.113008692976383
E02001653,Norfolk Park,Sheffield,Yorkshire and the Humber,1436,5192,232,239,208,253,6124,1546,5651,241,242,223,229,6586,1051,159,208,203,212,1833,0.18598478145461,0.659751037344398,0.859504132231405,0.910313901345291,0.925764192139738,0.278317643486183
E02001654,Woodhouse Mill,Sheffield,Yorkshire and the Humber,1081,3812,273,319,310,482,5196,1129,3996,279,314,285,530,5404,933,210,295,267,506,2211,0.233483483483484,0.752688172043011,0.939490445859873,0.936842105263158,0.954716981132075,0.409141376757957
E02001655,Richmond & Stradbroke,Sheffield,Yorkshire and the Humber,1620,4738,373,409,259,326,6105,1594,5000,378,419,283,338,6418,1199,295,391,277,327,2489,0.2398,0.780423280423281,0.933174224343675,0.978798586572438,0.967455621301775,0.387815518853225
E02001656,Brincliffe & Sharrow Vale,Sheffield,Yorkshire and the Humber,1275,5929,313,258,181,281,6962,1349,5963,336,290,194,280,7063,1354,259,265,182,259,2319,0.227066912627872,0.770833333333333,0.913793103448276,0.938144329896907,0.925,0.328330737646892
E02001657,Ecclesall & Greystones,Sheffield,Yorkshire and the Humber,2015,5642,428,419,253,402,7144,1975,6104,448,444,279,384,7659,1550,376,430,267,375,2998,0.253931847968545,0.839285714285714,0.968468468468468,0.956989247311828,0.9765625,0.391434913174044
E02001658,Arbourthorne,Sheffield,Yorkshire and the Humber,1308,3498,197,186,158,202,4241,1389,3670,224,192,164,180,4430,795,150,166,156,161,1428,0.216621253405995,0.669642857142857,0.864583333333333,0.951219512195122,0.894444444444445,0.32234762979684
E02001659,Woodhouse West,Sheffield,Yorkshire and the Humber,972,3851,302,321,192,383,5049,982,3937,325,312,196,347,5117,1001,216,295,185,321,2018,0.254254508509017,0.664615384615385,0.94551282051282,0.943877551020408,0.92507204610951,0.39437170216924
E02001660,Nether Edge,Sheffield,Yorkshire and the Humber,1873,7000,439,359,210,403,8411,1845,7539,485,428,266,418,9136,1570,350,393,241,364,2918,0.208250431091657,0.721649484536083,0.918224299065421,0.906015037593985,0.870813397129187,0.319395796847636
E02001661,Heeley & Newfield Green,Sheffield,Yorkshire and the Humber,1571,5307,309,360,250,406,6632,1621,5499,331,320,241,373,6764,1082,256,288,217,342,2185,0.196763047826878,0.773413897280967,0.9,0.900414937759336,0.916890080428954,0.323033707865169
E02001662,Intake,Sheffield,Yorkshire and the Humber,1262,4482,380,434,332,554,6182,1250,4623,426,418,362,577,6406,1230,326,392,339,543,2830,0.266060999351071,0.765258215962441,0.937799043062201,0.93646408839779,0.94107452339688,0.441773337496097
E02001663,Meersbrook,Sheffield,Yorkshire and the Humber,1432,5402,251,235,135,236,6259,1362,5579,347,231,158,262,6577,1176,261,198,143,226,2004,0.210790464240903,0.752161383285303,0.857142857142857,0.905063291139241,0.862595419847328,0.304698190664437
E02001664,Gleadless,Sheffield,Yorkshire and the Humber,1040,3829,369,379,298,449,5324,1024,3935,377,393,291,445,5441,968,320,369,279,425,2361,0.245997458703939,0.848806366047745,0.938931297709924,0.958762886597938,0.955056179775281,0.433927586840654
E02001665,Bents Green & Millhouses,Sheffield,Yorkshire and the Humber,1827,5265,618,656,459,794,7792,1903,6019,629,709,471,750,8578,1631,554,674,445,716,4020,0.270975245057319,0.880763116057234,0.950634696755994,0.9447983014862,0.954666666666667,0.468640708789928
E02001666,Beighton,Sheffield,Yorkshire and the Humber,1167,3819,273,273,202,249,4816,1144,4027,267,288,210,248,5040,1072,184,269,201,234,1960,0.26620312888006,0.689138576779026,0.934027777777778,0.957142857142857,0.943548387096774,0.388888888888889
E02001669,Woodseats,Sheffield,Yorkshire and the Humber,1285,5180,292,308,200,321,6301,1269,5320,334,303,246,352,6555,1118,272,283,234,343,2250,0.21015037593985,0.81437125748503,0.933993399339934,0.951219512195122,0.974431818181818,0.34324942791762
E02001670,Herdings & Gleadless Valley,Sheffield,Yorkshire and the Humber,1446,3889,253,257,179,353,4931,1412,4000,235,234,182,295,4946,851,184,213,170,270,1688,0.21275,0.782978723404255,0.91025641025641,0.934065934065934,0.915254237288136,0.341285887585928
E02001671,Hackenthorpe,Sheffield,Yorkshire and the Humber,708,3460,386,451,295,376,4968,708,3589,436,422,365,410,5222,894,360,403,358,396,2411,0.249094455280022,0.825688073394496,0.954976303317536,0.980821917808219,0.965853658536585,0.461700497893527
E02001672,Charnock & Basegreen,Sheffield,Yorkshire and the Humber,990,3589,308,360,281,547,5085,988,3823,336,330,261,435,5185,974,276,312,245,420,2227,0.254773737902171,0.821428571428571,0.945454545454546,0.938697318007663,0.96551724137931,0.429508196721311
E02001673,Sothall,Sheffield,Yorkshire and the Humber,923,3451,278,239,142,237,4347,922,3620,314,274,167,223,4598,963,252,261,164,218,1858,0.266022099447514,0.802547770700637,0.952554744525547,0.982035928143713,0.977578475336323,0.404088734232275
E02001674,Norton & Norton Lees,Sheffield,Yorkshire and the Humber,1356,4886,578,600,473,722,7259,1507,5474,598,601,500,732,7905,1310,505,573,484,706,3578,0.239313116550968,0.844481605351171,0.953410981697171,0.968,0.96448087431694,0.452624920936116
E02001675,Westfield & Waterthorpe,Sheffield,Yorkshire and the Humber,1432,5093,550,638,437,520,7238,1336,5305,585,632,456,517,7495,1328,462,616,440,502,3348,0.250329877474081,0.78974358974359,0.974683544303798,0.964912280701754,0.970986460348163,0.446697798532355
E02001676,Beauchief,Sheffield,Yorkshire and the Humber,982,3323,375,360,289,450,4797,961,3667,410,386,288,469,5220,816,365,370,274,450,2275,0.222525224979547,0.890243902439024,0.958549222797927,0.951388888888889,0.959488272921109,0.435823754789272
E02001678,Dore & Whirlow,Sheffield,Yorkshire and the Humber,1884,5593,685,717,537,879,8411,1943,6048,683,734,624,967,9056,1444,582,713,602,938,4279,0.238756613756614,0.85212298682284,0.971389645776567,0.96474358974359,0.970010341261634,0.472504416961131
E02001679,Greenhill & Lowedges,Sheffield,Yorkshire and the Humber,1453,3964,284,305,199,346,5098,1380,4058,305,310,238,333,5244,804,256,282,225,313,1880,0.198127156234598,0.839344262295082,0.909677419354839,0.945378151260504,0.93993993993994,0.358504958047292
E02001680,Batemoor & Jordanthorpe,Sheffield,Yorkshire and the Humber,1472,3943,260,244,198,332,4977,1379,4201,249,256,187,310,5203,816,195,232,174,290,1707,0.194239466793621,0.783132530120482,0.90625,0.93048128342246,0.935483870967742,0.328079953872766
E02001681,Totley & Bradway,Sheffield,Yorkshire and the Humber,1374,4259,517,513,408,573,6270,1397,4532,463,534,402,572,6503,970,399,505,377,561,2812,0.214033539276258,0.861771058315335,0.945692883895131,0.937810945273632,0.980769230769231,0.432415808088575
E02006803,Mosborough & Halfway,Sheffield,Yorkshire and the Humber,1473,5692,534,490,329,417,7462,1537,5916,533,526,374,484,7833,1383,447,507,365,470,3172,0.233772819472617,0.838649155722326,0.963878326996198,0.975935828877005,0.971074380165289,0.404953402272437
E02006843,Cathedral & Kelham,Sheffield,Yorkshire and the Humber,653,20409,29,30,25,25,20518,616,18465,65,41,17,21,18609,716,44,33,11,11,815,0.0387760628215543,0.676923076923077,0.804878048780488,0.647058823529412,0.523809523809524,0.0437960126820356
E02006844,Devonshire Quarter,Sheffield,Yorkshire and the Humber,766,10213,76,56,36,76,10457,788,11398,95,65,34,83,11675,723,52,49,26,71,921,0.0634321810844008,0.547368421052632,0.753846153846154,0.764705882352941,0.855421686746988,0.0788865096359743
E02006868,Park Hill & Wybourn,Sheffield,Yorkshire and the Humber,2578,9408,456,361,356,405,10986,2290,9995,457,416,317,431,11616,1435,320,356,286,370,2767,0.143571785892946,0.700218818380744,0.855769230769231,0.902208201892745,0.8584686774942,0.238205922865014
E02006869,Birley,Sheffield,Yorkshire and the Humber,1986,6982,488,559,387,647,9063,1980,7408,520,546,417,616,9507,1760,401,507,398,589,3655,0.237580993520518,0.771153846153846,0.928571428571429,0.954436450839328,0.956168831168831,0.384453560534343
E02002183,Addingham & Ilkley Moor,Bradford,Yorkshire and the Humber,771,2821,430,536,365,565,4717,741,3198,442,516,425,643,5224,807,395,488,412,631,2733,0.25234521575985,0.893665158371041,0.945736434108527,0.969411764705882,0.981337480559876,0.523162327718224
E02002184,Ilkley & Ben Rhydding,Bradford,Yorkshire and the Humber,2292,7011,754,842,669,1399,10675,2186,7859,809,868,680,1434,11650,1484,712,812,662,1388,5058,0.188828095177503,0.880098887515451,0.935483870967742,0.973529411764706,0.96792189679219,0.434163090128755
E02002185,Burley-in-Wharfedale,Bradford,Yorkshire and the Humber,1161,3318,397,350,245,397,4707,1128,3624,353,388,260,399,5024,729,316,376,256,380,2057,0.201158940397351,0.895184135977337,0.969072164948454,0.984615384615385,0.952380952380952,0.409434713375796
E02002186,Steeton & Silsden,Bradford,Yorkshire and the Humber,2340,7753,843,902,562,917,10977,2246,8491,880,935,634,920,11860,1885,653,868,609,871,4886,0.221999764456483,0.742045454545455,0.928342245989305,0.960567823343849,0.946739130434783,0.411973018549747
E02002187,Menston & Burley Moor,Bradford,Yorkshire and the Humber,1126,3318,373,410,261,487,4849,1199,3835,417,407,300,459,5418,698,382,388,289,443,2200,0.182007822685789,0.916067146282974,0.953316953316953,0.963333333333333,0.965141612200436,0.406053894425987
E02002188,Riddlesden & East Morton,Bradford,Yorkshire and the Humber,1531,4575,455,477,263,398,6168,1439,4911,444,511,277,416,6559,1068,361,478,261,387,2555,0.217470983506414,0.813063063063063,0.935420743639922,0.942238267148014,0.930288461538461,0.389541088580576
E02002189,Keighley Utley,Bradford,Yorkshire and the Humber,1738,3989,320,275,183,360,5127,1766,4675,383,272,200,381,5911,863,269,232,183,340,1887,0.184598930481283,0.702349869451697,0.852941176470588,0.915,0.89238845144357,0.319235323972255
E02002190,Keighley Central & East,Bradford,Yorkshire and the Humber,2990,7385,546,332,242,409,8914,3085,8518,609,382,250,396,10155,1224,423,319,217,319,2502,0.143695703216718,0.694581280788177,0.835078534031414,0.868,0.805555555555556,0.246381093057607
E02002191,Keighley Oakworth Road & West Lane,Bradford,Yorkshire and the Humber,2622,5901,347,250,241,300,7039,2720,6874,355,292,219,296,8036,990,209,234,192,247,1872,0.1440209485016,0.588732394366197,0.801369863013699,0.876712328767123,0.83445945945946,0.232951717272275
E02002192,Crossflatts & Eldwick,Bradford,Yorkshire and the Humber,1570,5243,619,641,434,669,7606,1475,5663,704,693,495,709,8264,1382,647,649,469,677,3824,0.244040261345577,0.919034090909091,0.936507936507937,0.947474747474747,0.954866008462623,0.462729912875121
E02002193,Keighley South,Bradford,Yorkshire and the Humber,1377,3762,297,294,215,240,4808,1395,4303,299,324,233,233,5392,716,173,272,201,197,1559,0.166395537996746,0.578595317725752,0.839506172839506,0.862660944206009,0.84549356223176,0.289132047477745
E02002194,Keighley Exley Head,Bradford,Yorkshire and the Humber,1523,4417,410,415,264,349,5855,1505,4845,392,455,265,365,6322,921,260,410,244,329,2164,0.190092879256966,0.663265306122449,0.901098901098901,0.920754716981132,0.901369863013699,0.342296741537488
E02002195,Baildon North,Bradford,Yorkshire and the Humber,1098,3564,430,512,292,410,5208,1005,3893,442,552,344,452,5683,993,392,517,335,446,2683,0.25507320832263,0.886877828054299,0.936594202898551,0.973837209302325,0.986725663716814,0.472109801161358
E02002196,Oakworth & Laycock,Bradford,Yorkshire and the Humber,1221,3983,377,329,181,242,5112,1250,4193,367,370,197,265,5392,773,268,352,187,239,1819,0.184354877176246,0.73024523160763,0.951351351351351,0.949238578680203,0.90188679245283,0.337351632047478
E02002197,Bingley Town,Bradford,Yorkshire and the Humber,1538,5539,450,490,288,589,7356,1558,5811,426,485,320,589,7631,1178,369,449,308,567,2871,0.202718981242471,0.866197183098592,0.925773195876289,0.9625,0.962648556876061,0.37622854147556
E02002198,Baildon South,Bradford,Yorkshire and the Humber,1422,4797,541,474,319,486,6617,1492,5224,508,555,338,527,7152,1155,425,504,322,508,2914,0.221094946401225,0.836614173228347,0.908108108108108,0.952662721893491,0.963946869070209,0.407438478747204
E02002199,Thackley & Esholt,Bradford,Yorkshire and the Humber,1112,4289,386,396,260,331,5662,1180,4643,426,387,262,378,6096,1091,354,358,251,363,2417,0.234977385311221,0.830985915492958,0.925064599483204,0.958015267175572,0.96031746031746,0.396489501312336
E02002200,Saltaire & Baildon West,Bradford,Yorkshire and the Humber,1614,5311,513,479,359,559,7221,1628,5827,518,539,384,598,7866,1336,441,509,368,570,3224,0.229277501287112,0.851351351351351,0.944341372912801,0.958333333333333,0.953177257525084,0.409865242817188
E02002201,Idle,Bradford,Yorkshire and the Humber,2447,7720,609,577,314,500,9720,2419,8219,652,594,376,505,10346,1796,555,560,352,480,3743,0.218518067891471,0.851226993865031,0.942760942760943,0.936170212765957,0.95049504950495,0.361782331335782
E02002202,Shipley Town,Bradford,Yorkshire and the Humber,1247,5037,298,249,213,332,6129,1257,5266,308,318,211,333,6436,1024,234,289,188,312,2047,0.194454994303076,0.75974025974026,0.908805031446541,0.890995260663507,0.936936936936937,0.3180546923555
E02002203,Windhill,Bradford,Yorkshire and the Humber,1685,4724,390,332,198,298,5942,1644,5240,407,361,211,269,6488,1047,321,324,198,249,2139,0.199809160305344,0.788697788697789,0.897506925207756,0.938388625592417,0.925650557620818,0.329685573366215
E02002204,"Cottingley, Harden & Wilsden",Bradford,Yorkshire and the Humber,1987,6686,776,792,545,749,9548,1933,7177,746,840,519,775,10057,1732,662,801,507,752,4454,0.241326459523478,0.887399463806971,0.953571428571429,0.976878612716763,0.970322580645161,0.442875609028537
E02002205,Haworth & Oxenhope,Bradford,Yorkshire and the Humber,1611,6128,671,709,360,443,8311,1485,6263,683,718,390,495,8549,1162,474,664,358,464,3122,0.185534089094683,0.693997071742313,0.924791086350975,0.917948717948718,0.937373737373737,0.365188910983741
E02002206,Wrose & Bolton Woods,Bradford,Yorkshire and the Humber,1809,5176,456,355,317,443,6747,1838,5685,458,390,300,430,7263,1327,379,360,284,414,2764,0.233421284080915,0.827510917030568,0.923076923076923,0.946666666666667,0.962790697674419,0.380558997659369
E02002207,Frizinghall & Heaton Grove,Bradford,Yorkshire and the Humber,1979,4780,257,198,131,263,5629,2014,5663,293,234,132,261,6583,980,192,185,115,226,1698,0.173053152039555,0.655290102389079,0.790598290598291,0.871212121212121,0.865900383141763,0.257937110739784
E02002208,Eccleshill,Bradford,Yorkshire and the Humber,1855,4799,381,337,257,412,6186,1937,5460,360,370,259,398,6847,1194,315,337,241,370,2457,0.218681318681319,0.875,0.910810810810811,0.930501930501931,0.92964824120603,0.358843289031693
E02002209,Ravenscliffe,Bradford,Yorkshire and the Humber,2196,4145,218,196,99,162,4820,2174,4793,231,200,109,132,5465,764,186,161,96,121,1328,0.159399123722095,0.805194805194805,0.805,0.880733944954129,0.916666666666667,0.243000914913083
E02002210,Bolton Road & Kings Road,Bradford,Yorkshire and the Humber,1863,4783,334,288,221,301,5927,1880,5259,348,334,194,382,6517,1047,292,305,174,350,2168,0.199087278950371,0.839080459770115,0.913173652694611,0.896907216494845,0.916230366492147,0.332668405708148
E02002211,Heaton Highgate,Bradford,Yorkshire and the Humber,1891,4588,296,195,148,237,5464,1961,5522,305,243,152,245,6467,945,229,204,129,208,1715,0.171133647229265,0.750819672131148,0.839506172839506,0.848684210526316,0.848979591836735,0.265192515849698
E02002212,Chellow Heights,Bradford,Yorkshire and the Humber,2655,5028,201,131,102,257,5719,3030,6252,228,137,98,226,6941,973,165,103,83,187,1511,0.155630198336532,0.723684210526316,0.751824817518248,0.846938775510204,0.827433628318584,0.217691975219709
E02002213,Cullingworth & Denholme,Bradford,Yorkshire and the Humber,1385,4468,454,431,277,329,5959,1396,4789,499,463,319,347,6417,979,440,437,306,328,2490,0.20442681144289,0.881763527054108,0.943844492440605,0.959247648902821,0.945244956772334,0.388031790556335
E02002214,Haigh Fold,Bradford,Yorkshire and the Humber,1482,3750,264,209,131,243,4597,1630,4237,292,235,153,239,5156,793,255,213,137,225,1623,0.187160726929431,0.873287671232877,0.906382978723404,0.895424836601307,0.941422594142259,0.31477889837083
E02002215,Toller Lane & Infirmary,Bradford,Yorkshire and the Humber,2732,6772,374,172,147,263,7728,2941,7950,431,211,136,258,8986,1018,255,154,107,192,1726,0.128050314465409,0.591647331786543,0.729857819905213,0.786764705882353,0.744186046511628,0.19207656354329
E02002216,Manningham & Lister Park,Bradford,Yorkshire and the Humber,2371,6110,343,201,120,223,6997,2716,7526,386,243,138,286,8579,924,231,175,100,191,1621,0.122774382141908,0.598445595854922,0.720164609053498,0.72463768115942,0.667832167832168,0.188949761044411
E02002217,Undercliffe,Bradford,Yorkshire and the Humber,3060,6153,301,188,138,273,7053,3045,7090,326,243,146,280,8085,863,227,192,128,239,1649,0.121720733427362,0.696319018404908,0.790123456790123,0.876712328767123,0.853571428571429,0.20395794681509
E02002218,Allerton,Bradford,Yorkshire and the Humber,2731,6004,363,408,226,323,7324,2744,6639,378,418,229,362,8026,1341,323,370,207,328,2569,0.201988251242657,0.854497354497355,0.885167464114833,0.903930131004367,0.906077348066298,0.320084724644904
E02002219,Girlington,Bradford,Yorkshire and the Humber,2569,5126,213,116,79,153,5687,2817,6299,237,139,91,161,6927,747,151,97,68,119,1182,0.118590252421019,0.637130801687764,0.697841726618705,0.747252747252747,0.739130434782609,0.170636639237765
E02002220,Thornbury,Bradford,Yorkshire and the Humber,2833,5680,236,160,112,151,6339,3021,7148,325,201,85,176,7935,922,223,152,67,130,1494,0.128987129266928,0.686153846153846,0.756218905472637,0.788235294117647,0.738636363636364,0.1882797731569
E02002221,Central Bradford & Barkerend West,Bradford,Yorkshire and the Humber,4377,11167,297,154,135,223,11976,4553,13637,369,212,129,244,14591,1465,220,148,104,165,2102,0.107428320011733,0.596205962059621,0.69811320754717,0.806201550387597,0.676229508196721,0.144061407717086
E02002222,Fairweather Green,Bradford,Yorkshire and the Humber,2577,5275,270,235,184,340,6304,2633,5921,332,278,179,368,7078,1020,251,252,158,316,1997,0.172268197939537,0.756024096385542,0.906474820143885,0.88268156424581,0.858695652173913,0.282141847979655
E02002223,Brown Royd,Bradford,Yorkshire and the Humber,2277,5115,235,121,80,138,5689,2613,6510,253,165,91,149,7168,654,165,123,61,99,1102,0.100460829493088,0.652173913043478,0.745454545454546,0.67032967032967,0.664429530201342,0.153738839285714
E02002224,Barkerend East,Bradford,Yorkshire and the Humber,3467,6626,229,122,127,208,7312,3536,8205,287,182,110,257,9041,854,175,138,78,179,1424,0.104082876294942,0.609756097560976,0.758241758241758,0.709090909090909,0.696498054474708,0.157504700807433
E02002225,Thornton,Bradford,Yorkshire and the Humber,1600,5048,504,419,311,373,6655,1722,5634,503,484,287,378,7286,1107,408,450,271,360,2596,0.196485623003195,0.811133200795229,0.929752066115702,0.944250871080139,0.952380952380952,0.356299752950865
E02002226,Shearbridge & University,Bradford,Yorkshire and the Humber,3485,10779,295,139,155,253,11621,3870,16027,367,217,130,308,17049,1169,216,153,88,234,1860,0.0729394147376303,0.588555858310627,0.705069124423963,0.676923076923077,0.75974025974026,0.109097307759986
E02002227,Broomfields & East Bowling,Bradford,Yorkshire and the Humber,1824,4241,159,140,95,146,4781,1858,4976,218,137,98,124,5553,623,144,114,81,101,1063,0.125200964630225,0.660550458715596,0.832116788321168,0.826530612244898,0.814516129032258,0.191428056906177
E02002228,Laisterdyke & Bowling,Bradford,Yorkshire and the Humber,2138,4687,268,252,140,256,5603,2074,5198,295,254,153,222,6122,957,245,224,135,200,1761,0.18410927279723,0.830508474576271,0.881889763779528,0.882352941176471,0.900900900900901,0.28765109441359
E02002229,Clayton,Bradford,Yorkshire and the Humber,1662,4718,402,322,254,340,6036,1627,5257,443,407,254,363,6724,1049,394,385,239,349,2416,0.19954346585505,0.889390519187359,0.945945945945946,0.940944881889764,0.961432506887052,0.35930993456276
E02002230,Holme Top,Bradford,Yorkshire and the Humber,2787,6272,280,112,72,157,6893,2715,7222,258,162,90,154,7886,830,143,104,72,118,1267,0.114926613126558,0.554263565891473,0.641975308641975,0.8,0.766233766233766,0.160664468678671
E02002231,Scholemoor,Bradford,Yorkshire and the Humber,3432,8148,520,379,290,408,9745,3417,9118,576,456,259,441,10850,1422,463,397,226,382,2890,0.155955253345032,0.803819444444445,0.870614035087719,0.872586872586873,0.866213151927438,0.266359447004608
E02002232,Great Horton & Brackenhill,Bradford,Yorkshire and the Humber,2119,4506,249,185,126,238,5304,2316,5327,261,210,118,222,6138,653,193,176,102,192,1316,0.122583067392529,0.739463601532567,0.838095238095238,0.864406779661017,0.864864864864865,0.214402085369827
E02002233,Canterbury,Bradford,Yorkshire and the Humber,3363,5766,216,148,121,179,6430,3324,7029,273,175,116,151,7744,1063,182,142,92,106,1585,0.151230616019348,0.666666666666667,0.811428571428571,0.793103448275862,0.701986754966887,0.20467458677686
E02002234,Holme Wood,Bradford,Yorkshire and the Humber,2559,4821,256,215,162,207,5661,2471,5405,296,223,152,204,6280,996,214,196,135,175,1716,0.18427382053654,0.722972972972973,0.878923766816144,0.888157894736842,0.857843137254902,0.273248407643312
E02002235,Bowling Park,Bradford,Yorkshire and the Humber,2251,4615,234,181,121,175,5326,2154,5306,252,180,109,177,6024,773,185,148,94,146,1346,0.145684131172258,0.734126984126984,0.822222222222222,0.862385321100918,0.824858757062147,0.223439575033201
E02002236,Wibsey St Enoch's,Bradford,Yorkshire and the Humber,1493,3705,254,271,143,320,4693,1547,4172,302,270,179,310,5233,826,259,248,172,283,1788,0.197986577181208,0.857615894039735,0.918518518518519,0.960893854748603,0.912903225806452,0.341677813873495
E02002237,Horton Bank,Bradford,Yorkshire and the Humber,2280,5236,318,302,192,353,6401,2276,5686,368,320,193,347,6914,1064,307,290,176,317,2154,0.187126275061555,0.834239130434783,0.90625,0.911917098445596,0.913544668587896,0.311541799247903
E02002238,Bankfoot,Bradford,Yorkshire and the Humber,1593,3824,279,230,150,226,4709,1631,4269,281,262,159,222,5193,808,241,236,140,197,1622,0.189271492152729,0.857651245551601,0.900763358778626,0.880503144654088,0.887387387387387,0.312343539379935
E02002239,Bierley & Tong,Bradford,Yorkshire and the Humber,2731,7014,425,427,203,319,8388,2646,7508,464,420,238,317,8947,1593,363,373,206,290,2825,0.2121736814065,0.782327586206897,0.888095238095238,0.865546218487395,0.914826498422713,0.315748295518051
E02002240,Queensbury,Bradford,Yorkshire and the Humber,2116,7040,610,495,328,426,8899,2188,7711,615,589,347,474,9736,1620,522,550,316,439,3447,0.210089482557386,0.848780487804878,0.933786078098472,0.910662824207493,0.926160337552743,0.354046836483155
E02002241,Buttershaw,Bradford,Yorkshire and the Humber,2987,7274,594,455,319,505,9147,3065,8250,558,537,320,472,10137,1665,488,485,297,437,3372,0.201818181818182,0.874551971326165,0.90316573556797,0.928125,0.925847457627119,0.332642793725954
E02002242,Low Moor,Bradford,Yorkshire and the Humber,1390,4766,479,455,312,441,6453,1424,5072,513,495,332,486,6898,1308,453,473,309,462,3005,0.25788643533123,0.883040935672515,0.955555555555556,0.930722891566265,0.950617283950617,0.435633516961438
E02002243,Wyke,Bradford,Yorkshire and the Humber,1971,5688,474,521,310,400,7393,2009,6328,512,542,354,420,8156,1401,444,505,339,392,3081,0.221396965865992,0.8671875,0.931734317343173,0.957627118644068,0.933333333333333,0.37775870524767
E02002244,Illingworth & Ogden,Calderdale,Yorkshire and the Humber,1128,3652,395,417,285,341,5090,1120,4084,365,402,277,320,5448,888,282,375,265,310,2120,0.21743388834476,0.772602739726028,0.932835820895522,0.956678700361011,0.96875,0.38913362701909
E02002245,Mixenden,Calderdale,Yorkshire and the Humber,1343,3341,249,231,123,141,4085,1439,3668,222,235,144,146,4415,673,147,196,134,126,1276,0.183478735005453,0.662162162162162,0.834042553191489,0.930555555555556,0.863013698630137,0.289014722536806
E02002246,Northowram & Shelf,Calderdale,Yorkshire and the Humber,1545,5723,650,611,438,614,8036,1545,6151,639,654,485,585,8514,1506,567,633,470,559,3735,0.244838237684929,0.887323943661972,0.967889908256881,0.969072164948454,0.955555555555556,0.438689217758985
E02002247,Hebden Bridge,Calderdale,Yorkshire and the Humber,1570,5784,637,585,300,367,7673,1474,6278,637,621,326,367,8229,1405,450,571,302,342,3070,0.22379738770309,0.706436420722135,0.919484702093398,0.92638036809816,0.931880108991826,0.373070847004496
E02002248,Wheatley & Ovenden West,Calderdale,Yorkshire and the Humber,1703,4935,363,350,234,242,6124,1775,5500,361,401,241,284,6787,1213,257,365,220,255,2310,0.220545454545455,0.71191135734072,0.910224438902743,0.912863070539419,0.897887323943662,0.340356564019449
E02002249,Ovenden East,Calderdale,Yorkshire and the Humber,1331,3554,208,236,146,155,4299,1479,4038,230,240,164,199,4871,782,168,214,152,183,1499,0.193660227835562,0.730434782608696,0.891666666666667,0.926829268292683,0.919597989949749,0.307739683843153
E02002250,Mytholmroyd & Cragg Vale,Calderdale,Yorkshire and the Humber,1436,5177,592,570,356,430,7125,1404,5640,550,566,374,468,7598,1269,414,515,354,445,2997,0.225,0.752727272727273,0.909893992932862,0.946524064171123,0.950854700854701,0.394445906817584
E02002251,Central Halifax & Boothtown,Calderdale,Yorkshire and the Humber,1412,5828,398,359,254,478,7317,1464,6247,415,383,266,429,7740,1111,307,339,233,400,2390,0.177845365775572,0.739759036144578,0.885117493472585,0.87593984962406,0.932400932400932,0.308785529715762
E02002252,Norton Tower & Mount Tabor,Calderdale,Yorkshire and the Humber,1437,3953,392,396,256,353,5350,1407,4250,368,391,283,361,5653,849,299,371,270,343,2132,0.199764705882353,0.8125,0.948849104859335,0.954063604240283,0.950138504155125,0.377144878825402
E02002253,Pellon West & Highroad Well,Calderdale,Yorkshire and the Humber,2568,5376,249,186,153,305,6269,2641,5936,263,198,162,216,6775,792,186,160,145,188,1471,0.133423180592992,0.707224334600761,0.808080808080808,0.895061728395062,0.87037037037037,0.217121771217712
E02002254,Hipperholme,Calderdale,Yorkshire and the Humber,1116,3777,374,384,249,382,5166,1098,3964,385,398,278,398,5423,926,348,380,267,382,2303,0.233602421796166,0.903896103896104,0.954773869346734,0.960431654676259,0.959798994974874,0.424672690392771
E02002255,Pellon East,Calderdale,Yorkshire and the Humber,2215,5067,235,139,127,306,5874,2344,6291,281,183,153,381,7289,745,165,120,116,288,1434,0.118423144174217,0.587188612099644,0.655737704918033,0.758169934640523,0.755905511811024,0.196734805871862
E02002256,Todmorden West & Cornholme,Calderdale,Yorkshire and the Humber,1856,5852,541,534,333,438,7698,1874,6199,557,561,379,420,8116,1694,347,486,342,392,3261,0.273269882239071,0.622980251346499,0.866310160427808,0.902374670184697,0.933333333333333,0.401798915722031
E02002257,King Cross,Calderdale,Yorkshire and the Humber,1919,4382,178,112,117,123,4912,1995,4885,231,138,98,130,5482,610,153,105,79,94,1041,0.124872057318321,0.662337662337662,0.760869565217391,0.806122448979592,0.723076923076923,0.189894199197373
E02002258,Clifton & Bailiff Bridge,Calderdale,Yorkshire and the Humber,1647,5792,538,467,318,456,7571,1603,5723,506,508,346,452,7535,1169,424,480,330,428,2831,0.204263498165298,0.837944664031621,0.944881889763779,0.953757225433526,0.946902654867257,0.375713337757133
E02002259,Savile Park,Calderdale,Yorkshire and the Humber,1418,4321,349,360,230,443,5703,1409,4702,374,359,246,451,6132,1086,313,330,233,423,2385,0.230965546575925,0.836898395721925,0.919220055710306,0.947154471544715,0.937915742793792,0.38894324853229
E02002260,Sowerby Bridge,Calderdale,Yorkshire and the Humber,1610,5974,561,521,323,380,7759,1548,6004,484,546,342,370,7746,1140,406,490,311,337,2684,0.189873417721519,0.838842975206612,0.897435897435897,0.909356725146199,0.910810810810811,0.346501420087787
E02002261,Southowram & Siddal,Calderdale,Yorkshire and the Humber,1561,5135,460,447,281,420,6743,1544,5439,452,449,298,357,6995,1228,391,410,282,341,2652,0.225776797205369,0.865044247787611,0.913140311804009,0.946308724832215,0.955182072829132,0.379127948534668
E02002262,Brighouse,Calderdale,Yorkshire and the Humber,1248,4892,411,503,382,515,6703,1191,4950,417,488,373,556,6784,930,342,463,353,521,2609,0.187878787878788,0.820143884892086,0.948770491803279,0.946380697050938,0.93705035971223,0.384581367924528
E02002263,Sowerby & Luddendenfoot,Calderdale,Yorkshire and the Humber,1259,3941,431,412,228,239,5251,1307,4415,417,389,245,249,5715,849,352,363,232,232,2028,0.192298980747452,0.844124700239808,0.933161953727506,0.946938775510204,0.931726907630522,0.354855643044619
E02002264,Skircoat Green,Calderdale,Yorkshire and the Humber,1295,4154,368,416,357,495,5790,1282,4369,376,437,342,495,6019,1159,338,411,322,474,2704,0.265278095674067,0.898936170212766,0.940503432494279,0.941520467836257,0.957575757575757,0.449244060475162
E02002265,Todmorden East & Walsden,Calderdale,Yorkshire and the Humber,960,3490,368,352,223,311,4744,956,3613,352,384,229,298,4876,1031,217,358,215,273,2094,0.285358427899253,0.616477272727273,0.932291666666667,0.938864628820961,0.916107382550335,0.429450369155045
E02002266,Rastrick East,Calderdale,Yorkshire and the Humber,901,3463,363,394,299,367,4886,923,3655,351,379,317,364,5066,698,305,362,302,338,2005,0.190971272229822,0.868945868945869,0.955145118733509,0.952681388012618,0.928571428571429,0.395775759968417
E02002267,Rastrick West,Calderdale,Yorkshire and the Humber,1429,4799,473,534,330,369,6505,1401,5124,467,532,362,410,6895,1065,418,500,346,379,2708,0.207845433255269,0.895074946466809,0.93984962406015,0.955801104972376,0.924390243902439,0.392748368382886
E02002268,Elland,Calderdale,Yorkshire and the Humber,2067,6541,503,546,381,587,8558,2006,6739,520,544,397,574,8774,1192,453,505,376,549,3075,0.176880842855023,0.871153846153846,0.928308823529412,0.947103274559194,0.956445993031359,0.350467289719626
E02002269,Greetland & Stainland,Calderdale,Yorkshire and the Humber,1750,5898,585,552,348,389,7772,1712,6127,562,576,390,407,8062,1159,512,535,373,385,2964,0.189162722376367,0.911032028469751,0.928819444444444,0.956410256410256,0.945945945945946,0.36765070702059
E02002270,"Ripponden, Rishworth & Barkisland",Calderdale,Yorkshire and the Humber,1670,5505,499,478,313,263,7058,1583,5775,535,484,359,340,7493,1007,482,460,351,326,2626,0.174372294372294,0.900934579439252,0.950413223140496,0.977715877437326,0.958823529411765,0.350460429734419
E02002271,Birkenshaw,Kirklees,Yorkshire and the Humber,1410,4291,366,411,299,506,5873,1412,4622,377,454,314,485,6252,1189,353,434,299,467,2742,0.257247944612722,0.936339522546419,0.955947136563877,0.952229299363057,0.962886597938144,0.438579654510557
E02002272,Birstall,Kirklees,Yorkshire and the Humber,1971,5911,481,540,362,424,7718,2003,6315,462,534,361,441,8113,1508,419,486,341,419,3173,0.238796516231196,0.906926406926407,0.910112359550562,0.944598337950139,0.950113378684807,0.391100702576112
E02002273,Scholes & Hunsworth,Kirklees,Yorkshire and the Humber,1247,4160,381,388,270,347,5546,1120,4100,367,399,263,336,5465,956,335,374,246,316,2227,0.233170731707317,0.912806539509537,0.93734335839599,0.935361216730038,0.940476190476191,0.407502287282708
E02002274,Gomersal,Kirklees,Yorkshire and the Humber,1442,4344,382,429,274,389,5818,1308,4362,376,373,275,364,5750,1151,333,356,266,348,2454,0.263869784502522,0.885638297872341,0.954423592493298,0.967272727272727,0.956043956043956,0.426782608695652
E02002275,Cleckheaton,Kirklees,Yorkshire and the Humber,1549,5315,450,468,330,490,7053,1608,5753,439,496,337,510,7535,1181,370,461,310,446,2768,0.205284199548062,0.842824601366743,0.929435483870968,0.919881305637982,0.874509803921569,0.367352355673524
E02002276,"Wilton Park, Carlinghow & Brookroyd",Kirklees,Yorkshire and the Humber,1614,4441,399,431,279,386,5936,1694,4889,365,406,290,286,6236,1039,324,380,277,271,2291,0.212517897320515,0.887671232876712,0.935960591133005,0.955172413793104,0.947552447552448,0.367382937780629
E02002277,Upper Batley & Soothill,Kirklees,Yorkshire and the Humber,1603,4234,258,290,212,301,5295,1503,4519,252,281,209,303,5564,804,207,263,198,288,1760,0.177915468023899,0.821428571428571,0.935943060498221,0.947368421052632,0.95049504950495,0.316319194823868
E02002278,Hightown & Hartshead Moor,Kirklees,Yorkshire and the Humber,1433,4066,365,414,234,289,5368,1379,4242,340,401,280,271,5534,988,303,381,267,242,2181,0.232909005186233,0.891176470588235,0.950124688279302,0.953571428571429,0.892988929889299,0.39410914347669
E02002279,"Liversedge, Littletown & Millbridge",Kirklees,Yorkshire and the Humber,1235,3849,329,312,238,280,5008,1282,4151,330,330,213,275,5299,930,292,301,203,260,1986,0.224042399421826,0.884848484848485,0.912121212121212,0.953051643192488,0.945454545454546,0.374787695791659
E02002280,Batley Central,Kirklees,Yorkshire and the Humber,1790,4319,289,209,171,218,5206,1613,4605,290,222,148,182,5447,765,224,192,130,157,1468,0.166123778501629,0.772413793103448,0.864864864864865,0.878378378378378,0.862637362637363,0.269506150174408
E02002281,Heckmondwike North,Kirklees,Yorkshire and the Humber,2678,7109,539,490,333,560,9031,2732,7615,514,503,347,525,9504,1549,425,471,315,437,3197,0.203414313854235,0.826848249027237,0.936381709741551,0.907780979827089,0.832380952380952,0.33638468013468
E02002282,Staincliffe & Healey,Kirklees,Yorkshire and the Humber,2025,4788,280,214,154,204,5640,1958,5145,273,218,148,193,5977,873,211,192,134,171,1581,0.169679300291545,0.772893772893773,0.880733944954129,0.905405405405405,0.886010362694301,0.264513970219174
E02002283,Batley Carr & Mount Pleasant,Kirklees,Yorkshire and the Humber,1670,5046,287,222,167,193,5915,1612,5350,361,235,131,183,6260,690,270,204,118,155,1437,0.128971962616822,0.74792243767313,0.868085106382979,0.900763358778626,0.846994535519126,0.229552715654952
E02002284,Shaw Cross & Hanging Heaton,Kirklees,Yorkshire and the Humber,1120,3766,364,320,221,342,5013,1146,3957,337,302,235,314,5145,922,310,284,227,303,2046,0.233004801617387,0.919881305637982,0.940397350993378,0.965957446808511,0.964968152866242,0.397667638483965
E02002285,"Heckmondwike Town, Norristhorpe & Roberttown",Kirklees,Yorkshire and the Humber,1457,4886,517,515,319,468,6705,1409,5083,457,508,346,447,6841,1272,422,485,335,421,2935,0.250245917765099,0.923413566739606,0.954724409448819,0.968208092485549,0.941834451901566,0.429030843443941
E02002286,Dewsbury Moor Upper,Kirklees,Yorkshire and the Humber,1701,4108,265,211,122,174,4880,1681,4375,274,229,107,178,5163,861,227,202,99,163,1552,0.1968,0.828467153284672,0.882096069868996,0.925233644859813,0.915730337078652,0.300600426108851
E02002287,Dewsbury Central & Westborough,Kirklees,Yorkshire and the Humber,1697,4886,271,223,131,255,5766,1692,5304,255,203,149,248,6159,797,198,176,132,216,1519,0.15026395173454,0.776470588235294,0.866995073891626,0.885906040268456,0.870967741935484,0.246630946582237
E02002288,Earlsheaton & Chickenley,Kirklees,Yorkshire and the Humber,2187,6068,425,436,272,425,7626,2251,6661,441,420,282,408,8212,1376,391,392,270,379,2808,0.206575589250863,0.886621315192744,0.933333333333333,0.957446808510638,0.928921568627451,0.34193862640039
E02002289,Dewsbury Moor Lower & Westtown,Kirklees,Yorkshire and the Humber,2107,4378,182,125,101,119,4905,2135,5012,192,156,100,154,5614,675,135,127,85,110,1132,0.134676775738228,0.703125,0.814102564102564,0.85,0.714285714285714,0.201638760242252
E02002290,Northorpe & Crossley,Kirklees,Yorkshire and the Humber,1116,3630,391,489,342,419,5271,1055,3729,396,439,370,439,5373,990,372,431,356,428,2577,0.265486725663717,0.939393939393939,0.981776765375854,0.962162162162162,0.9749430523918,0.479620323841429
E02002291,Battyeford,Kirklees,Yorkshire and the Humber,1275,3814,390,482,291,352,5329,1222,4074,376,403,338,354,5545,1042,345,386,328,348,2449,0.255768286696122,0.917553191489362,0.957816377171216,0.970414201183432,0.983050847457627,0.44165915238954
E02002292,Bradley & North Fixby,Kirklees,Yorkshire and the Humber,1032,3437,395,303,239,346,4720,936,3476,390,336,233,333,4768,807,357,317,221,308,2010,0.232163406214039,0.915384615384615,0.943452380952381,0.948497854077253,0.924924924924925,0.421560402684564
E02002293,Ravensthorpe,Kirklees,Yorkshire and the Humber,2831,5739,244,154,122,162,6421,2787,6680,244,189,108,154,7375,686,164,144,87,113,1194,0.102694610778443,0.672131147540984,0.761904761904762,0.805555555555556,0.733766233766234,0.161898305084746
E02002294,Dewsbury Savile Town & Thornhill Lees,Kirklees,Yorkshire and the Humber,2853,7001,436,265,190,260,8152,2755,7940,467,289,215,301,9212,1064,351,239,188,247,2089,0.134005037783375,0.751605995717345,0.826989619377163,0.874418604651163,0.820598006644518,0.226769431176726
E02002295,Deighton & Brackenhall,Kirklees,Yorkshire and the Humber,1958,4512,266,225,181,197,5381,2016,5014,277,215,179,213,5898,898,220,184,160,179,1641,0.179098524132429,0.794223826714801,0.855813953488372,0.893854748603352,0.84037558685446,0.27822990844354
E02002296,Mirfield Central & Hopton,Kirklees,Yorkshire and the Humber,1143,4055,336,509,318,591,5809,1078,4172,378,470,377,553,5950,1000,355,446,367,536,2704,0.239693192713327,0.939153439153439,0.948936170212766,0.973474801061008,0.969258589511754,0.454453781512605
E02002297,Cowcliffe & South Fixby,Kirklees,Yorkshire and the Humber,1284,4118,377,452,236,396,5579,1304,4570,415,424,276,366,6051,1016,357,390,256,339,2358,0.222319474835886,0.860240963855422,0.919811320754717,0.927536231884058,0.926229508196721,0.389687654933069
E02002298,Thornhill,Kirklees,Yorkshire and the Humber,1245,4055,400,396,269,380,5500,1233,4302,404,398,253,380,5737,900,359,378,242,363,2242,0.209205020920502,0.888613861386139,0.949748743718593,0.956521739130435,0.955263157894737,0.390796583580268
E02002299,Huddersfield Leeds Road & Fartown,Kirklees,Yorkshire and the Humber,1732,5179,178,145,129,206,5837,1773,6300,210,161,122,226,7019,694,151,135,105,184,1269,0.11015873015873,0.719047619047619,0.838509316770186,0.860655737704918,0.814159292035398,0.180794985040604
E02002300,North Lindley & Birchencliffe,Kirklees,Yorkshire and the Humber,1620,4697,439,413,349,539,6437,1694,5141,428,419,354,547,6889,1222,395,393,341,525,2876,0.237696946119432,0.922897196261682,0.937947494033413,0.963276836158192,0.959780621572212,0.417477137465525
E02002301,Birkby,Kirklees,Yorkshire and the Humber,2168,5531,254,153,141,229,6308,2334,6333,281,167,115,242,7138,805,192,119,93,189,1398,0.127111953260698,0.683274021352313,0.712574850299401,0.808695652173913,0.78099173553719,0.195853180162511
E02002302,Kirkheaton,Kirklees,Yorkshire and the Humber,1150,3813,342,426,256,291,5128,1146,3893,339,436,265,349,5282,913,296,408,254,336,2207,0.234523503724634,0.873156342182891,0.935779816513761,0.958490566037736,0.962750716332378,0.417834153729648
E02002303,Oakes & South Lindley,Kirklees,Yorkshire and the Humber,1227,4035,309,326,235,463,5368,1314,4341,326,322,235,394,5618,960,277,291,217,360,2105,0.221147201105736,0.849693251533742,0.903726708074534,0.923404255319149,0.913705583756345,0.374688501245995
E02002304,Edgerton & Marsh,Kirklees,Yorkshire and the Humber,1026,4916,281,221,181,278,5877,1029,5408,274,256,198,284,6420,945,228,231,184,249,1837,0.174741124260355,0.832116788321168,0.90234375,0.929292929292929,0.876760563380282,0.28613707165109
E02002305,Rawthorpe,Kirklees,Yorkshire and the Humber,1379,4030,266,196,143,238,4873,1357,4293,260,209,149,241,5152,852,225,192,143,215,1627,0.198462613556953,0.865384615384615,0.91866028708134,0.959731543624161,0.892116182572614,0.315799689440994
E02002306,"Scapegoat Hill, Outlane & West Golcar",Kirklees,Yorkshire and the Humber,1000,3805,400,370,221,326,5122,1020,4059,400,372,247,348,5426,1094,354,350,235,318,2351,0.269524513426952,0.885,0.940860215053764,0.951417004048583,0.913793103448276,0.433284187246591
E02002307,Dalton Long Lane,Kirklees,Yorkshire and the Humber,1041,3633,327,345,233,325,4863,1094,3768,306,311,239,304,4928,910,279,298,231,291,2009,0.241507430997877,0.911764705882353,0.958199356913183,0.96652719665272,0.957236842105263,0.407670454545455
E02002308,Longwood & Quarmby,Kirklees,Yorkshire and the Humber,1195,4084,347,299,232,293,5255,1237,4343,333,301,231,276,5484,1060,287,279,216,255,2097,0.244070918719779,0.861861861861862,0.926910299003322,0.935064935064935,0.923913043478261,0.382385120350109
E02002309,Paddock & Greenhead,Kirklees,Yorkshire and the Humber,1469,4661,248,252,128,304,5593,1478,5177,262,237,178,258,6112,820,208,208,154,222,1612,0.158392891636083,0.793893129770992,0.877637130801688,0.865168539325843,0.86046511627907,0.263743455497382
E02002310,Moldgreen & Ravensknowle Park,Kirklees,Yorkshire and the Humber,1084,3792,299,314,193,306,4904,1081,3886,271,282,206,318,4963,752,249,253,194,294,1742,0.193515182707154,0.918819188191882,0.897163120567376,0.941747572815534,0.924528301886792,0.350997380616563
E02002311,Golcar,Kirklees,Yorkshire and the Humber,1321,4066,361,345,169,280,5221,1268,4204,362,369,210,282,5427,1139,326,349,201,267,2282,0.2709324452902,0.900552486187845,0.94579945799458,0.957142857142857,0.946808510638298,0.420490141883177
E02002312,"Aspley, Longley & University",Kirklees,Yorkshire and the Humber,1314,8856,252,195,147,189,9639,1295,9523,276,207,155,202,10363,893,218,187,137,173,1608,0.0937729707025097,0.789855072463768,0.903381642512077,0.883870967741936,0.856435643564356,0.155167422561034
E02002313,Lockwood,Kirklees,Yorkshire and the Humber,2309,5392,186,150,138,176,6042,2235,6230,249,158,140,215,6992,714,183,120,107,156,1280,0.114606741573034,0.734939759036145,0.759493670886076,0.764285714285714,0.725581395348837,0.183066361556064
E02002314,Almondbury & Waterloo,Kirklees,Yorkshire and the Humber,1029,3432,336,376,291,437,4872,1039,3495,353,386,310,431,4975,749,321,358,298,404,2130,0.214306151645207,0.909348441926346,0.927461139896373,0.961290322580645,0.937354988399072,0.428140703517588
E02002315,Cowlersley & Milnsbridge,Kirklees,Yorkshire and the Humber,1350,4555,280,261,155,228,5479,1240,4507,289,282,163,213,5454,1028,259,253,157,197,1894,0.228089638340359,0.896193771626298,0.897163120567376,0.96319018404908,0.924882629107981,0.347268060139347
E02002316,"Lepton, Grange Moor & Flockton",Kirklees,Yorkshire and the Humber,1146,3733,433,494,298,401,5359,1076,4083,370,494,302,425,5674,844,327,475,293,406,2345,0.206710751898114,0.883783783783784,0.961538461538461,0.970198675496689,0.955294117647059,0.413288685230878
E02002317,Crosland Moor,Kirklees,Yorkshire and the Humber,1933,4422,295,239,253,340,5549,1850,4868,341,269,212,323,6013,946,292,245,190,297,1970,0.194330320460148,0.856304985337243,0.910780669144981,0.89622641509434,0.919504643962848,0.327623482454682
E02002318,"Primrose Hill, Newsome & Berry Brow",Kirklees,Yorkshire and the Humber,1094,3922,359,394,283,353,5311,1092,4152,309,415,261,362,5499,863,276,391,247,338,2115,0.207851637764933,0.893203883495146,0.942168674698795,0.946360153256705,0.933701657458563,0.384615384615385
E02002319,Slaithwaite & Linthwaite,Kirklees,Yorkshire and the Humber,1352,4209,362,321,224,317,5433,1331,4572,345,359,235,304,5815,891,294,334,229,288,2036,0.19488188976378,0.852173913043478,0.930362116991643,0.974468085106383,0.947368421052632,0.350128976784179
E02002320,Netherton & South Crosland,Kirklees,Yorkshire and the Humber,933,3605,485,442,286,422,5240,900,3737,431,461,323,436,5388,895,397,436,307,412,2447,0.23949692266524,0.921113689095128,0.945770065075922,0.95046439628483,0.944954128440367,0.454157386785449
E02002321,Kirkburton & Farnley Tyas,Kirklees,Yorkshire and the Humber,1102,4382,445,444,268,316,5855,1061,4815,450,457,315,337,6374,787,387,428,306,320,2228,0.163447559709242,0.86,0.936542669584245,0.971428571428571,0.949554896142433,0.34954502667085
E02002322,Marsden & Pole Moor,Kirklees,Yorkshire and the Humber,1122,3918,442,417,251,279,5307,1147,4058,416,442,281,310,5507,761,375,409,268,291,2104,0.187530803351405,0.901442307692308,0.925339366515837,0.953736654804271,0.938709677419355,0.382059197385146
E02002323,Honley & Brockholes,Kirklees,Yorkshire and the Humber,1528,4905,548,579,385,512,6929,1394,4998,496,619,396,521,7030,1028,459,603,387,502,2979,0.205682272909164,0.925403225806452,0.974151857835218,0.977272727272727,0.963531669865643,0.42375533428165
E02002324,Emley & Skelmanthorpe,Kirklees,Yorkshire and the Humber,1155,3857,438,538,355,383,5571,1106,3988,422,539,386,391,5726,765,359,522,376,377,2399,0.191825476429288,0.850710900473934,0.968460111317254,0.974093264248705,0.964194373401535,0.418966119455117
E02002325,Meltham,Kirklees,Yorkshire and the Humber,1678,5232,520,620,382,520,7274,1615,5599,500,608,391,529,7627,1122,447,588,382,502,3041,0.200392927308448,0.894,0.967105263157895,0.976982097186701,0.948960302457467,0.39871509112364
E02002326,Shelley & Shepley,Kirklees,Yorkshire and the Humber,1214,3695,348,435,253,313,5044,1109,3857,364,395,302,293,5211,750,318,377,291,279,2015,0.194451646357273,0.873626373626374,0.954430379746835,0.963576158940397,0.95221843003413,0.386682018806371
E02002327,"Denby Dale, Cumberworth & Clayton West",Kirklees,Yorkshire and the Humber,1864,5806,635,663,437,585,8126,1696,6021,628,659,493,615,8416,1096,528,633,474,591,3322,0.182029563195482,0.840764331210191,0.960546282245827,0.961460446247465,0.960975609756098,0.39472433460076
E02002328,Upperthong & Holmbridge,Kirklees,Yorkshire and the Humber,1178,4193,514,450,313,428,5898,1151,4519,491,474,340,431,6255,865,453,452,323,412,2505,0.191414029652578,0.922606924643584,0.953586497890295,0.95,0.955916473317865,0.400479616306954
E02002329,"Holmfirth, New Mill & Hepworth",Kirklees,Yorkshire and the Humber,2272,7350,863,812,440,486,9951,2130,7965,802,854,540,479,10640,1548,722,811,518,465,4064,0.194350282485876,0.900249376558604,0.949648711943794,0.959259259259259,0.970772442588727,0.381954887218045
E02002330,Wetherby West,Leeds,Yorkshire and the Humber,1050,3520,476,629,385,512,5522,1110,4130,511,607,468,537,6253,683,455,578,457,523,2696,0.165375302663438,0.89041095890411,0.952224052718287,0.976495726495726,0.973929236499069,0.431153046537662
E02002331,Wetherby East & Thorp Arch,Leeds,Yorkshire and the Humber,989,4159,369,461,356,695,6040,1030,5060,397,464,407,737,7065,684,307,434,379,696,2500,0.135177865612648,0.773299748110831,0.935344827586207,0.931203931203931,0.944369063772049,0.353857041755131
E02002332,Otley North,Leeds,Yorkshire and the Humber,1136,3482,445,407,293,380,5007,1238,4073,414,445,325,384,5641,885,384,420,308,371,2368,0.217284556837712,0.927536231884058,0.943820224719101,0.947692307692308,0.966145833333333,0.419783726289665
E02002333,Otley South,Leeds,Yorkshire and the Humber,1206,4408,538,531,390,564,6431,1213,4919,541,590,394,583,7027,1135,493,564,373,561,3126,0.230737954868876,0.911275415896488,0.95593220338983,0.946700507614213,0.962264150943396,0.444855557136758
E02002334,Boston Spa & Bramham,Leeds,Yorkshire and the Humber,1352,3800,449,554,413,542,5758,1409,4422,476,539,465,557,6459,738,431,524,442,535,2670,0.166892808683853,0.90546218487395,0.972170686456401,0.950537634408602,0.960502692998205,0.413376683697167
E02002335,"Collingham, Rigton & Harewood",Leeds,Yorkshire and the Humber,1339,4193,500,569,394,505,6161,1327,4637,512,573,458,560,6740,915,466,559,446,544,2930,0.197325857235281,0.91015625,0.975567190226876,0.973799126637555,0.971428571428571,0.434718100890208
E02002336,Bramhope & Pool-in-Wharfedale,Leeds,Yorkshire and the Humber,1263,3710,385,453,293,492,5333,1288,4277,394,479,351,522,6023,896,368,455,331,499,2549,0.20949263502455,0.934010152284264,0.949895615866388,0.943019943019943,0.955938697318008,0.423211024406442
E02002337,Guiseley North & West,Leeds,Yorkshire and the Humber,1429,4490,359,450,250,410,5959,1418,4824,415,493,312,433,6477,755,387,478,299,412,2331,0.15650912106136,0.932530120481928,0.969574036511156,0.958333333333333,0.951501154734411,0.359888837424734
E02002338,Guiseley East & South,Leeds,Yorkshire and the Humber,1370,3974,344,399,291,439,5447,1434,4486,383,437,306,469,6081,739,338,417,297,449,2240,0.164734730271957,0.882506527415144,0.954233409610984,0.970588235294118,0.957356076759062,0.368360467028449
E02002339,Yeadon West,Leeds,Yorkshire and the Humber,1030,3284,311,274,183,269,4321,1054,3659,307,316,206,321,4809,678,261,291,194,303,1727,0.185296529106313,0.850162866449512,0.920886075949367,0.941747572815534,0.94392523364486,0.35911831981701
E02002340,Yeadon East,Leeds,Yorkshire and the Humber,928,3220,376,387,280,363,4626,899,3636,405,425,302,416,5184,675,347,407,288,404,2121,0.185643564356436,0.85679012345679,0.957647058823529,0.95364238410596,0.971153846153846,0.409143518518519
E02002341,Alwoodley,Leeds,Yorkshire and the Humber,1413,3963,480,479,316,567,5805,1509,4530,466,498,357,571,6422,1282,433,469,335,547,3066,0.283002207505519,0.929184549356223,0.941767068273092,0.938375350140056,0.957968476357268,0.47742136406104
E02002342,Cookridge & Holt Park,Leeds,Yorkshire and the Humber,1049,3113,339,378,244,456,4530,1093,3688,360,385,268,446,5147,795,323,371,256,425,2170,0.21556399132321,0.897222222222222,0.963636363636364,0.955223880597015,0.952914798206278,0.421604818340781
E02002343,Yeadon South,Leeds,Yorkshire and the Humber,1159,3482,332,286,184,274,4558,1155,3937,324,338,225,269,5093,683,274,320,217,263,1757,0.173482346964694,0.845679012345679,0.946745562130177,0.964444444444444,0.977695167286245,0.344983310426075
E02002344,Primley Park & Wigton Moor,Leeds,Yorkshire and the Humber,1395,4416,454,448,304,549,6171,1555,5154,406,510,318,589,6977,1315,357,489,298,540,2999,0.255141637563058,0.879310344827586,0.958823529411765,0.937106918238994,0.916808149405773,0.429840905833453
E02002345,Adel,Leeds,Yorkshire and the Humber,1079,3145,389,392,225,405,4556,1144,3870,395,418,242,399,5324,954,369,404,236,383,2346,0.246511627906977,0.934177215189873,0.966507177033493,0.975206611570248,0.959899749373434,0.440646130728775
E02002346,Tinshill,Leeds,Yorkshire and the Humber,1197,3609,294,288,166,288,4645,1284,4181,303,299,188,308,5279,817,249,274,182,288,1810,0.195407797177709,0.821782178217822,0.916387959866221,0.968085106382979,0.935064935064935,0.342867967418072
E02002347,Moor Allerton,Leeds,Yorkshire and the Humber,1560,3729,278,292,136,283,4718,1624,4311,295,275,159,272,5312,1099,259,256,151,253,2018,0.254929250753885,0.877966101694915,0.930909090909091,0.949685534591195,0.930147058823529,0.379894578313253
E02002348,Lawnswood & Ireland Wood,Leeds,Yorkshire and the Humber,1254,3767,332,286,199,378,4962,1293,4303,358,333,214,384,5592,864,298,309,193,364,2028,0.200790146409482,0.832402234636871,0.927927927927928,0.901869158878505,0.947916666666667,0.362660944206009
E02002349,Roundhay Park & Slaid Hill,Leeds,Yorkshire and the Humber,1074,3589,305,283,175,326,4678,1164,4128,317,310,223,334,5312,989,272,277,203,312,2053,0.239583333333333,0.858044164037855,0.893548387096774,0.910313901345291,0.934131736526946,0.38648343373494
E02002350,Horsforth West,Leeds,Yorkshire and the Humber,1170,3410,305,370,295,484,4864,1223,3978,282,374,315,510,5459,783,250,361,304,498,2196,0.19683257918552,0.886524822695036,0.96524064171123,0.965079365079365,0.976470588235294,0.402271478292728
E02002351,"Scarcroft, Shadwell & Scholes",Leeds,Yorkshire and the Humber,900,3012,380,367,277,410,4446,1004,3422,355,401,289,429,4896,869,322,388,284,417,2280,0.253945061367621,0.907042253521127,0.967581047381546,0.982698961937716,0.972027972027972,0.465686274509804
E02002352,Moortown,Leeds,Yorkshire and the Humber,1438,4627,444,334,236,337,5978,1546,5357,419,383,288,434,6881,1237,363,356,259,396,2611,0.230912824341982,0.866348448687351,0.929503916449086,0.899305555555556,0.912442396313364,0.379450661241099
E02002353,Roundhay West,Leeds,Yorkshire and the Humber,1323,3707,297,218,120,274,4616,1382,4387,335,260,162,221,5365,1086,293,236,146,198,1959,0.247549578299521,0.874626865671642,0.907692307692308,0.901234567901234,0.895927601809955,0.365144454799627
E02002354,Carr Manor,Leeds,Yorkshire and the Humber,1568,4757,363,309,273,432,6134,1742,5647,399,346,261,458,7111,1319,342,314,233,430,2638,0.233575349743227,0.857142857142857,0.907514450867052,0.89272030651341,0.938864628820961,0.370974546477289
E02002356,Horsforth South & Rawdon,Leeds,Yorkshire and the Humber,1779,5081,394,424,266,380,6545,1966,5927,409,467,303,426,7532,1100,359,445,292,408,2604,0.185591361565716,0.877750611246944,0.952890792291221,0.963696369636964,0.957746478873239,0.345724907063197
E02002357,Horsforth East,Leeds,Yorkshire and the Humber,1560,4936,368,376,228,447,6355,1639,5423,372,389,259,425,6868,1045,296,359,245,416,2361,0.192697768762678,0.795698924731183,0.922879177377892,0.945945945945946,0.978823529411765,0.343768200349447
E02002358,Whinmoor,Leeds,Yorkshire and the Humber,1623,4632,463,423,308,352,6178,1794,5432,498,480,276,397,7083,1250,416,446,257,376,2745,0.230117820324006,0.835341365461847,0.929166666666667,0.931159420289855,0.947103274559194,0.387547649301144
E02002359,"Aberford, Barwick & Thorner",Leeds,Yorkshire and the Humber,1081,3719,391,457,333,468,5368,1064,4038,397,461,359,485,5740,826,364,445,347,467,2449,0.20455671124319,0.916876574307305,0.96529284164859,0.966573816155989,0.962886597938144,0.426655052264808
E02002360,Meanwood,Leeds,Yorkshire and the Humber,1320,4403,274,226,162,311,5376,1301,4874,273,252,190,304,5893,1190,241,225,174,292,2122,0.244152646696758,0.882783882783883,0.892857142857143,0.91578947368421,0.960526315789474,0.360088240285084
E02002361,Gledhow,Leeds,Yorkshire and the Humber,1318,3669,292,192,121,294,4568,1377,4252,272,226,128,241,5119,995,222,203,119,224,1763,0.234007525870179,0.816176470588235,0.898230088495575,0.9296875,0.929460580912863,0.344403203750733
E02002362,Hawksworth & West Park,Leeds,Yorkshire and the Humber,1628,5013,335,275,192,301,6116,1634,5823,335,303,195,270,6926,1294,279,280,178,251,2282,0.222222222222222,0.832835820895522,0.924092409240924,0.912820512820513,0.92962962962963,0.329483107132544
E02002363,Chapel Allerton North,Leeds,Yorkshire and the Humber,886,4825,272,244,151,340,5832,1001,5648,323,303,206,311,6791,1278,266,278,186,278,2286,0.226274787535411,0.823529411764706,0.917491749174918,0.902912621359223,0.893890675241158,0.336621999705493
E02002364,Seacroft North & Monkswood,Leeds,Yorkshire and the Humber,1192,3537,267,230,161,321,4516,1276,4160,297,290,148,351,5246,868,218,253,130,317,1786,0.208653846153846,0.734006734006734,0.872413793103448,0.878378378378378,0.903133903133903,0.340449866565002
E02002366,Lady Wood & Oakwood,Leeds,Yorkshire and the Humber,1754,4848,355,346,254,510,6313,1959,5821,368,374,287,507,7357,1124,297,333,256,454,2464,0.193093970108229,0.807065217391304,0.890374331550802,0.89198606271777,0.895463510848126,0.334919124643197
E02002367,Meanwood South & Sugarwell,Leeds,Yorkshire and the Humber,1554,3928,196,172,120,203,4619,1575,5013,204,215,128,233,5793,1011,151,180,102,191,1635,0.201675643327349,0.740196078431373,0.837209302325582,0.796875,0.819742489270386,0.282237182806836
E02002368,Calverley & Farsley North,Leeds,Yorkshire and the Humber,1732,4988,425,449,295,392,6549,1768,5566,430,466,314,438,7214,1149,388,437,299,422,2695,0.206431908012936,0.902325581395349,0.937768240343348,0.952229299363057,0.963470319634703,0.37357915164957
E02002369,Hollin Park & Fearnville,Leeds,Yorkshire and the Humber,1855,4517,268,244,179,282,5490,1991,5564,295,249,207,257,6572,863,225,216,185,229,1718,0.15510424155284,0.76271186440678,0.867469879518072,0.893719806763285,0.891050583657588,0.261412051125989
E02002370,Swarcliffe,Leeds,Yorkshire and the Humber,1795,4246,285,303,155,268,5257,1871,4713,278,293,204,271,5759,995,222,265,187,258,1927,0.211118183747083,0.798561151079137,0.904436860068259,0.916666666666667,0.952029520295203,0.334606702552527
E02002371,Chapel Allerton South & Chapeltown,Leeds,Yorkshire and the Humber,2397,6797,330,180,213,298,7818,2551,8853,413,263,202,411,10142,1301,262,202,145,294,2204,0.146955834180504,0.634382566585956,0.768060836501901,0.717821782178218,0.715328467153285,0.217314139223033
E02002373,Headingley,Leeds,Yorkshire and the Humber,346,8736,113,114,67,143,9173,346,7225,138,118,81,126,7688,832,101,104,78,114,1229,0.115155709342561,0.731884057971015,0.88135593220339,0.962962962962963,0.904761904761905,0.159859521331946
E02002374,Kirkstall,Leeds,Yorkshire and the Humber,1067,4876,280,228,157,227,5768,1273,6005,269,245,162,216,6897,944,225,221,152,205,1747,0.157202331390508,0.836431226765799,0.902040816326531,0.938271604938272,0.949074074074074,0.253298535595186
E02002375,Bramley Fall,Leeds,Yorkshire and the Humber,1399,4219,252,155,109,137,4872,1537,5050,271,193,108,146,5768,816,226,177,98,131,1448,0.161584158415842,0.833948339483395,0.917098445595855,0.907407407407407,0.897260273972603,0.251040221914008
E02002376,Gipton North,Leeds,Yorkshire and the Humber,2418,4777,160,147,116,170,5370,2447,6057,196,171,119,222,6765,977,138,141,95,177,1528,0.161300974079577,0.704081632653061,0.824561403508772,0.798319327731092,0.797297297297297,0.225868440502587
E02002377,Harehills North,Leeds,Yorkshire and the Humber,2335,5023,174,102,96,133,5528,2689,7581,224,152,83,151,8191,917,129,91,59,100,1296,0.120960295475531,0.575892857142857,0.598684210526316,0.710843373493976,0.662251655629139,0.158222439262605
E02002379,Seacroft South,Leeds,Yorkshire and the Humber,1629,3316,183,178,118,134,3929,1702,4203,190,186,106,136,4821,767,153,160,95,124,1299,0.182488698548656,0.805263157894737,0.860215053763441,0.89622641509434,0.911764705882353,0.269446172993155
E02002380,Bramley Park North,Leeds,Yorkshire and the Humber,848,3276,305,259,176,297,4313,945,3753,318,307,179,288,4845,738,284,284,169,274,1749,0.196642685851319,0.893081761006289,0.925081433224756,0.94413407821229,0.951388888888889,0.360990712074303
E02002381,Rodley & Stanningley Park,Leeds,Yorkshire and the Humber,1030,4095,313,238,160,215,5021,1120,4343,305,301,153,234,5336,886,273,281,143,223,1806,0.204006447156344,0.895081967213115,0.933554817275748,0.934640522875817,0.952991452991453,0.338455772113943
E02002382,Harehills South,Leeds,Yorkshire and the Humber,3024,5210,116,78,61,90,5555,3472,7293,161,86,71,145,7756,619,71,55,48,104,897,0.0848759084053202,0.440993788819876,0.63953488372093,0.676056338028169,0.717241379310345,0.115652398143373
E02002383,Hyde Park,Leeds,Yorkshire and the Humber,495,7763,86,51,37,35,7972,485,6915,79,59,31,43,7127,609,57,45,27,35,773,0.0880694143167028,0.721518987341772,0.76271186440678,0.870967741935484,0.813953488372093,0.108460782938123
E02002384,Woodhouse & Little London,Leeds,Yorkshire and the Humber,2169,10430,227,180,88,160,11085,2616,16227,243,195,127,169,16961,1078,175,149,109,140,1651,0.0664324890614408,0.720164609053498,0.764102564102564,0.858267716535433,0.828402366863905,0.0973409586698897
E02002385,Burley,Leeds,Yorkshire and the Humber,873,7405,155,121,95,108,7884,862,8517,153,136,82,133,9021,903,111,115,72,122,1323,0.106023247622402,0.725490196078431,0.845588235294118,0.878048780487805,0.917293233082707,0.146657798470236
E02002386,Cross Gates East & Manston,Leeds,Yorkshire and the Humber,1364,4924,563,595,446,647,7175,1400,5569,572,651,478,740,8010,1360,511,625,454,708,3658,0.244209014185671,0.893356643356643,0.960061443932412,0.94979079497908,0.956756756756757,0.456679151061174
E02002387,Bramley Park South,Leeds,Yorkshire and the Humber,1209,3726,193,199,151,220,4489,1305,4345,232,213,155,216,5161,866,200,200,142,198,1606,0.199309551208285,0.862068965517241,0.938967136150235,0.916129032258065,0.916666666666667,0.311180003875218
E02002388,Bramley East,Leeds,Yorkshire and the Humber,1716,4981,257,264,130,268,5900,1864,5829,272,271,152,275,6799,1051,234,251,138,255,1929,0.180305369703208,0.860294117647059,0.92619926199262,0.907894736842105,0.927272727272727,0.283718193852037
E02002389,Gipton South & Killingbeck Park,Leeds,Yorkshire and the Humber,1949,4303,273,240,192,317,5325,2106,5129,290,272,180,270,6141,963,200,231,157,238,1789,0.187755897835835,0.689655172413793,0.849264705882353,0.872222222222222,0.881481481481482,0.291320631818922
E02002390,Cross Gates West & Killingbeck,Leeds,Yorkshire and the Humber,1252,4066,303,268,186,270,5093,1298,4736,325,289,188,257,5795,987,245,272,179,237,1920,0.208403716216216,0.753846153846154,0.941176470588235,0.952127659574468,0.922178988326848,0.331320103537532
E02002391,"Farsley South, Stanningley & Pudsey North West",Leeds,Yorkshire and the Humber,1379,4846,340,306,207,334,6033,1410,5369,407,398,235,346,6755,988,354,370,218,325,2255,0.184019370460048,0.86977886977887,0.92964824120603,0.927659574468085,0.939306358381503,0.333826794966691
E02002392,University & Little Woodhouse,Leeds,Yorkshire and the Humber,585,10640,87,65,39,52,10883,643,14719,90,69,36,59,14973,943,58,55,28,45,1129,0.064066852367688,0.644444444444445,0.797101449275362,0.777777777777778,0.76271186440678,0.0754023909704134
E02002393,Lincoln Green & St James,Leeds,Yorkshire and the Humber,2502,6186,174,139,88,143,6730,2749,7799,231,166,102,170,8468,1065,138,118,81,126,1528,0.136555968713938,0.597402597402597,0.710843373493976,0.794117647058824,0.741176470588235,0.180444024563061
E02002394,Burmantofts,Leeds,Yorkshire and the Humber,2515,5130,201,192,131,152,5806,2569,6340,214,189,133,141,7017,889,148,159,115,122,1433,0.140220820189274,0.691588785046729,0.841269841269841,0.864661654135338,0.865248226950355,0.204218326920336
E02002395,New Pudsey,Leeds,Yorkshire and the Humber,1485,4192,305,271,221,368,5357,1673,4787,351,313,210,373,6034,1006,308,286,201,352,2153,0.210152496344266,0.877492877492878,0.913738019169329,0.957142857142857,0.943699731903485,0.356811402055022
E02002396,Bramley South & Upper Armley,Leeds,Yorkshire and the Humber,1513,5944,362,335,236,385,7262,1592,6618,391,382,229,399,8019,1216,345,353,215,376,2505,0.183741311574494,0.882352941176471,0.924083769633508,0.938864628820961,0.942355889724311,0.312383090160868
E02002397,Pudsey North East,Leeds,Yorkshire and the Humber,1473,4699,377,375,242,328,6021,1478,5173,388,379,253,351,6544,940,349,357,240,339,2225,0.181712739222888,0.899484536082474,0.941952506596306,0.948616600790514,0.965811965811966,0.340006112469438
E02002398,Temple Newsam & Graveleythorpe,Leeds,Yorkshire and the Humber,1112,4211,451,468,374,562,6066,1117,4761,457,477,364,605,6664,1247,398,449,343,577,3014,0.261919764755304,0.87089715536105,0.941299790356394,0.942307692307692,0.953719008264463,0.452280912364946
E02002399,Osmondthorpe & Neville Hill,Leeds,Yorkshire and the Humber,1493,3836,250,211,128,203,4628,1647,4583,270,246,122,193,5414,791,187,216,109,173,1476,0.172594370499673,0.692592592592593,0.878048780487805,0.89344262295082,0.896373056994819,0.272626523827115
E02002400,Armley & New Wortley,Leeds,Yorkshire and the Humber,1909,6105,245,219,132,199,6900,2031,8236,255,206,150,218,9065,897,197,178,124,189,1585,0.10891209324915,0.772549019607843,0.864077669902913,0.826666666666667,0.86697247706422,0.174848317705461
E02002401,Halton Moor,Leeds,Yorkshire and the Humber,1887,3879,253,214,156,181,4683,1982,4612,246,243,146,200,5447,868,174,213,132,175,1562,0.188204683434519,0.707317073170732,0.876543209876543,0.904109589041096,0.875,0.286763355975767
E02002402,"Colton, Austhorpe & Whitkirk",Leeds,Yorkshire and the Humber,843,3469,291,317,209,298,4584,890,3930,311,335,241,405,5222,978,287,323,232,393,2213,0.248854961832061,0.922829581993569,0.964179104477612,0.962655601659751,0.97037037037037,0.42378399080812
E02002403,Garforth West,Leeds,Yorkshire and the Humber,951,3513,327,414,280,500,5034,948,3944,289,444,336,574,5587,685,258,429,326,555,2253,0.17368154158215,0.892733564013841,0.966216216216216,0.970238095238095,0.966898954703833,0.40325756219796
E02002404,East End Park & Richmond Hill,Leeds,Yorkshire and the Humber,1997,8046,256,237,139,133,8811,2030,8261,304,223,145,178,9111,1339,220,188,128,158,2033,0.162086914417141,0.723684210526316,0.84304932735426,0.882758620689655,0.887640449438202,0.223136867522775
E02002405,Pudsey South West,Leeds,Yorkshire and the Humber,1884,5152,403,407,319,538,6819,1935,5797,438,400,349,545,7529,1149,382,380,339,527,2777,0.198205968604451,0.872146118721461,0.95,0.97134670487106,0.96697247706422,0.368840483463939
E02002406,Garforth East,Leeds,Yorkshire and the Humber,1212,3907,440,524,364,422,5657,1270,4543,401,550,425,430,6349,850,348,528,416,421,2563,0.187101034558662,0.86783042394015,0.96,0.978823529411765,0.97906976744186,0.403685619782643
E02002407,Farnley East,Leeds,Yorkshire and the Humber,1616,4103,200,176,158,234,4871,1643,4612,227,189,148,224,5400,886,185,174,138,199,1582,0.192107545533391,0.814977973568282,0.920634920634921,0.932432432432432,0.888392857142857,0.292962962962963
E02002408,Pudsey South East,Leeds,Yorkshire and the Humber,1349,4489,386,382,236,370,5863,1384,5070,402,380,293,409,6554,962,346,354,279,391,2332,0.18974358974359,0.860696517412935,0.931578947368421,0.95221843003413,0.9559902200489,0.355813243820568
E02002409,Farnley West & Gamble Hill,Leeds,Yorkshire and the Humber,1185,3669,280,267,207,277,4700,1270,4320,302,299,201,287,5409,1094,267,278,190,275,2104,0.253240740740741,0.884105960264901,0.929765886287625,0.945273631840796,0.958188153310105,0.388981327417268
E02002410,Wortley,Leeds,Yorkshire and the Humber,1192,4300,336,295,217,311,5459,1209,4818,353,324,231,338,6064,967,303,309,214,317,2110,0.200705687007057,0.858356940509915,0.953703703703704,0.926406926406927,0.937869822485207,0.347955145118734
E02002411,Holbeck,Leeds,Yorkshire and the Humber,1865,6285,198,181,98,188,6950,2008,7297,205,174,87,197,7960,736,144,138,78,183,1279,0.100863368507606,0.702439024390244,0.793103448275862,0.896551724137931,0.928934010152284,0.160678391959799
E02002412,New Farnley & Lower Wortley,Leeds,Yorkshire and the Humber,1399,4488,313,298,209,297,5605,1452,5096,318,316,202,288,6220,1320,288,303,195,281,2387,0.259026687598116,0.905660377358491,0.958860759493671,0.965346534653465,0.975694444444444,0.383762057877814
E02002414,Beeston Hill & Hunslet Moor,Leeds,Yorkshire and the Humber,1802,4308,164,195,133,215,5015,1875,5320,207,177,127,183,6014,602,150,154,113,169,1188,0.113157894736842,0.72463768115942,0.870056497175141,0.889763779527559,0.923497267759563,0.197539075490522
E02002415,Cross Flats Park & Garnets,Leeds,Yorkshire and the Humber,2106,5049,171,80,67,85,5452,2428,7431,208,97,52,90,7878,478,119,59,38,61,755,0.0643251244785359,0.572115384615385,0.608247422680412,0.730769230769231,0.677777777777778,0.0958365067275958
E02002416,"Garforth South, Swillington & Little Preston",Leeds,Yorkshire and the Humber,1188,3817,382,527,387,483,5596,1215,4190,384,479,438,510,6001,836,338,450,423,486,2533,0.199522673031026,0.880208333333333,0.939457202505219,0.965753424657534,0.952941176470588,0.422096317280453
E02002417,"Kippax East, Micklefield & Allerton Bywater",Leeds,Yorkshire and the Humber,1279,3964,358,422,294,354,5392,1377,4392,365,415,328,403,5903,891,316,402,317,388,2314,0.202868852459016,0.865753424657534,0.968674698795181,0.966463414634146,0.962779156327543,0.39200406572929
E02002418,Kippax West,Leeds,Yorkshire and the Humber,1277,4271,394,413,277,271,5626,1302,4650,388,416,299,305,6058,940,297,402,293,299,2231,0.202150537634409,0.765463917525773,0.966346153846154,0.979933110367893,0.980327868852459,0.368273357543744
E02002419,Beeston West & Cottingley,Leeds,Yorkshire and the Humber,2007,5179,298,287,172,310,6246,1966,5955,351,303,193,291,7093,1000,298,258,176,263,1995,0.167926112510495,0.849002849002849,0.851485148514852,0.911917098445596,0.903780068728522,0.28126321725645
E02002420,Beeston East,Leeds,Yorkshire and the Humber,2014,5412,307,289,212,314,6534,2124,6419,324,296,226,325,7590,901,268,257,210,292,1928,0.14036454276367,0.82716049382716,0.868243243243243,0.929203539823009,0.898461538461539,0.254018445322793
E02002421,Belle Isle North,Leeds,Yorkshire and the Humber,1522,3759,244,184,137,195,4519,1630,4566,243,214,119,214,5356,871,188,183,110,197,1549,0.190757774857643,0.773662551440329,0.855140186915888,0.92436974789916,0.920560747663551,0.289208364451083
E02002422,Churwell,Leeds,Yorkshire and the Humber,1068,3793,368,343,245,307,5056,1093,4175,317,393,264,346,5495,957,280,370,256,332,2195,0.229221556886228,0.883280757097792,0.94147582697201,0.96969696969697,0.959537572254335,0.399454049135578
E02002423,Belle Isle South,Leeds,Yorkshire and the Humber,1311,3501,305,223,169,211,4409,1367,4041,302,269,178,229,5019,827,251,244,167,215,1704,0.204652313783717,0.83112582781457,0.907063197026022,0.938202247191011,0.938864628820961,0.339509862522415
E02002424,Morley North & Gildersome East,Leeds,Yorkshire and the Humber,1414,4802,345,405,223,333,6108,1440,5106,352,407,267,359,6491,1140,293,393,256,346,2428,0.223266745005875,0.832386363636364,0.965601965601966,0.958801498127341,0.963788300835655,0.374056385764905
E02002425,Drighlington & Gildersome West,Leeds,Yorkshire and the Humber,1511,4955,471,533,380,492,6831,1533,5479,498,571,411,510,7469,1296,424,547,397,495,3159,0.236539514509947,0.85140562248996,0.957968476357268,0.965936739659367,0.970588235294118,0.422948185834784
E02002426,Woodlesford & Oulton,Leeds,Yorkshire and the Humber,1439,4575,406,420,302,510,6213,1416,5021,411,402,331,517,6682,952,383,393,323,507,2558,0.189603664608644,0.931873479318735,0.977611940298507,0.97583081570997,0.980657640232108,0.382819515115235
E02002427,Rothwell Inner,Leeds,Yorkshire and the Humber,1270,3921,378,404,324,419,5446,1247,4363,352,416,323,427,5881,883,326,396,308,409,2322,0.202383680953472,0.926136363636364,0.951923076923077,0.953560371517028,0.957845433255269,0.39483081108655
E02002428,Middleton Town Street,Leeds,Yorkshire and the Humber,1794,4991,345,263,212,283,6094,1786,5556,354,295,204,269,6678,1155,297,275,193,249,2169,0.207883369330454,0.838983050847458,0.932203389830508,0.946078431372549,0.925650557620818,0.324797843665768
E02002429,Rothwell Outer,Leeds,Yorkshire and the Humber,1588,5107,423,447,319,401,6697,1701,5621,434,423,372,419,7269,1127,401,402,364,400,2694,0.200498132004981,0.923963133640553,0.950354609929078,0.978494623655914,0.954653937947494,0.37061494015683
E02002430,Middleton Park Avenue,Leeds,Yorkshire and the Humber,2167,4664,239,249,175,208,5535,2361,5633,242,247,166,229,6517,1109,193,219,153,212,1886,0.196875554766554,0.797520661157025,0.88663967611336,0.921686746987952,0.925764192139738,0.289396961792236
E02002431,Morley East,Leeds,Yorkshire and the Humber,1670,5501,331,333,190,239,6594,1727,6197,350,357,202,218,7324,1245,262,332,189,197,2225,0.200903663062772,0.748571428571429,0.929971988795518,0.935643564356436,0.903669724770642,0.303795740032769
E02002432,Methley,Leeds,Yorkshire and the Humber,1417,4355,370,411,259,356,5751,1407,4916,335,401,337,413,6402,892,295,382,318,394,2281,0.181448331977217,0.880597014925373,0.952618453865337,0.943620178041543,0.953995157384988,0.3562949078413
E02002433,Morley Central,Leeds,Yorkshire and the Humber,1026,4232,318,303,222,334,5409,992,4703,319,355,224,321,5922,990,246,328,208,301,2073,0.210503933659366,0.771159874608151,0.923943661971831,0.928571428571429,0.937694704049844,0.350050658561297
E02002434,"Robin Hood, Lofthouse & Middleton Lane",Leeds,Yorkshire and the Humber,2437,6639,304,328,166,192,7629,2312,6949,332,346,215,284,8126,1547,294,321,200,269,2631,0.222621959994244,0.885542168674699,0.927745664739884,0.930232558139535,0.947183098591549,0.32377553531873
E02002435,Morley Bruntcliffe & Woodkirk,Leeds,Yorkshire and the Humber,1478,4667,359,370,294,390,6080,1618,5481,377,411,312,377,6958,1047,320,381,300,361,2409,0.191023535851122,0.848806366047745,0.927007299270073,0.961538461538461,0.957559681697613,0.34622017821213
E02002436,Tingley East & East Ardsley,Leeds,Yorkshire and the Humber,1332,4110,312,344,223,275,5264,1341,4561,353,328,269,306,5817,1107,288,304,257,288,2244,0.242709932032449,0.81586402266289,0.926829268292683,0.955390334572491,0.941176470588235,0.385765858690046
E02002437,Tingley West & West Ardsley,Leeds,Yorkshire and the Humber,1094,3847,331,319,197,260,4954,1129,4285,393,353,209,270,5510,1052,355,340,203,259,2209,0.245507584597433,0.903307888040712,0.963172804532578,0.971291866028708,0.959259259259259,0.400907441016334
E02006852,Far Headingley & Weetwood,Leeds,Yorkshire and the Humber,1686,8302,482,428,263,459,9934,1787,9438,504,510,305,471,11228,1759,448,471,292,448,3418,0.186374231828777,0.888888888888889,0.923529411764706,0.957377049180328,0.951167728237792,0.304417527609548
E02006861,Hyde Park Corner & Woodhouse Cliff,Leeds,Yorkshire and the Humber,674,12650,124,148,84,213,13219,677,13560,173,139,99,274,14245,1267,137,119,92,250,1865,0.0934365781710914,0.791907514450867,0.856115107913669,0.929292929292929,0.912408759124088,0.130923130923131
E02006875,Leeds City Centre,Leeds,Yorkshire and the Humber,227,13252,37,34,29,18,13370,334,12728,46,34,19,12,12839,737,23,22,12,10,804,0.0579038340666248,0.5,0.647058823529412,0.631578947368421,0.833333333333333,0.0626216995093076
E02006876,"Leeds Dock, Hunslet & Stourton",Leeds,Yorkshire and the Humber,1157,6511,230,149,157,210,7257,1293,6872,238,222,143,254,7729,1007,169,199,129,240,1744,0.146536670547148,0.710084033613445,0.896396396396396,0.902097902097902,0.944881889763779,0.225643679648079
E02002438,Ferry Fryston,Wakefield,Yorkshire and the Humber,2136,5194,416,383,240,315,6548,2138,5812,423,385,253,320,7193,1037,365,355,238,290,2285,0.17842395044735,0.862884160756501,0.922077922077922,0.940711462450593,0.90625,0.317669956902544
E02002439,Castleford Town,Wakefield,Yorkshire and the Humber,1448,5537,403,383,256,425,7004,1455,6195,416,439,287,402,7739,924,364,411,270,376,2345,0.149152542372881,0.875,0.93621867881549,0.940766550522648,0.935323383084577,0.303010724899858
E02002440,Airedale,Wakefield,Yorkshire and the Humber,1676,4789,447,405,279,377,6297,1641,5196,440,430,300,381,6747,904,388,403,288,358,2341,0.173979984603541,0.881818181818182,0.937209302325581,0.96,0.939632545931758,0.346969023269601
E02002441,Castleford West,Wakefield,Yorkshire and the Humber,1804,5914,390,448,342,449,7543,1901,6515,397,457,392,443,8204,959,355,418,367,414,2513,0.147198772064467,0.894206549118388,0.914660831509847,0.936224489795918,0.934537246049661,0.306313993174061
E02002442,Glasshoughton,Wakefield,Yorkshire and the Humber,1211,4836,389,343,215,309,6092,1195,4929,379,339,266,278,6191,801,340,317,255,265,1978,0.162507608034084,0.897097625329815,0.935103244837758,0.958646616541353,0.953237410071942,0.319496042642546
E02002443,Outwood East,Wakefield,Yorkshire and the Humber,1146,4123,310,320,190,200,5143,1086,4190,342,312,226,196,5266,949,302,296,216,183,1946,0.226491646778043,0.883040935672515,0.948717948717949,0.955752212389381,0.933673469387755,0.369540448157995
E02002444,"Stanley, Moorhouse & Bottomboat",Wakefield,Yorkshire and the Humber,1126,4014,362,325,237,251,5189,1210,4375,380,333,249,245,5582,1029,324,319,240,227,2139,0.2352,0.852631578947369,0.957957957957958,0.963855421686747,0.926530612244898,0.383195987101397
E02002445,Outwood West,Wakefield,Yorkshire and the Humber,1432,4742,434,498,342,472,6488,1577,5356,420,529,350,518,7173,1144,379,503,334,488,2848,0.213592233009709,0.902380952380952,0.950850661625709,0.954285714285714,0.942084942084942,0.397044472326781
E02002446,Altofts,Wakefield,Yorkshire and the Humber,881,3644,354,374,294,343,5009,888,3808,360,386,306,377,5237,870,341,368,297,362,2238,0.228466386554622,0.947222222222222,0.953367875647668,0.970588235294118,0.960212201591512,0.427343899178919
E02002447,Knottingley,Wakefield,Yorkshire and the Humber,1186,3847,316,346,228,352,5089,1202,4004,332,342,235,350,5263,751,298,315,223,324,1911,0.187562437562438,0.897590361445783,0.921052631578947,0.948936170212766,0.925714285714286,0.363100893026791
E02002448,Ferrybridge & West Knottingley,Wakefield,Yorkshire and the Humber,1673,4905,427,374,269,413,6388,1700,5269,439,390,264,383,6745,890,386,369,241,361,2247,0.1689125071171,0.879271070615034,0.946153846153846,0.912878787878788,0.942558746736293,0.333135656041512
E02002449,Pontefract North East,Wakefield,Yorkshire and the Humber,1889,5730,430,416,324,405,7305,1912,6435,442,438,335,425,8075,1255,401,422,322,397,2797,0.195027195027195,0.907239819004525,0.963470319634703,0.961194029850746,0.934117647058823,0.346377708978328
E02002450,Normanton East,Wakefield,Yorkshire and the Humber,1388,4681,376,372,247,275,5951,1464,5283,412,406,237,295,6633,1016,368,370,220,289,2263,0.192314972553473,0.893203883495146,0.911330049261084,0.928270042194093,0.979661016949153,0.341172923262476
E02002451,Wrenthorpe & Kirkhamgate,Wakefield,Yorkshire and the Humber,1250,4545,534,506,356,541,6482,1302,4867,523,552,393,476,6811,1018,471,526,379,450,2844,0.20916375590713,0.90057361376673,0.952898550724638,0.964376590330789,0.945378151260504,0.417559829687271
E02002452,Pontefract North West,Wakefield,Yorkshire and the Humber,1532,5551,425,419,295,372,7062,1628,6136,435,428,278,420,7697,1121,374,402,266,393,2556,0.182692307692308,0.859770114942529,0.939252336448598,0.956834532374101,0.935714285714286,0.332077432766013
E02002453,Normanton West,Wakefield,Yorkshire and the Humber,1907,6240,482,489,317,353,7881,2029,7141,504,509,326,392,8872,1242,434,468,311,373,2828,0.173925220557345,0.861111111111111,0.919449901768173,0.95398773006135,0.951530612244898,0.318755635707845
E02002454,Wakefield Central,Wakefield,Yorkshire and the Humber,1513,6076,335,237,185,357,7190,1895,7808,371,292,186,364,9021,992,246,251,159,315,1963,0.127049180327869,0.663072776280323,0.859589041095891,0.854838709677419,0.865384615384615,0.217603369914644
E02002455,Pontefract South East,Wakefield,Yorkshire and the Humber,1522,3800,302,283,205,279,4869,1503,4325,304,317,200,289,5435,874,276,299,183,268,1900,0.202080924855491,0.907894736842105,0.943217665615142,0.915,0.927335640138408,0.349586016559338
E02002456,Wakefield St John's,Wakefield,Yorkshire and the Humber,1422,5584,331,324,211,184,6634,1443,5849,316,304,221,219,6909,765,246,276,202,190,1679,0.130791588305693,0.778481012658228,0.907894736842105,0.914027149321267,0.867579908675799,0.243016355478362
E02002457,Eastmoor,Wakefield,Yorkshire and the Humber,1785,5033,388,366,190,313,6290,1905,5822,414,371,217,304,7128,956,322,341,195,272,2086,0.164204740638956,0.777777777777778,0.919137466307278,0.898617511520737,0.894736842105263,0.292648709315376
E02002458,Ossett North,Wakefield,Yorkshire and the Humber,1751,5423,573,549,359,478,7382,1620,5652,495,577,388,472,7584,1126,438,546,373,455,2938,0.199221514508139,0.884848484848485,0.946273830155979,0.961340206185567,0.963983050847458,0.387394514767932
E02002459,Alverthorpe & Flanshaw,Wakefield,Yorkshire and the Humber,2079,6263,425,388,257,319,7652,2212,7142,428,417,279,369,8635,1215,366,375,264,343,2563,0.170120414449734,0.855140186915888,0.899280575539568,0.946236559139785,0.929539295392954,0.296815286624204
E02002460,Pontefract South West,Wakefield,Yorkshire and the Humber,1176,3994,499,514,322,596,5925,1214,4510,532,531,370,621,6564,955,509,516,362,601,2943,0.211751662971175,0.956766917293233,0.971751412429379,0.978378378378378,0.967793880837359,0.44835466179159
E02002461,Streethouse & Sharlston Common,Wakefield,Yorkshire and the Humber,2387,7209,542,511,383,458,9103,2354,7641,536,521,406,491,9595,1411,480,483,391,472,3237,0.184661693495616,0.895522388059702,0.927063339731286,0.963054187192118,0.961303462321792,0.337363210005211
E02002462,Ossett West,Wakefield,Yorkshire and the Humber,1350,4493,456,477,338,401,6165,1310,4767,474,498,345,404,6488,917,428,476,326,382,2529,0.192364170337739,0.90295358649789,0.955823293172691,0.944927536231884,0.945544554455445,0.389796547472256
E02002463,Lupset,Wakefield,Yorkshire and the Humber,2736,6104,359,388,270,403,7524,2666,6825,384,373,270,375,8227,1238,321,349,252,363,2523,0.181391941391941,0.8359375,0.935656836461126,0.933333333333333,0.968,0.306673149386168
E02002464,Featherstone,Wakefield,Yorkshire and the Humber,1785,5309,448,416,321,414,6908,1853,6026,440,434,334,384,7618,1086,378,398,311,367,2540,0.180219050779954,0.859090909090909,0.91705069124424,0.931137724550898,0.955729166666667,0.333420845366238
E02002465,Thornes,Wakefield,Yorkshire and the Humber,820,3798,401,373,284,392,5248,851,4101,421,400,328,419,5669,761,365,379,321,391,2217,0.185564496464277,0.866983372921615,0.9475,0.978658536585366,0.933174224343675,0.391074263538543
E02002466,Ossett South East & Horbury Bridge,Wakefield,Yorkshire and the Humber,1713,5448,554,631,384,525,7542,1622,5681,548,599,465,537,7830,1139,481,566,443,508,3137,0.20049287097342,0.877737226277372,0.944908180300501,0.952688172043011,0.945996275605214,0.400638569604087
E02002467,Agbrigg & Belle Isle,Wakefield,Yorkshire and the Humber,1954,6100,325,286,145,223,7079,2020,7169,354,311,175,217,8226,1007,291,284,158,194,1934,0.140465894824941,0.822033898305085,0.913183279742765,0.902857142857143,0.894009216589862,0.235108193532701
E02002468,Horbury,Wakefield,Yorkshire and the Humber,1090,3729,387,412,229,389,5146,1048,3902,374,427,271,351,5325,808,328,413,265,335,2149,0.207073295745771,0.877005347593583,0.967213114754098,0.977859778597786,0.954415954415954,0.403568075117371
E02002469,Crofton,Wakefield,Yorkshire and the Humber,1207,3840,380,439,293,279,5231,1185,4249,391,430,317,297,5684,921,364,416,311,290,2302,0.216756883972699,0.930946291560102,0.967441860465116,0.981072555205047,0.976430976430976,0.404996481351161
E02002470,Sandal,Wakefield,Yorkshire and the Humber,876,3305,434,573,424,559,5295,846,3464,452,533,439,598,5486,778,423,508,419,583,2711,0.22459584295612,0.935840707964602,0.953095684803002,0.954441913439636,0.974916387959866,0.494166970470288
E02002471,Ackworth & Darrington,Wakefield,Yorkshire and the Humber,1893,6686,711,705,512,676,9290,1949,7296,747,722,571,668,10004,1621,693,700,553,642,4209,0.222176535087719,0.927710843373494,0.969529085872576,0.968476357267951,0.961077844311377,0.420731707317073
E02002472,Netherton & Middlestown,Wakefield,Yorkshire and the Humber,858,3690,384,414,259,306,5053,846,3891,408,403,293,327,5322,810,373,373,283,314,2153,0.208172706245181,0.91421568627451,0.925558312655087,0.965870307167236,0.960244648318043,0.404547162720782
E02002473,Durkar & Crigglestone,Wakefield,Yorkshire and the Humber,1107,3969,438,445,321,367,5540,1012,4243,493,437,330,362,5865,883,443,421,313,346,2406,0.208107471128918,0.898580121703854,0.963386727688787,0.948484848484848,0.955801104972376,0.410230179028133
E02002474,Kettlethorpe & Chapelthorpe,Wakefield,Yorkshire and the Humber,1419,4127,334,324,192,317,5294,1439,4578,349,358,218,298,5801,929,308,330,211,277,2055,0.202927042376584,0.882521489971347,0.921787709497207,0.967889908256881,0.929530201342282,0.354249267367695
E02002475,"Walton, Woolley & Bretton",Wakefield,Yorkshire and the Humber,1148,3623,439,443,311,407,5223,1033,3657,465,496,333,450,5401,740,444,481,328,427,2420,0.202351654361499,0.954838709677419,0.969758064516129,0.984984984984985,0.948888888888889,0.44806517311609
E02002476,Kinsley & Fitzwilliam,Wakefield,Yorkshire and the Humber,1470,3926,296,276,198,266,4962,1493,4445,283,283,207,249,5467,928,254,265,199,229,1875,0.208773903262092,0.897526501766784,0.936395759717314,0.961352657004831,0.919678714859438,0.342966892262667
E02002477,Ryhill & South Hiendley,Wakefield,Yorkshire and the Humber,1259,3942,412,326,246,371,5297,1229,4039,387,376,244,298,5344,918,347,352,234,286,2137,0.227283981183461,0.896640826873385,0.936170212765957,0.959016393442623,0.959731543624161,0.399887724550898
E02002478,Upton,Wakefield,Yorkshire and the Humber,1322,3933,298,284,211,249,4975,1280,4275,303,292,204,225,5299,867,282,272,197,208,1826,0.20280701754386,0.930693069306931,0.931506849315068,0.965686274509804,0.924444444444444,0.344593319494244
E02002479,Hemsworth Town,Wakefield,Yorkshire and the Humber,1411,5077,520,504,416,449,6966,1404,5319,547,489,441,463,7259,1201,517,469,431,439,3057,0.225794322241023,0.945155393053016,0.959100204498978,0.977324263038549,0.948164146868251,0.421132387381182
E02002480,Moorthorpe,Wakefield,Yorkshire and the Humber,917,3551,386,325,307,312,4881,934,3905,408,329,280,338,5260,725,370,304,268,319,1986,0.185659411011524,0.906862745098039,0.924012158054711,0.957142857142857,0.943786982248521,0.377566539923954
E02002481,South Elmsall,Wakefield,Yorkshire and the Humber,1502,4559,322,311,239,380,5811,1511,5029,380,321,232,374,6336,965,343,307,225,363,2203,0.191887055080533,0.902631578947368,0.956386292834891,0.969827586206897,0.970588235294118,0.347695707070707
E02002482,South Kirkby,Wakefield,Yorkshire and the Humber,1648,4348,337,344,235,297,5561,1731,4764,352,311,241,303,5971,911,324,296,231,285,2047,0.191225860621327,0.920454545454545,0.951768488745981,0.95850622406639,0.940594059405941,0.342823647630213
